"Yr","Level_1","Level_2","Level_3","Total","SimRd"
1,500,200,50,750,1
2,437,244,112,793,1
3,405,277,145,827,1
4,404,281,184,869,1
5,399,313,188,900,1
6,397,328,219,944,1
7,377,348,242,967,1
8,393,349,260,1002,1
9,399,380,264,1043,1
10,373,385,283,1041,1
11,383,390,278,1051,1
1,500,200,50,750,2
2,473,215,92,780,2
3,439,254,134,827,2
4,426,275,167,868,2
5,425,310,181,916,2
6,385,370,207,962,2
7,373,385,229,987,2
8,370,386,248,1004,2
9,383,389,252,1024,2
10,406,415,257,1078,2
11,381,404,281,1066,2
1,500,200,50,750,3
2,450,240,98,788,3
3,415,286,128,829,3
4,420,288,172,880,3
5,398,297,203,898,3
6,430,304,221,955,3
7,438,323,234,995,3
8,414,350,236,1000,3
9,393,378,246,1017,3
10,394,388,267,1049,3
11,402,403,278,1083,3
1,500,200,50,750,4
2,448,225,94,767,4
3,433,267,124,824,4
4,413,278,181,872,4
5,401,315,193,909,4
6,402,356,213,971,4
7,385,362,230,977,4
8,377,401,236,1014,4
9,381,395,261,1037,4
10,392,403,263,1058,4
11,379,399,291,1069,4
1,500,200,50,750,5
2,454,233,100,787,5
3,420,269,136,825,5
4,405,293,171,869,5
5,423,303,189,915,5
6,416,349,201,966,5
7,389,340,237,966,5
8,391,366,244,1001,5
9,395,370,259,1024,5
10,408,390,271,1069,5
11,413,403,275,1091,5
1,500,200,50,750,6
2,454,228,89,771,6
3,409,267,140,816,6
4,404,304,161,869,6
5,412,309,211,932,6
6,402,328,230,960,6
7,394,353,243,990,6
8,365,378,242,985,6
9,378,385,254,1017,6
10,393,388,260,1041,6
11,394,401,276,1071,6
1,500,200,50,750,7
2,436,231,117,784,7
3,414,276,129,819,7
4,397,302,171,870,7
5,413,316,181,910,7
6,396,352,206,954,7
7,403,373,219,995,7
8,385,391,226,1002,7
9,391,387,265,1043,7
10,370,437,259,1066,7
11,385,442,266,1093,7
1,500,200,50,750,8
2,450,222,108,780,8
3,436,240,137,813,8
4,421,278,169,868,8
5,409,312,176,897,8
6,410,364,200,974,8
7,395,352,229,976,8
8,415,356,241,1012,8
9,400,379,255,1034,8
10,390,392,260,1042,8
11,408,407,269,1084,8
1,500,200,50,750,9
2,457,251,104,812,9
3,419,265,140,824,9
4,434,299,168,901,9
5,396,324,185,905,9
6,408,337,209,954,9
7,399,339,246,984,9
8,413,352,246,1011,9
9,428,370,257,1055,9
10,406,382,261,1049,9
11,427,392,278,1097,9
1,500,200,50,750,10
2,474,212,104,790,10
3,444,244,140,828,10
4,423,273,172,868,10
5,416,318,190,924,10
6,415,326,223,964,10
7,403,358,221,982,10
8,397,373,232,1002,10
9,398,410,224,1032,10
10,403,404,239,1046,10
11,403,410,267,1080,10
1,500,200,50,750,11
2,444,237,86,767,11
3,433,264,131,828,11
4,426,283,158,867,11
5,413,300,192,905,11
6,429,326,211,966,11
7,409,353,220,982,11
8,396,367,219,982,11
9,401,381,232,1014,11
10,385,392,258,1035,11
11,407,394,278,1079,11
1,500,200,50,750,12
2,452,249,99,800,12
3,427,259,154,840,12
4,402,287,178,867,12
5,406,300,190,896,12
6,411,331,221,963,12
7,391,351,245,987,12
8,367,374,248,989,12
9,378,401,264,1043,12
10,354,410,293,1057,12
11,357,440,299,1096,12
1,500,200,50,750,13
2,460,224,92,776,13
3,428,262,137,827,13
4,413,279,171,863,13
5,426,304,182,912,13
6,423,324,212,959,13
7,402,348,223,973,13
8,396,370,237,1003,13
9,395,384,261,1040,13
10,380,386,280,1046,13
11,382,404,268,1054,13
1,500,200,50,750,14
2,466,236,87,789,14
3,447,240,134,821,14
4,426,283,164,873,14
5,389,309,209,907,14
6,398,331,218,947,14
7,395,354,219,968,14
8,395,373,224,992,14
9,396,380,254,1030,14
10,421,402,263,1086,14
11,404,426,261,1091,14
1,500,200,50,750,15
2,487,213,93,793,15
3,453,244,125,822,15
4,443,293,139,875,15
5,425,313,165,903,15
6,434,335,186,955,15
7,401,375,199,975,15
8,397,384,219,1000,15
9,399,400,248,1047,15
10,409,399,246,1054,15
11,414,422,260,1096,15
1,500,200,50,750,16
2,482,218,90,790,16
3,446,270,114,830,16
4,435,282,152,869,16
5,404,339,181,924,16
6,423,347,181,951,16
7,423,361,204,988,16
8,398,370,229,997,16
9,383,381,249,1013,16
10,403,389,263,1055,16
11,401,401,278,1080,16
1,500,200,50,750,17
2,439,233,110,782,17
3,428,260,137,825,17
4,422,293,162,877,17
5,400,306,191,897,17
6,404,344,206,954,17
7,381,349,232,962,17
8,380,373,254,1007,17
9,397,374,264,1035,17
10,409,401,269,1079,17
11,402,409,268,1079,17
1,500,200,50,750,18
2,455,232,105,792,18
3,421,252,140,813,18
4,396,307,176,879,18
5,381,322,209,912,18
6,387,347,230,964,18
7,377,365,247,989,18
8,370,379,266,1015,18
9,373,395,264,1032,18
10,383,405,271,1059,18
11,382,391,306,1079,18
1,500,200,50,750,19
2,449,248,86,783,19
3,427,264,132,823,19
4,404,283,174,861,19
5,393,328,182,903,19
6,401,358,209,968,19
7,395,380,223,998,19
8,383,386,246,1015,19
9,369,386,258,1013,19
10,376,393,280,1049,19
11,385,415,275,1075,19
1,500,200,50,750,20
2,459,242,92,793,20
3,427,272,140,839,20
4,409,295,172,876,20
5,376,324,196,896,20
6,406,345,211,962,20
7,387,351,235,973,20
8,407,385,227,1019,20
9,395,391,235,1021,20
10,429,395,244,1068,20
11,406,405,277,1088,20
1,500,200,50,750,21
2,451,238,97,786,21
3,418,273,136,827,21
4,404,298,171,873,21
5,416,309,205,930,21
6,405,342,228,975,21
7,379,374,223,976,21
8,402,388,237,1027,21
9,381,405,244,1030,21
10,402,409,262,1073,21
11,397,410,287,1094,21
1,500,200,50,750,22
2,472,226,97,795,22
3,439,248,143,830,22
4,412,284,179,875,22
5,388,312,196,896,22
6,395,351,205,951,22
7,380,374,213,967,22
8,377,353,245,975,22
9,395,387,256,1038,22
10,386,415,243,1044,22
11,384,403,284,1071,22
1,500,200,50,750,23
2,468,240,94,802,23
3,424,277,123,824,23
4,412,299,146,857,23
5,402,317,185,904,23
6,404,325,215,944,23
7,398,348,242,988,23
8,390,334,276,1000,23
9,380,368,278,1026,23
10,407,357,297,1061,23
11,402,377,296,1075,23
1,500,200,50,750,24
2,423,269,87,779,24
3,423,288,126,837,24
4,408,315,162,885,24
5,388,324,196,908,24
6,418,331,207,956,24
7,414,349,211,974,24
8,420,341,242,1003,24
9,404,357,254,1015,24
10,412,389,256,1057,24
11,426,376,284,1086,24
1,500,200,50,750,25
2,445,231,111,787,25
3,419,259,152,830,25
4,403,279,187,869,25
5,382,311,211,904,25
6,400,334,209,943,25
7,398,371,225,994,25
8,394,371,229,994,25
9,410,359,248,1017,25
10,421,396,240,1057,25
11,413,409,254,1076,25
1,500,200,50,750,26
2,459,229,94,782,26
3,438,252,130,820,26
4,424,287,155,866,26
5,403,312,184,899,26
6,390,338,213,941,26
7,378,359,236,973,26
8,389,389,237,1015,26
9,379,397,254,1030,26
10,372,422,257,1051,26
11,356,418,317,1091,26
1,500,200,50,750,27
2,460,243,97,800,27
3,434,264,148,846,27
4,435,264,177,876,27
5,406,302,191,899,27
6,401,332,226,959,27
7,376,353,237,966,27
8,392,363,261,1016,27
9,410,382,249,1041,27
10,432,379,247,1058,27
11,440,414,231,1085,27
1,500,200,50,750,28
2,463,227,98,788,28
3,421,271,122,814,28
4,420,293,163,876,28
5,390,310,203,903,28
6,401,365,200,966,28
7,389,357,233,979,28
8,406,382,234,1022,28
9,363,398,262,1023,28
10,373,404,261,1038,28
11,397,431,251,1079,28
1,500,200,50,750,29
2,464,217,95,776,29
3,444,238,140,822,29
4,439,280,160,879,29
5,427,295,192,914,29
6,432,332,211,975,29
7,410,355,229,994,29
8,375,384,249,1008,29
9,371,387,263,1021,29
10,371,403,275,1049,29
11,369,411,296,1076,29
1,500,200,50,750,30
2,443,221,111,775,30
3,418,270,145,833,30
4,405,275,182,862,30
5,414,299,200,913,30
6,407,298,229,934,30
7,438,322,236,996,30
8,419,349,251,1019,30
9,423,349,257,1029,30
10,403,384,264,1051,30
11,401,408,272,1081,30
1,500,200,50,750,31
2,463,240,95,798,31
3,437,244,145,826,31
4,426,280,167,873,31
5,401,311,192,904,31
6,419,332,218,969,31
7,404,346,226,976,31
8,402,366,242,1010,31
9,364,389,264,1017,31
10,397,398,269,1064,31
11,393,398,272,1063,31
1,500,200,50,750,32
2,453,228,98,779,32
3,410,276,143,829,32
4,391,299,182,872,32
5,383,333,198,914,32
6,405,340,228,973,32
7,384,356,248,988,32
8,405,344,262,1011,32
9,408,387,250,1045,32
10,401,396,259,1056,32
11,372,398,294,1064,32
1,500,200,50,750,33
2,453,241,91,785,33
3,426,275,131,832,33
4,405,292,164,861,33
5,408,304,181,893,33
6,413,351,191,955,33
7,401,367,212,980,33
8,376,394,221,991,33
9,378,412,224,1014,33
10,383,425,228,1036,33
11,411,424,258,1093,33
1,500,200,50,750,34
2,459,242,92,793,34
3,428,257,133,818,34
4,406,294,159,859,34
5,431,326,172,929,34
6,419,346,196,961,34
7,382,371,216,969,34
8,391,376,247,1014,34
9,379,378,268,1025,34
10,392,374,280,1046,34
11,396,407,279,1082,34
1,500,200,50,750,35
2,460,233,95,788,35
3,433,275,122,830,35
4,428,308,145,881,35
5,405,330,175,910,35
6,389,354,211,954,35
7,396,350,240,986,35
8,405,365,250,1020,35
9,393,391,245,1029,35
10,394,401,267,1062,35
11,379,430,279,1088,35
1,500,200,50,750,36
2,459,229,95,783,36
3,442,262,129,833,36
4,402,283,174,859,36
5,412,303,199,914,36
6,397,329,212,938,36
7,403,330,261,994,36
8,401,349,258,1008,36
9,391,360,272,1023,36
10,414,388,269,1071,36
11,401,418,267,1086,36
1,500,200,50,750,37
2,460,243,94,797,37
3,421,261,139,821,37
4,424,300,163,887,37
5,413,313,178,904,37
6,431,333,203,967,37
7,394,370,225,989,37
8,392,382,234,1008,37
9,402,403,250,1055,37
10,385,397,271,1053,37
11,403,397,284,1084,37
1,500,200,50,750,38
2,463,223,102,788,38
3,435,250,137,822,38
4,408,280,164,852,38
5,418,295,190,903,38
6,420,329,214,963,38
7,408,328,250,986,38
8,392,340,259,991,38
9,409,351,265,1025,38
10,413,411,241,1065,38
11,412,396,272,1080,38
1,500,200,50,750,39
2,478,220,85,783,39
3,443,255,138,836,39
4,408,289,155,852,39
5,403,334,168,905,39
6,388,362,210,960,39
7,393,359,231,983,39
8,363,393,248,1004,39
9,378,381,279,1038,39
10,383,410,279,1072,39
11,393,426,269,1088,39
1,500,200,50,750,40
2,460,231,93,784,40
3,428,271,130,829,40
4,406,304,163,873,40
5,374,321,216,911,40
6,379,349,227,955,40
7,378,365,231,974,40
8,389,380,241,1010,40
9,366,402,262,1030,40
10,391,408,276,1075,40
11,404,404,281,1089,40
1,500,200,50,750,41
2,461,230,93,784,41
3,422,250,151,823,41
4,418,283,171,872,41
5,427,305,191,923,41
6,411,323,213,947,41
7,427,340,213,980,41
8,421,365,230,1016,41
9,420,366,250,1036,41
10,425,370,265,1060,41
11,425,386,279,1090,41
1,500,200,50,750,42
2,464,234,84,782,42
3,430,268,138,836,42
4,410,289,165,864,42
5,374,328,190,892,42
6,403,337,210,950,42
7,425,330,246,1001,42
8,420,356,245,1021,42
9,393,383,247,1023,42
10,393,401,264,1058,42
11,383,442,255,1080,42
1,500,200,50,750,43
2,462,241,87,790,43
3,455,245,132,832,43
4,418,306,143,867,43
5,399,314,189,902,43
6,435,329,191,955,43
7,422,335,224,981,43
8,388,378,243,1009,43
9,406,374,253,1033,43
10,410,388,279,1077,43
11,429,402,282,1113,43
1,500,200,50,750,44
2,473,220,97,790,44
3,437,238,140,815,44
4,447,263,165,875,44
5,441,285,188,914,44
6,428,333,196,957,44
7,411,336,224,971,44
8,412,338,246,996,44
9,412,374,250,1036,44
10,412,401,254,1067,44
11,418,403,277,1098,44
1,500,200,50,750,45
2,443,230,100,773,45
3,414,279,134,827,45
4,408,293,165,866,45
5,395,309,186,890,45
6,414,333,208,955,45
7,395,376,207,978,45
8,388,370,237,995,45
9,382,394,240,1016,45
10,402,385,267,1054,45
11,430,386,270,1086,45
1,500,200,50,750,46
2,451,214,101,766,46
3,446,252,123,821,46
4,418,284,155,857,46
5,407,315,174,896,46
6,417,358,187,962,46
7,407,353,218,978,46
8,424,355,235,1014,46
9,392,397,247,1036,46
10,393,400,258,1051,46
11,412,418,262,1092,46
1,500,200,50,750,47
2,468,220,111,799,47
3,418,265,149,832,47
4,414,273,191,878,47
5,396,281,225,902,47
6,384,316,259,959,47
7,382,358,250,990,47
8,376,367,259,1002,47
9,354,376,272,1002,47
10,370,381,292,1043,47
11,368,420,297,1085,47
1,500,200,50,750,48
2,430,245,108,783,48
3,421,265,129,815,48
4,430,296,165,891,48
5,409,304,204,917,48
6,404,361,206,971,48
7,397,354,236,987,48
8,387,348,250,985,48
9,423,390,234,1047,48
10,410,389,256,1055,48
11,412,413,258,1083,48
1,500,200,50,750,49
2,446,236,92,774,49
3,444,252,131,827,49
4,429,270,157,856,49
5,435,282,184,901,49
6,443,330,188,961,49
7,439,321,227,987,49
8,411,371,219,1001,49
9,407,381,253,1041,49
10,416,386,257,1059,49
11,423,406,271,1100,49
1,500,200,50,750,50
2,456,227,95,778,50
3,449,258,136,843,50
4,426,273,166,865,50
5,413,309,186,908,50
6,403,351,211,965,50
7,393,355,223,971,50
8,400,377,227,1004,50
9,396,384,252,1032,50
10,384,389,277,1050,50
11,389,400,291,1080,50
1,500,200,50,750,51
2,455,226,110,791,51
3,439,248,149,836,51
4,433,277,170,880,51
5,403,314,194,911,51
6,415,341,205,961,51
7,392,368,223,983,51
8,389,391,217,997,51
9,382,390,251,1023,51
10,383,416,261,1060,51
11,399,414,285,1098,51
1,500,200,50,750,52
2,462,233,94,789,52
3,421,272,124,817,52
4,417,291,165,873,52
5,403,311,184,898,52
6,422,340,209,971,52
7,403,357,222,982,52
8,393,380,229,1002,52
9,396,410,228,1034,52
10,385,430,240,1055,52
11,401,431,264,1096,52
1,500,200,50,750,53
2,430,246,108,784,53
3,429,264,141,834,53
4,397,297,167,861,53
5,393,335,188,916,53
6,392,368,211,971,53
7,375,376,226,977,53
8,388,386,241,1015,53
9,392,399,252,1043,53
10,381,394,274,1049,53
11,411,403,285,1099,53
1,500,200,50,750,54
2,440,241,101,782,54
3,406,279,134,819,54
4,384,302,174,860,54
5,388,318,196,902,54
6,409,356,210,975,54
7,381,359,238,978,54
8,374,372,250,996,54
9,377,396,253,1026,54
10,397,405,266,1068,54
11,388,401,294,1083,54
1,500,200,50,750,55
2,458,232,109,799,55
3,434,252,141,827,55
4,437,277,161,875,55
5,433,295,199,927,55
6,431,328,216,975,55
7,393,366,219,978,55
8,382,375,247,1004,55
9,382,390,250,1022,55
10,384,402,258,1044,55
11,415,406,262,1083,55
1,500,200,50,750,56
2,467,218,92,777,56
3,441,244,130,815,56
4,426,297,158,881,56
5,410,324,181,915,56
6,402,361,189,952,56
7,397,364,214,975,56
8,398,391,210,999,56
9,415,390,238,1043,56
10,405,385,254,1044,56
11,409,388,265,1062,56
1,500,200,50,750,57
2,470,226,98,794,57
3,440,250,127,817,57
4,416,281,168,865,57
5,422,296,201,919,57
6,425,321,213,959,57
7,408,346,219,973,57
8,397,363,243,1003,57
9,401,377,254,1032,57
10,385,386,274,1045,57
11,389,395,286,1070,57
1,500,200,50,750,58
2,447,237,88,772,58
3,434,256,144,834,58
4,426,280,174,880,58
5,412,333,172,917,58
6,406,348,201,955,58
7,417,349,208,974,58
8,431,341,229,1001,58
9,444,360,236,1040,58
10,430,366,251,1047,58
11,437,399,259,1095,58
1,500,200,50,750,59
2,458,243,89,790,59
3,433,251,142,826,59
4,402,304,151,857,59
5,386,337,194,917,59
6,402,345,231,978,59
7,385,341,246,972,59
8,390,366,233,989,59
9,415,393,235,1043,59
10,372,408,263,1043,59
11,390,419,269,1078,59
1,500,200,50,750,60
2,456,232,98,786,60
3,432,248,139,819,60
4,418,276,168,862,60
5,411,329,171,911,60
6,405,333,212,950,60
7,399,358,228,985,60
8,396,388,232,1016,60
9,406,383,241,1030,60
10,420,382,255,1057,60
11,413,398,278,1089,60
1,500,200,50,750,61
2,453,235,96,784,61
3,419,262,136,817,61
4,410,282,179,871,61
5,408,320,194,922,61
6,400,339,224,963,61
7,399,361,227,987,61
8,391,377,238,1006,61
9,380,387,249,1016,61
10,391,413,264,1068,61
11,381,425,271,1077,61
1,500,200,50,750,62
2,472,233,85,790,62
3,434,265,132,831,62
4,443,266,157,866,62
5,444,321,169,934,62
6,420,324,197,941,62
7,411,352,223,986,62
8,408,355,246,1009,62
9,399,355,263,1017,62
10,389,396,273,1058,62
11,405,412,269,1086,62
1,500,200,50,750,63
2,453,229,108,790,63
3,430,261,120,811,63
4,412,314,140,866,63
5,406,343,169,918,63
6,403,356,196,955,63
7,392,376,219,987,63
8,372,391,242,1005,63
9,380,418,236,1034,63
10,406,430,247,1083,63
11,396,419,255,1070,63
1,500,200,50,750,64
2,471,227,97,795,64
3,437,255,141,833,64
4,396,281,175,852,64
5,408,321,188,917,64
6,416,330,211,957,64
7,395,338,238,971,64
8,393,363,247,1003,64
9,381,396,257,1034,64
10,372,396,273,1041,64
11,381,429,280,1090,64
1,500,200,50,750,65
2,469,230,95,794,65
3,431,261,140,832,65
4,420,286,157,863,65
5,419,292,197,908,65
6,408,340,203,951,65
7,391,355,219,965,65
8,420,375,226,1021,65
9,400,400,238,1038,65
10,394,411,258,1063,65
11,394,438,258,1090,65
1,500,200,50,750,66
2,437,250,97,784,66
3,415,287,131,833,66
4,397,297,174,868,66
5,401,306,205,912,66
6,412,318,224,954,66
7,409,350,228,987,66
8,412,373,244,1029,66
9,401,410,233,1044,66
10,394,408,266,1068,66
11,388,410,287,1085,66
1,500,200,50,750,67
2,467,220,106,793,67
3,419,259,144,822,67
4,397,295,179,871,67
5,398,317,205,920,67
6,380,330,242,952,67
7,397,333,256,986,67
8,382,347,266,995,67
9,393,380,256,1029,67
10,402,405,257,1064,67
11,443,410,263,1116,67
1,500,200,50,750,68
2,469,223,99,791,68
3,451,240,132,823,68
4,448,298,141,887,68
5,408,322,170,900,68
6,405,333,208,946,68
7,402,368,226,996,68
8,373,371,251,995,68
9,391,361,262,1014,68
10,408,375,265,1048,68
11,430,362,299,1091,68
1,500,200,50,750,69
2,475,217,93,785,69
3,435,254,150,839,69
4,427,269,180,876,69
5,395,312,212,919,69
6,388,348,223,959,69
7,398,348,238,984,69
8,400,365,253,1018,69
9,396,370,257,1023,69
10,408,376,268,1052,69
11,430,392,269,1091,69
1,500,200,50,750,70
2,455,236,102,793,70
3,442,258,118,818,70
4,409,295,135,839,70
5,414,310,182,906,70
6,414,317,220,951,70
7,421,345,205,971,70
8,410,358,230,998,70
9,404,381,242,1027,70
10,391,426,242,1059,70
11,390,424,264,1078,70
1,500,200,50,750,71
2,450,239,106,795,71
3,412,274,138,824,71
4,414,282,157,853,71
5,415,299,190,904,71
6,420,324,222,966,71
7,399,344,238,981,71
8,403,354,249,1006,71
9,399,387,254,1040,71
10,395,379,285,1059,71
11,405,399,270,1074,71
1,500,200,50,750,72
2,474,227,88,789,72
3,441,242,126,809,72
4,443,279,154,876,72
5,432,321,171,924,72
6,424,339,188,951,72
7,397,356,229,982,72
8,402,365,238,1005,72
9,409,388,250,1047,72
10,391,402,258,1051,72
11,426,413,257,1096,72
1,500,200,50,750,73
2,466,229,101,796,73
3,436,254,133,823,73
4,424,282,170,876,73
5,391,314,204,909,73
6,414,338,222,974,73
7,390,363,233,986,73
8,373,379,253,1005,73
9,383,392,271,1046,73
10,386,397,265,1048,73
11,395,406,289,1090,73
1,500,200,50,750,74
2,453,223,118,794,74
3,432,259,146,837,74
4,421,296,158,875,74
5,400,297,206,903,74
6,401,323,239,963,74
7,391,359,237,987,74
8,383,376,245,1004,74
9,392,388,250,1030,74
10,391,385,268,1044,74
11,409,411,276,1096,74
1,500,200,50,750,75
2,462,233,90,785,75
3,459,248,122,829,75
4,419,289,150,858,75
5,430,299,184,913,75
6,415,327,215,957,75
7,421,346,223,990,75
8,416,363,230,1009,75
9,392,371,252,1015,75
10,409,391,261,1061,75
11,390,408,291,1089,75
1,500,200,50,750,76
2,450,252,87,789,76
3,435,275,116,826,76
4,423,284,160,867,76
5,404,311,185,900,76
6,424,327,214,965,76
7,406,348,230,984,76
8,413,352,245,1010,76
9,390,370,258,1018,76
10,385,393,279,1057,76
11,381,407,300,1088,76
1,500,200,50,750,77
2,444,233,99,776,77
3,431,270,135,836,77
4,385,304,167,856,77
5,368,328,199,895,77
6,396,363,209,968,77
7,387,379,222,988,77
8,397,392,240,1029,77
9,392,397,249,1038,77
10,392,406,269,1067,77
11,385,397,285,1067,77
1,500,200,50,750,78
2,466,224,101,791,78
3,438,253,126,817,78
4,444,275,160,879,78
5,423,319,166,908,78
6,438,339,181,958,78
7,399,345,229,973,78
8,416,360,238,1014,78
9,403,397,229,1029,78
10,412,381,257,1050,78
11,401,416,264,1081,78
1,500,200,50,750,79
2,459,235,94,788,79
3,429,271,122,822,79
4,437,282,154,873,79
5,405,309,180,894,79
6,418,346,190,954,79
7,414,383,196,993,79
8,410,386,215,1011,79
9,396,400,244,1040,79
10,400,392,260,1052,79
11,415,414,273,1102,79
1,500,200,50,750,80
2,451,206,112,769,80
3,452,237,139,828,80
4,414,276,168,858,80
5,427,311,177,915,80
6,423,342,179,944,80
7,400,364,222,986,80
8,383,373,237,993,80
9,388,384,255,1027,80
10,384,399,261,1044,80
11,388,406,290,1084,80
1,500,200,50,750,81
2,451,241,95,787,81
3,419,287,122,828,81
4,404,293,163,860,81
5,398,346,172,916,81
6,406,337,213,956,81
7,375,352,249,976,81
8,379,382,261,1022,81
9,379,396,241,1016,81
10,402,406,247,1055,81
11,400,412,267,1079,81
1,500,200,50,750,82
2,439,257,89,785,82
3,435,262,130,827,82
4,427,269,173,869,82
5,418,311,185,914,82
6,425,345,198,968,82
7,410,324,228,962,82
8,424,356,232,1012,82
9,412,402,234,1048,82
10,404,376,254,1034,82
11,412,382,278,1072,82
1,500,200,50,750,83
2,462,215,100,777,83
3,440,261,134,835,83
4,441,278,156,875,83
5,418,315,181,914,83
6,398,336,215,949,83
7,404,343,243,990,83
8,398,364,241,1003,83
9,388,405,242,1035,83
10,377,407,274,1058,83
11,377,433,269,1079,83
1,500,200,50,750,84
2,441,244,102,787,84
3,407,275,139,821,84
4,407,287,169,863,84
5,396,308,190,894,84
6,429,331,220,980,84
7,393,367,217,977,84
8,400,368,235,1003,84
9,390,408,246,1044,84
10,401,400,265,1066,84
11,412,393,281,1086,84
1,500,200,50,750,85
2,474,236,99,809,85
3,437,260,134,831,85
4,423,291,156,870,85
5,405,300,202,907,85
6,424,316,208,948,85
7,413,335,219,967,85
8,440,365,203,1008,85
9,420,365,220,1005,85
10,453,398,222,1073,85
11,436,393,257,1086,85
1,500,200,50,750,86
2,471,215,97,783,86
3,443,252,132,827,86
4,417,270,177,864,86
5,396,299,196,891,86
6,401,322,237,960,86
7,383,374,232,989,86
8,363,375,259,997,86
9,395,387,268,1050,86
10,379,421,267,1067,86
11,384,418,284,1086,86
1,500,200,50,750,87
2,473,205,100,778,87
3,454,259,134,847,87
4,427,270,170,867,87
5,422,292,200,914,87
6,442,335,218,995,87
7,396,343,233,972,87
8,397,357,255,1009,87
9,394,371,280,1045,87
10,389,385,278,1052,87
11,404,393,282,1079,87
1,500,200,50,750,88
2,460,221,108,789,88
3,447,240,130,817,88
4,443,285,146,874,88
5,426,300,181,907,88
6,422,325,205,952,88
7,411,350,221,982,88
8,396,371,230,997,88
9,385,389,256,1030,88
10,393,368,277,1038,88
11,433,398,264,1095,88
1,500,200,50,750,89
2,457,243,99,799,89
3,433,258,135,826,89
4,420,301,159,880,89
5,402,342,169,913,89
6,381,363,207,951,89
7,378,374,236,988,89
8,398,373,240,1011,89
9,370,386,271,1027,89
10,386,390,294,1070,89
11,378,416,285,1079,89
1,500,200,50,750,90
2,440,232,114,786,90
3,413,253,157,823,90
4,397,300,164,861,90
5,403,332,184,919,90
6,410,339,213,962,90
7,395,347,235,977,90
8,398,374,235,1007,90
9,392,373,264,1029,90
10,387,386,296,1069,90
11,394,414,289,1097,90
1,500,200,50,750,91
2,460,220,96,776,91
3,437,258,133,828,91
4,394,281,174,849,91
5,405,309,195,909,91
6,396,343,211,950,91
7,389,363,217,969,91
8,392,356,257,1005,91
9,393,371,264,1028,91
10,382,402,273,1057,91
11,397,406,276,1079,91
1,500,200,50,750,92
2,459,227,94,780,92
3,443,252,137,832,92
4,439,276,164,879,92
5,421,282,194,897,92
6,415,323,208,946,92
7,410,337,218,965,92
8,415,367,231,1013,92
9,402,382,239,1023,92
10,412,398,247,1057,92
11,442,407,238,1087,92
1,500,200,50,750,93
2,450,220,102,772,93
3,413,268,133,814,93
4,413,278,183,874,93
5,400,307,206,913,93
6,405,339,218,962,93
7,377,344,225,946,93
8,384,369,234,987,93
9,395,398,247,1040,93
10,399,407,259,1065,93
11,381,428,268,1077,93
1,500,200,50,750,94
2,474,240,68,782,94
3,442,291,115,848,94
4,414,307,149,870,94
5,409,324,181,914,94
6,396,356,191,943,94
7,378,358,228,964,94
8,377,391,238,1006,94
9,378,377,275,1030,94
10,365,402,271,1038,94
11,402,390,300,1092,94
1,500,200,50,750,95
2,472,232,95,799,95
3,434,262,132,828,95
4,415,285,180,880,95
5,388,302,207,897,95
6,400,335,213,948,95
7,421,345,228,994,95
8,428,362,221,1011,95
9,424,357,247,1028,95
10,419,370,278,1067,95
11,403,383,283,1069,95
1,500,200,50,750,96
2,448,229,102,779,96
3,418,265,141,824,96
4,428,298,161,887,96
5,397,315,205,917,96
6,402,335,222,959,96
7,393,351,234,978,96
8,392,360,248,1000,96
9,384,393,264,1041,96
10,376,390,276,1042,96
11,387,422,271,1080,96
1,500,200,50,750,97
2,448,238,104,790,97
3,431,255,144,830,97
4,431,281,152,864,97
5,414,295,193,902,97
6,426,342,204,972,97
7,391,358,226,975,97
8,385,376,238,999,97
9,393,407,244,1044,97
10,388,406,260,1054,97
11,387,398,283,1068,97
1,500,200,50,750,98
2,453,234,101,788,98
3,420,265,144,829,98
4,411,295,175,881,98
5,399,335,168,902,98
6,397,358,205,960,98
7,395,360,237,992,98
8,402,375,242,1019,98
9,390,399,226,1015,98
10,373,426,250,1049,98
11,389,418,277,1084,98
1,500,200,50,750,99
2,468,240,83,791,99
3,444,261,128,833,99
4,416,285,171,872,99
5,426,311,177,914,99
6,425,343,205,973,99
7,428,340,215,983,99
8,420,355,229,1004,99
9,417,368,252,1037,99
10,395,356,281,1032,99
11,416,384,286,1086,99
1,500,200,50,750,100
2,460,235,87,782,100
3,433,273,125,831,100
4,413,303,162,878,100
5,400,305,210,915,100
6,376,341,242,959,100
7,370,356,252,978,100
8,391,359,257,1007,100
9,391,359,293,1043,100
10,392,366,294,1052,100
11,409,371,313,1093,100
1,500,200,50,750,101
2,450,236,102,788,101
3,434,257,128,819,101
4,410,297,164,871,101
5,386,331,184,901,101
6,405,350,194,949,101
7,388,381,215,984,101
8,361,406,220,987,101
9,391,411,233,1035,101
10,404,387,267,1058,101
11,390,422,264,1076,101
1,500,200,50,750,102
2,458,234,77,769,102
3,461,270,112,843,102
4,405,277,166,848,102
5,431,324,178,933,102
6,419,317,215,951,102
7,407,339,225,971,102
8,405,395,210,1010,102
9,383,417,237,1037,102
10,385,419,259,1063,102
11,365,445,281,1091,102
1,500,200,50,750,103
2,468,240,95,803,103
3,434,254,126,814,103
4,411,290,162,863,103
5,398,320,170,888,103
6,416,357,200,973,103
7,400,354,237,991,103
8,400,370,245,1015,103
9,382,394,253,1029,103
10,398,390,257,1045,103
11,396,418,257,1071,103
1,500,200,50,750,104
2,457,230,105,792,104
3,426,279,122,827,104
4,423,306,144,873,104
5,380,332,201,913,104
6,405,329,212,946,104
7,416,350,236,1002,104
8,380,402,219,1001,104
9,384,402,244,1030,104
10,381,412,256,1049,104
11,368,412,285,1065,104
1,500,200,50,750,105
2,472,227,92,791,105
3,440,250,127,817,105
4,435,274,157,866,105
5,422,299,182,903,105
6,415,330,215,960,105
7,391,352,250,993,105
8,381,365,257,1003,105
9,379,411,230,1020,105
10,367,423,264,1054,105
11,388,417,281,1086,105
1,500,200,50,750,106
2,460,230,89,779,106
3,427,268,130,825,106
4,428,264,170,862,106
5,426,300,198,924,106
6,412,315,218,945,106
7,391,349,229,969,106
8,382,377,256,1015,106
9,362,396,262,1020,106
10,371,441,241,1053,106
11,396,433,259,1088,106
1,500,200,50,750,107
2,480,212,97,789,107
3,456,234,137,827,107
4,425,282,160,867,107
5,403,331,172,906,107
6,399,350,230,979,107
7,372,382,240,994,107
8,356,378,259,993,107
9,383,386,267,1036,107
10,387,405,272,1064,107
11,419,399,282,1100,107
1,500,200,50,750,108
2,476,216,93,785,108
3,422,263,128,813,108
4,412,292,162,866,108
5,401,319,189,909,108
6,393,325,219,937,108
7,395,352,219,966,108
8,422,382,221,1025,108
9,430,381,225,1036,108
10,419,379,242,1040,108
11,422,409,252,1083,108
1,500,200,50,750,109
2,463,223,100,786,109
3,448,246,145,839,109
4,425,270,170,865,109
5,425,326,180,931,109
6,396,351,216,963,109
7,387,370,233,990,109
8,385,363,251,999,109
9,381,381,254,1016,109
10,412,390,279,1081,109
11,393,390,294,1077,109
1,500,200,50,750,110
2,461,232,89,782,110
3,439,265,129,833,110
4,434,293,159,886,110
5,390,325,191,906,110
6,384,352,214,950,110
7,396,380,228,1004,110
8,390,374,240,1004,110
9,388,401,257,1046,110
10,388,410,262,1060,110
11,386,427,285,1098,110
1,500,200,50,750,111
2,451,242,94,787,111
3,418,264,145,827,111
4,394,303,169,866,111
5,396,297,200,893,111
6,415,318,217,950,111
7,401,337,237,975,111
8,383,389,246,1018,111
9,353,402,276,1031,111
10,349,416,277,1042,111
11,366,412,317,1095,111
1,500,200,50,750,112
2,449,232,100,781,112
3,438,263,137,838,112
4,410,290,178,878,112
5,385,336,197,918,112
6,378,362,212,952,112
7,353,370,249,972,112
8,363,384,284,1031,112
9,337,409,274,1020,112
10,343,401,309,1053,112
11,366,414,295,1075,112
1,500,200,50,750,113
2,449,227,112,788,113
3,431,268,131,830,113
4,424,282,165,871,113
5,408,314,195,917,113
6,385,339,222,946,113
7,395,350,237,982,113
8,385,377,241,1003,113
9,398,387,253,1038,113
10,393,388,277,1058,113
11,386,409,289,1084,113
1,500,200,50,750,114
2,475,205,105,785,114
3,440,230,147,817,114
4,436,263,171,870,114
5,429,294,197,920,114
6,408,339,203,950,114
7,416,356,215,987,114
8,396,372,233,1001,114
9,389,406,228,1023,114
10,393,408,249,1050,114
11,421,405,257,1083,114
1,500,200,50,750,115
2,455,226,107,788,115
3,430,251,148,829,115
4,431,272,176,879,115
5,427,304,188,919,115
6,409,351,183,943,115
7,406,368,199,973,115
8,390,407,218,1015,115
9,383,396,252,1031,115
10,382,401,257,1040,115
11,402,396,292,1090,115
1,500,200,50,750,116
2,449,222,110,781,116
3,434,242,145,821,116
4,417,295,168,880,116
5,403,319,192,914,116
6,405,348,205,958,116
7,392,378,203,973,116
8,391,374,244,1009,116
9,390,363,265,1018,116
10,403,368,282,1053,116
11,391,390,303,1084,116
1,500,200,50,750,117
2,451,227,103,781,117
3,425,264,146,835,117
4,408,287,170,865,117
5,399,295,208,902,117
6,419,334,209,962,117
7,398,358,221,977,117
8,392,391,231,1014,117
9,391,389,251,1031,117
10,397,401,258,1056,117
11,399,420,263,1082,117
1,500,200,50,750,118
2,473,213,100,786,118
3,456,235,138,829,118
4,411,274,164,849,118
5,424,301,192,917,118
6,405,338,218,961,118
7,416,354,223,993,118
8,394,367,257,1018,118
9,395,389,239,1023,118
10,405,400,260,1065,118
11,395,403,278,1076,118
1,500,200,50,750,119
2,476,220,102,798,119
3,436,257,129,822,119
4,391,292,182,865,119
5,389,319,197,905,119
6,384,362,219,965,119
7,390,355,246,991,119
8,384,357,252,993,119
9,401,369,251,1021,119
10,404,384,280,1068,119
11,381,430,265,1076,119
1,500,200,50,750,120
2,440,254,91,785,120
3,395,302,122,819,120
4,401,315,167,883,120
5,373,351,181,905,120
6,392,350,239,981,120
7,374,380,245,999,120
8,380,391,241,1012,120
9,369,427,234,1030,120
10,368,416,287,1071,120
11,359,439,276,1074,120
1,500,200,50,750,121
2,456,237,92,785,121
3,439,244,130,813,121
4,422,282,155,859,121
5,413,321,178,912,121
6,420,333,209,962,121
7,403,351,223,977,121
8,392,364,251,1007,121
9,401,351,277,1029,121
10,402,352,300,1054,121
11,432,382,285,1099,121
1,500,200,50,750,122
2,445,243,93,781,122
3,426,265,134,825,122
4,420,302,153,875,122
5,416,313,185,914,122
6,410,316,221,947,122
7,392,354,244,990,122
8,385,369,256,1010,122
9,397,390,233,1020,122
10,399,391,263,1053,122
11,388,400,287,1075,122
1,500,200,50,750,123
2,448,230,100,778,123
3,427,252,140,819,123
4,408,282,170,860,123
5,413,315,195,923,123
6,389,335,220,944,123
7,382,365,235,982,123
8,387,379,238,1004,123
9,385,394,250,1029,123
10,387,392,279,1058,123
11,387,403,291,1081,123
1,500,200,50,750,124
2,474,226,106,806,124
3,431,241,145,817,124
4,429,249,179,857,124
5,439,268,207,914,124
6,420,309,222,951,124
7,407,345,232,984,124
8,402,344,260,1006,124
9,396,351,287,1034,124
10,404,377,275,1056,124
11,406,390,292,1088,124
1,500,200,50,750,125
2,466,227,93,786,125
3,433,269,125,827,125
4,399,273,164,836,125
5,408,302,209,919,125
6,421,307,225,953,125
7,406,371,213,990,125
8,404,390,212,1006,125
9,408,380,254,1042,125
10,421,409,235,1065,125
11,413,399,267,1079,125
1,500,200,50,750,126
2,449,249,95,793,126
3,442,274,133,849,126
4,420,272,180,872,126
5,430,295,195,920,126
6,411,349,203,963,126
7,387,374,203,964,126
8,427,370,221,1018,126
9,425,387,228,1040,126
10,415,388,268,1071,126
11,412,412,259,1083,126
1,500,200,50,750,127
2,461,213,109,783,127
3,428,257,138,823,127
4,436,283,146,865,127
5,429,321,162,912,127
6,430,366,165,961,127
7,411,383,189,983,127
8,390,390,226,1006,127
9,384,394,255,1033,127
10,409,385,274,1068,127
11,397,386,300,1083,127
1,500,200,50,750,128
2,477,227,97,801,128
3,437,235,150,822,128
4,418,272,173,863,128
5,416,305,208,929,128
6,398,354,208,960,128
7,377,370,212,959,128
8,378,366,245,989,128
9,388,373,272,1033,128
10,392,403,254,1049,128
11,396,420,265,1081,128
1,500,200,50,750,129
2,463,244,91,798,129
3,415,276,136,827,129
4,394,304,171,869,129
5,401,308,198,907,129
6,406,326,214,946,129
7,405,336,234,975,129
8,415,353,250,1018,129
9,409,378,256,1043,129
10,382,404,272,1058,129
11,368,406,297,1071,129
1,500,200,50,750,130
2,460,215,103,778,130
3,441,257,120,818,130
4,425,295,147,867,130
5,399,316,186,901,130
6,411,330,214,955,130
7,415,347,219,981,130
8,418,368,227,1013,130
9,394,356,261,1011,130
10,421,385,276,1082,130
11,402,368,311,1081,130
1,500,200,50,750,131
2,466,232,94,792,131
3,449,238,136,823,131
4,426,261,166,853,131
5,408,296,186,890,131
6,435,312,209,956,131
7,433,329,217,979,131
8,449,342,222,1013,131
9,447,371,232,1050,131
10,420,378,260,1058,131
11,412,408,257,1077,131
1,500,200,50,750,132
2,469,226,100,795,132
3,437,239,141,817,132
4,419,268,161,848,132
5,407,309,190,906,132
6,391,333,215,939,132
7,373,358,246,977,132
8,388,366,269,1023,132
9,385,394,256,1035,132
10,396,385,271,1052,132
11,407,408,290,1105,132
1,500,200,50,750,133
2,469,219,110,798,133
3,434,249,143,826,133
4,414,271,170,855,133
5,418,327,182,927,133
6,417,329,209,955,133
7,400,333,250,983,133
8,381,378,254,1013,133
9,375,378,268,1021,133
10,375,391,289,1055,133
11,380,418,285,1083,133
1,500,200,50,750,134
2,452,249,96,797,134
3,413,269,131,813,134
4,399,295,162,856,134
5,389,328,195,912,134
6,401,351,204,956,134
7,395,354,237,986,134
8,389,372,265,1026,134
9,365,389,281,1035,134
10,363,398,284,1045,134
11,381,426,269,1076,134
1,500,200,50,750,135
2,461,246,104,811,135
3,429,258,143,830,135
4,415,299,148,862,135
5,401,336,170,907,135
6,393,346,207,946,135
7,382,357,237,976,135
8,373,378,232,983,135
9,387,406,245,1038,135
10,386,413,267,1066,135
11,368,409,287,1064,135
1,500,200,50,750,136
2,439,243,100,782,136
3,427,243,149,819,136
4,436,271,177,884,136
5,403,314,202,919,136
6,410,320,239,969,136
7,399,328,258,985,136
8,400,365,259,1024,136
9,376,382,276,1034,136
10,391,411,258,1060,136
11,380,430,268,1078,136
1,500,200,50,750,137
2,471,207,105,783,137
3,445,244,126,815,137
4,424,281,166,871,137
5,406,285,190,881,137
6,411,339,211,961,137
7,411,344,234,989,137
8,415,360,237,1012,137
9,409,363,262,1034,137
10,382,375,275,1032,137
11,399,403,280,1082,137
1,500,200,50,750,138
2,458,225,106,789,138
3,422,245,152,819,138
4,408,290,167,865,138
5,418,339,170,927,138
6,404,349,199,952,138
7,405,347,224,976,138
8,404,376,230,1010,138
9,400,405,239,1044,138
10,389,397,264,1050,138
11,404,391,282,1077,138
1,500,200,50,750,139
2,462,237,90,789,139
3,442,265,127,834,139
4,405,293,165,863,139
5,444,309,176,929,139
6,422,318,221,961,139
7,411,357,220,988,139
8,397,376,237,1010,139
9,389,390,242,1021,139
10,366,381,279,1026,139
11,395,374,305,1074,139
1,500,200,50,750,140
2,439,241,87,767,140
3,445,260,122,827,140
4,421,295,153,869,140
5,405,307,187,899,140
6,426,336,214,976,140
7,393,350,232,975,140
8,395,359,247,1001,140
9,379,369,278,1026,140
10,393,363,296,1052,140
11,394,404,278,1076,140
1,500,200,50,750,141
2,455,242,95,792,141
3,435,264,127,826,141
4,422,280,160,862,141
5,414,306,166,886,141
6,437,334,195,966,141
7,430,349,201,980,141
8,403,373,221,997,141
9,402,370,262,1034,141
10,399,390,273,1062,141
11,385,416,274,1075,141
1,500,200,50,750,142
2,453,222,104,779,142
3,441,251,146,838,142
4,381,284,189,854,142
5,371,312,207,890,142
6,389,319,249,957,142
7,393,364,232,989,142
8,371,397,248,1016,142
9,379,379,264,1022,142
10,416,377,274,1067,142
11,413,397,275,1085,142
1,500,200,50,750,143
2,480,223,82,785,143
3,422,264,142,828,143
4,416,295,160,871,143
5,396,319,189,904,143
6,401,327,219,947,143
7,400,348,240,988,143
8,369,343,283,995,143
9,412,385,254,1051,143
10,423,394,251,1068,143
11,407,405,266,1078,143
1,500,200,50,750,144
2,453,229,93,775,144
3,447,262,131,840,144
4,411,293,162,866,144
5,404,312,199,915,144
6,401,320,224,945,144
7,396,357,231,984,144
8,394,382,241,1017,144
9,397,384,249,1030,144
10,410,406,245,1061,144
11,403,413,261,1077,144
1,500,200,50,750,145
2,474,229,98,801,145
3,432,265,131,828,145
4,418,283,175,876,145
5,426,291,213,930,145
6,442,303,224,969,145
7,408,346,232,986,145
8,407,373,235,1015,145
9,402,371,261,1034,145
10,391,389,278,1058,145
11,427,396,269,1092,145
1,500,200,50,750,146
2,443,235,103,781,146
3,426,275,130,831,146
4,428,311,143,882,146
5,395,341,157,893,146
6,406,361,187,954,146
7,387,366,217,970,146
8,394,368,234,996,146
9,384,387,265,1036,146
10,381,408,260,1049,146
11,371,411,285,1067,146
1,500,200,50,750,147
2,433,238,100,771,147
3,440,272,137,849,147
4,405,301,157,863,147
5,397,330,183,910,147
6,404,345,213,962,147
7,400,368,227,995,147
8,387,375,240,1002,147
9,397,388,241,1026,147
10,414,406,239,1059,147
11,402,396,271,1069,147
1,500,200,50,750,148
2,463,222,113,798,148
3,435,253,145,833,148
4,427,264,178,869,148
5,434,300,185,919,148
6,423,310,213,946,148
7,411,331,230,972,148
8,398,342,252,992,148
9,401,351,264,1016,148
10,400,383,254,1037,148
11,415,403,273,1091,148
1,500,200,50,750,149
2,450,233,98,781,149
3,417,254,145,816,149
4,429,275,182,886,149
5,397,290,228,915,149
6,406,344,238,988,149
7,373,352,256,981,149
8,388,359,269,1016,149
9,373,382,288,1043,149
10,385,388,284,1057,149
11,401,384,302,1087,149
1,500,200,50,750,150
2,474,240,89,803,150
3,439,264,124,827,150
4,426,293,164,883,150
5,419,301,203,923,150
6,426,342,198,966,150
7,434,338,216,988,150
8,418,364,228,1010,150
9,412,385,236,1033,150
10,408,384,255,1047,150
11,400,416,254,1070,150
1,500,200,50,750,151
2,453,229,108,790,151
3,443,248,145,836,151
4,406,277,173,856,151
5,411,318,195,924,151
6,447,346,186,979,151
7,403,352,224,979,151
8,403,368,226,997,151
9,424,381,240,1045,151
10,420,378,269,1067,151
11,430,412,243,1085,151
1,500,200,50,750,152
2,477,212,102,791,152
3,438,261,131,830,152
4,421,276,162,859,152
5,411,308,194,913,152
6,419,316,206,941,152
7,417,359,215,991,152
8,418,370,219,1007,152
9,411,379,239,1029,152
10,406,384,260,1050,152
11,408,386,282,1076,152
1,500,200,50,750,153
2,431,242,108,781,153
3,399,265,152,816,153
4,374,310,189,873,153
5,355,369,194,918,153
6,361,377,208,946,153
7,397,383,215,995,153
8,378,392,236,1006,153
9,391,393,244,1028,153
10,398,386,271,1055,153
11,428,387,272,1087,153
1,500,200,50,750,154
2,483,217,90,790,154
3,447,246,126,819,154
4,436,267,173,876,154
5,440,296,183,919,154
6,426,306,221,953,154
7,411,336,217,964,154
8,421,375,231,1027,154
9,415,394,235,1044,154
10,394,388,275,1057,154
11,405,416,258,1079,154
1,500,200,50,750,155
2,457,226,107,790,155
3,426,258,147,831,155
4,409,284,177,870,155
5,401,313,194,908,155
6,378,350,218,946,155
7,384,357,231,972,155
8,370,391,238,999,155
9,368,402,266,1036,155
10,380,397,272,1049,155
11,400,407,274,1081,155
1,500,200,50,750,156
2,459,226,106,791,156
3,423,278,130,831,156
4,417,285,163,865,156
5,398,324,182,904,156
6,413,342,203,958,156
7,388,359,234,981,156
8,383,362,252,997,156
9,385,388,261,1034,156
10,382,386,280,1048,156
11,391,415,275,1081,156
1,500,200,50,750,157
2,441,246,103,790,157
3,439,259,139,837,157
4,427,270,164,861,157
5,414,302,193,909,157
6,427,335,206,968,157
7,406,362,233,1001,157
8,377,374,242,993,157
9,381,397,249,1027,157
10,384,396,285,1065,157
11,390,393,300,1083,157
1,500,200,50,750,158
2,455,235,94,784,158
3,410,291,124,825,158
4,407,330,144,881,158
5,408,353,170,931,158
6,373,380,195,948,158
7,388,387,224,999,158
8,375,379,241,995,158
9,405,379,257,1041,158
10,390,383,282,1055,158
11,400,416,282,1098,158
1,500,200,50,750,159
2,444,243,92,779,159
3,434,289,117,840,159
4,406,307,150,863,159
5,400,336,174,910,159
6,390,359,205,954,159
7,385,355,241,981,159
8,376,369,249,994,159
9,376,374,278,1028,159
10,386,385,273,1044,159
11,412,409,263,1084,159
1,500,200,50,750,160
2,463,223,95,781,160
3,431,269,131,831,160
4,431,291,159,881,160
5,413,317,189,919,160
6,392,328,227,947,160
7,396,332,244,972,160
8,408,331,280,1019,160
9,406,330,288,1024,160
10,396,373,278,1047,160
11,428,398,279,1105,160
1,500,200,50,750,161
2,442,238,101,781,161
3,390,281,141,812,161
4,396,298,169,863,161
5,405,321,200,926,161
6,406,348,215,969,161
7,380,370,231,981,161
8,382,402,235,1019,161
9,378,394,248,1020,161
10,397,414,277,1088,161
11,378,426,286,1090,161
1,500,200,50,750,162
2,465,232,84,781,162
3,463,238,133,834,162
4,429,283,148,860,162
5,410,327,178,915,162
6,388,348,199,935,162
7,386,356,221,963,162
8,407,387,220,1014,162
9,407,402,229,1038,162
10,398,408,251,1057,162
11,404,422,253,1079,162
1,500,200,50,750,163
2,456,237,96,789,163
3,443,235,147,825,163
4,432,271,161,864,163
5,416,305,183,904,163
6,431,308,213,952,163
7,412,358,225,995,163
8,384,391,228,1003,163
9,389,394,249,1032,163
10,394,391,267,1052,163
11,394,385,293,1072,163
1,500,200,50,750,164
2,468,218,105,791,164
3,449,251,136,836,164
4,407,293,178,878,164
5,375,321,196,892,164
6,388,329,219,936,164
7,391,356,227,974,164
8,403,360,247,1010,164
9,406,390,245,1041,164
10,403,395,271,1069,164
11,377,406,291,1074,164
1,500,200,50,750,165
2,462,219,97,778,165
3,432,250,141,823,165
4,427,296,165,888,165
5,394,300,212,906,165
6,390,339,224,953,165
7,412,344,239,995,165
8,394,355,237,986,165
9,404,391,245,1040,165
10,386,404,258,1048,165
11,399,410,271,1080,165
1,500,200,50,750,166
2,444,247,95,786,166
3,419,282,133,834,166
4,379,302,183,864,166
5,390,322,198,910,166
6,399,349,216,964,166
7,381,363,229,973,166
8,394,377,251,1022,166
9,378,394,257,1029,166
10,402,396,262,1060,166
11,393,420,253,1066,166
1,500,200,50,750,167
2,443,252,96,791,167
3,411,281,125,817,167
4,402,309,159,870,167
5,402,324,185,911,167
6,380,332,227,939,167
7,380,359,231,970,167
8,379,353,261,993,167
9,390,362,271,1023,167
10,386,400,265,1051,167
11,411,399,278,1088,167
1,500,200,50,750,168
2,440,226,108,774,168
3,421,264,143,828,168
4,419,271,166,856,168
5,426,291,195,912,168
6,433,326,210,969,168
7,414,352,218,984,168
8,420,371,235,1026,168
9,398,383,251,1032,168
10,430,408,245,1083,168
11,395,431,257,1083,168
1,500,200,50,750,169
2,456,222,94,772,169
3,463,236,140,839,169
4,430,282,162,874,169
5,416,298,188,902,169
6,426,324,210,960,169
7,413,342,230,985,169
8,401,360,250,1011,169
9,395,365,262,1022,169
10,386,381,279,1046,169
11,379,407,265,1051,169
1,500,200,50,750,170
2,477,238,80,795,170
3,444,262,119,825,170
4,445,278,135,858,170
5,428,303,179,910,170
6,407,332,203,942,170
7,394,385,219,998,170
8,389,392,234,1015,170
9,365,410,238,1013,170
10,379,420,263,1062,170
11,390,434,264,1088,170
1,500,200,50,750,171
2,447,248,84,779,171
3,448,279,113,840,171
4,398,324,148,870,171
5,404,320,176,900,171
6,423,325,197,945,171
7,412,360,218,990,171
8,368,380,252,1000,171
9,368,378,253,999,171
10,383,394,277,1054,171
11,393,435,271,1099,171
1,500,200,50,750,172
2,455,254,93,802,172
3,435,277,117,829,172
4,413,291,161,865,172
5,407,316,191,914,172
6,401,313,231,945,172
7,375,362,238,975,172
8,382,393,228,1003,172
9,387,398,230,1015,172
10,397,407,262,1066,172
11,380,426,283,1089,172
1,500,200,50,750,173
2,454,234,102,790,173
3,413,281,137,831,173
4,403,307,159,869,173
5,406,310,182,898,173
6,411,346,206,963,173
7,390,375,213,978,173
8,388,400,231,1019,173
9,395,400,245,1040,173
10,396,424,247,1067,173
11,407,419,244,1070,173
1,500,200,50,750,174
2,464,208,104,776,174
3,446,229,144,819,174
4,453,243,166,862,174
5,410,291,186,887,174
6,436,324,227,987,174
7,398,323,262,983,174
8,376,353,256,985,174
9,380,380,259,1019,174
10,372,367,271,1010,174
11,387,404,282,1073,174
1,500,200,50,750,175
2,473,218,96,787,175
3,455,243,137,835,175
4,427,268,162,857,175
5,422,300,187,909,175
6,402,317,212,931,175
7,420,320,232,972,175
8,434,349,214,997,175
9,428,379,236,1043,175
10,414,359,265,1038,175
11,425,372,284,1081,175
1,500,200,50,750,176
2,453,231,88,772,176
3,435,260,131,826,176
4,395,301,153,849,176
5,407,331,172,910,176
6,387,348,197,932,176
7,400,348,239,987,176
8,406,352,260,1018,176
9,425,369,241,1035,176
10,411,377,266,1054,176
11,410,390,274,1074,176
1,500,200,50,750,177
2,445,229,92,766,177
3,458,258,128,844,177
4,414,295,161,870,177
5,382,313,195,890,177
6,390,329,233,952,177
7,388,356,241,985,177
8,403,373,246,1022,177
9,376,394,252,1022,177
10,389,397,281,1067,177
11,378,422,278,1078,177
1,500,200,50,750,178
2,448,243,95,786,178
3,425,269,140,834,178
4,401,280,180,861,178
5,428,317,188,933,178
6,407,329,210,946,178
7,427,335,222,984,178
8,404,353,250,1007,178
9,394,373,258,1025,178
10,397,385,263,1045,178
11,402,394,280,1076,178
1,500,200,50,750,179
2,454,244,84,782,179
3,431,260,126,817,179
4,426,295,157,878,179
5,415,327,177,919,179
6,406,348,208,962,179
7,409,356,224,989,179
8,384,375,243,1002,179
9,395,384,255,1034,179
10,391,406,258,1055,179
11,405,395,277,1077,179
1,500,200,50,750,180
2,457,228,109,794,180
3,423,251,136,810,180
4,410,298,176,884,180
5,401,309,195,905,180
6,427,331,220,978,180
7,392,363,221,976,180
8,378,388,242,1008,180
9,368,391,256,1015,180
10,369,415,259,1043,180
11,386,434,251,1071,180
1,500,200,50,750,181
2,468,237,92,797,181
3,414,285,136,835,181
4,403,301,167,871,181
5,417,313,200,930,181
6,415,335,204,954,181
7,415,350,209,974,181
8,392,355,242,989,181
9,373,374,277,1024,181
10,371,387,289,1047,181
11,390,399,284,1073,181
1,500,200,50,750,182
2,454,236,102,792,182
3,433,265,132,830,182
4,421,289,153,863,182
5,405,307,190,902,182
6,421,315,222,958,182
7,398,366,226,990,182
8,379,395,226,1000,182
9,383,422,226,1031,182
10,381,416,269,1066,182
11,386,426,276,1088,182
1,500,200,50,750,183
2,447,235,94,776,183
3,432,261,127,820,183
4,395,301,178,874,183
5,403,333,181,917,183
6,399,365,190,954,183
7,392,372,207,971,183
8,393,380,237,1010,183
9,382,395,254,1031,183
10,381,409,264,1054,183
11,391,408,279,1078,183
1,500,200,50,750,184
2,470,224,85,779,184
3,442,258,122,822,184
4,422,287,156,865,184
5,428,317,170,915,184
6,439,337,185,961,184
7,418,350,222,990,184
8,425,344,238,1007,184
9,402,363,266,1031,184
10,393,392,283,1068,184
11,393,412,279,1084,184
1,500,200,50,750,185
2,454,250,88,792,185
3,438,282,127,847,185
4,428,294,156,878,185
5,417,326,178,921,185
6,421,335,212,968,185
7,420,339,221,980,185
8,421,352,224,997,185
9,414,411,220,1045,185
10,426,394,251,1071,185
11,410,403,260,1073,185
1,500,200,50,750,186
2,473,226,93,792,186
3,437,260,128,825,186
4,425,319,137,881,186
5,415,342,163,920,186
6,399,325,223,947,186
7,398,366,233,997,186
8,413,351,251,1015,186
9,437,351,245,1033,186
10,420,362,269,1051,186
11,417,388,276,1081,186
1,500,200,50,750,187
2,463,223,105,791,187
3,445,250,134,829,187
4,431,284,168,883,187
5,423,292,196,911,187
6,435,310,206,951,187
7,413,352,225,990,187
8,395,369,234,998,187
9,389,407,232,1028,187
10,396,426,241,1063,187
11,413,429,254,1096,187
1,500,200,50,750,188
2,457,231,97,785,188
3,429,256,134,819,188
4,430,288,155,873,188
5,404,306,180,890,188
6,427,329,204,960,188
7,415,337,231,983,188
8,385,356,259,1000,188
9,404,372,266,1042,188
10,412,385,268,1065,188
11,409,392,289,1090,188
1,500,200,50,750,189
2,456,239,104,799,189
3,420,270,138,828,189
4,394,310,172,876,189
5,389,318,202,909,189
6,374,322,246,942,189
7,379,323,263,965,189
8,409,357,265,1031,189
9,384,381,270,1035,189
10,363,411,269,1043,189
11,388,388,290,1066,189
1,500,200,50,750,190
2,462,226,104,792,190
3,425,246,160,831,190
4,424,275,182,881,190
5,404,312,199,915,190
6,403,342,219,964,190
7,388,361,225,974,190
8,392,397,226,1015,190
9,386,385,251,1022,190
10,405,411,263,1079,190
11,387,410,273,1070,190
1,500,200,50,750,191
2,450,245,92,787,191
3,428,267,133,828,191
4,423,310,146,879,191
5,414,335,160,909,191
6,412,343,206,961,191
7,400,351,240,991,191
8,370,374,258,1002,191
9,385,364,271,1020,191
10,404,367,292,1063,191
11,419,366,290,1075,191
1,500,200,50,750,192
2,450,245,102,797,192
3,415,270,146,831,192
4,415,285,186,886,192
5,401,306,197,904,192
6,410,349,229,988,192
7,384,367,241,992,192
8,397,370,252,1019,192
9,390,379,271,1040,192
10,406,385,273,1064,192
11,399,398,292,1089,192
1,500,200,50,750,193
2,466,229,99,794,193
3,415,270,138,823,193
4,391,300,162,853,193
5,398,313,204,915,193
6,387,338,231,956,193
7,379,363,236,978,193
8,374,403,241,1018,193
9,372,392,268,1032,193
10,379,378,305,1062,193
11,378,402,284,1064,193
1,500,200,50,750,194
2,457,236,102,795,194
3,402,265,151,818,194
4,407,290,160,857,194
5,396,307,201,904,194
6,401,345,221,967,194
7,385,351,236,972,194
8,382,358,259,999,194
9,401,366,275,1042,194
10,395,404,270,1069,194
11,393,427,263,1083,194
1,500,200,50,750,195
2,432,234,98,764,195
3,439,266,132,837,195
4,418,291,150,859,195
5,410,302,197,909,195
6,413,323,210,946,195
7,405,348,222,975,195
8,392,353,260,1005,195
9,364,376,273,1013,195
10,360,410,274,1044,195
11,383,436,278,1097,195
1,500,200,50,750,196
2,453,229,91,773,196
3,440,273,120,833,196
4,404,305,168,877,196
5,406,328,190,924,196
6,405,341,209,955,196
7,445,333,218,996,196
8,421,369,224,1014,196
9,400,402,238,1040,196
10,387,411,248,1046,196
11,402,406,275,1083,196
1,500,200,50,750,197
2,449,242,102,793,197
3,411,282,130,823,197
4,397,294,158,849,197
5,383,333,195,911,197
6,391,324,222,937,197
7,386,334,263,983,197
8,384,348,269,1001,197
9,404,352,280,1036,197
10,385,385,284,1054,197
11,388,396,282,1066,197
1,500,200,50,750,198
2,461,251,98,810,198
3,413,273,139,825,198
4,403,297,172,872,198
5,379,320,214,913,198
6,389,351,227,967,198
7,372,337,256,965,198
8,360,384,272,1016,198
9,368,396,282,1046,198
10,381,410,267,1058,198
11,364,433,261,1058,198
1,500,200,50,750,199
2,471,231,95,797,199
3,437,248,141,826,199
4,419,279,171,869,199
5,414,324,198,936,199
6,398,347,222,967,199
7,379,372,229,980,199
8,379,368,247,994,199
9,396,379,254,1029,199
10,396,401,267,1064,199
11,389,414,286,1089,199
1,500,200,50,750,200
2,454,226,106,786,200
3,443,264,129,836,200
4,417,292,146,855,200
5,413,323,173,909,200
6,400,361,218,979,200
7,379,374,221,974,200
8,377,368,253,998,200
9,379,384,254,1017,200
10,397,401,266,1064,200
11,410,408,265,1083,200
1,500,200,50,750,201
2,454,237,96,787,201
3,435,248,124,807,201
4,444,276,157,877,201
5,429,301,183,913,201
6,427,335,205,967,201
7,409,348,220,977,201
8,414,361,222,997,201
9,427,382,220,1029,201
10,430,383,251,1064,201
11,436,373,281,1090,201
1,500,200,50,750,202
2,455,229,100,784,202
3,426,269,127,822,202
4,419,293,152,864,202
5,425,298,196,919,202
6,427,332,204,963,202
7,418,344,212,974,202
8,401,354,251,1006,202
9,414,361,260,1035,202
10,407,397,255,1059,202
11,411,427,257,1095,202
1,500,200,50,750,203
2,465,225,105,795,203
3,437,244,144,825,203
4,435,275,158,868,203
5,418,312,189,919,203
6,404,348,213,965,203
7,407,360,226,993,203
8,423,363,225,1011,203
9,415,390,237,1042,203
10,388,389,271,1048,203
11,401,427,278,1106,203
1,500,200,50,750,204
2,460,221,102,783,204
3,438,261,135,834,204
4,413,289,168,870,204
5,393,334,188,915,204
6,401,345,209,955,204
7,385,365,229,979,204
8,390,371,232,993,204
9,380,388,257,1025,204
10,385,374,291,1050,204
11,409,388,299,1096,204
1,500,200,50,750,205
2,474,222,97,793,205
3,425,252,137,814,205
4,420,271,175,866,205
5,417,287,201,905,205
6,423,345,207,975,205
7,394,366,237,997,205
8,399,355,265,1019,205
9,394,400,245,1039,205
10,386,408,274,1068,205
11,397,419,269,1085,205
1,500,200,50,750,206
2,460,230,103,793,206
3,433,269,131,833,206
4,417,280,177,874,206
5,407,303,192,902,206
6,394,342,222,958,206
7,383,357,245,985,206
8,383,372,255,1010,206
9,381,360,269,1010,206
10,398,364,295,1057,206
11,412,379,298,1089,206
1,500,200,50,750,207
2,477,215,106,798,207
3,424,269,138,831,207
4,389,285,189,863,207
5,377,314,207,898,207
6,389,343,230,962,207
7,384,372,227,983,207
8,393,367,248,1008,207
9,409,379,248,1036,207
10,390,383,274,1047,207
11,409,410,268,1087,207
1,500,200,50,750,208
2,464,243,99,806,208
3,421,261,150,832,208
4,416,298,168,882,208
5,393,317,210,920,208
6,414,338,209,961,208
7,402,358,217,977,208
8,412,353,235,1000,208
9,424,362,260,1046,208
10,418,351,274,1043,208
11,424,388,266,1078,208
1,500,200,50,750,209
2,457,244,89,790,209
3,433,267,120,820,209
4,415,297,157,869,209
5,405,327,185,917,209
6,392,360,186,938,209
7,401,368,211,980,209
8,424,376,221,1021,209
9,431,380,223,1034,209
10,442,370,248,1060,209
11,435,397,254,1086,209
1,500,200,50,750,210
2,447,211,117,775,210
3,439,251,138,828,210
4,412,275,171,858,210
5,403,303,196,902,210
6,403,332,213,948,210
7,406,329,242,977,210
8,410,349,256,1015,210
9,406,360,264,1030,210
10,405,391,269,1065,210
11,399,393,288,1080,210
1,500,200,50,750,211
2,436,233,108,777,211
3,424,270,137,831,211
4,403,299,171,873,211
5,393,328,187,908,211
6,386,349,206,941,211
7,371,347,251,969,211
8,389,365,244,998,211
9,392,383,249,1024,211
10,381,406,251,1038,211
11,407,422,252,1081,211
1,500,200,50,750,212
2,456,225,109,790,212
3,420,260,140,820,212
4,435,283,152,870,212
5,431,307,187,925,212
6,397,317,234,948,212
7,396,331,244,971,212
8,384,366,254,1004,212
9,381,398,256,1035,212
10,381,400,275,1056,212
11,370,406,297,1073,212
1,500,200,50,750,213
2,459,234,107,800,213
3,429,263,123,815,213
4,410,292,158,860,213
5,418,306,193,917,213
6,428,327,199,954,213
7,398,342,224,964,213
8,412,370,236,1018,213
9,405,382,239,1026,213
10,397,387,266,1050,213
11,400,400,289,1089,213
1,500,200,50,750,214
2,450,239,96,785,214
3,417,249,148,814,214
4,420,281,164,865,214
5,394,322,190,906,214
6,394,345,204,943,214
7,393,358,236,987,214
8,385,370,261,1016,214
9,400,386,263,1049,214
10,381,404,271,1056,214
11,383,412,298,1093,214
1,500,200,50,750,215
2,450,240,84,774,215
3,430,267,113,810,215
4,422,291,164,877,215
5,402,317,189,908,215
6,409,354,219,982,215
7,396,343,242,981,215
8,400,360,258,1018,215
9,386,371,262,1019,215
10,410,394,259,1063,215
11,413,409,266,1088,215
1,500,200,50,750,216
2,462,235,95,792,216
3,427,288,116,831,216
4,406,301,153,860,216
5,410,330,191,931,216
6,396,350,202,948,216
7,411,372,194,977,216
8,403,364,226,993,216
9,420,376,249,1045,216
10,401,395,272,1068,216
11,382,390,285,1057,216
1,500,200,50,750,217
2,474,224,112,810,217
3,437,234,150,821,217
4,406,292,174,872,217
5,414,311,187,912,217
6,421,313,224,958,217
7,388,335,240,963,217
8,383,361,249,993,217
9,391,386,245,1022,217
10,400,384,272,1056,217
11,398,383,297,1078,217
1,500,200,50,750,218
2,455,236,95,786,218
3,428,259,135,822,218
4,427,282,172,881,218
5,421,294,185,900,218
6,437,334,193,964,218
7,394,363,224,981,218
8,393,390,245,1028,218
9,409,389,239,1037,218
10,398,403,259,1060,218
11,425,395,266,1086,218
1,500,200,50,750,219
2,460,243,89,792,219
3,426,271,111,808,219
4,422,288,155,865,219
5,390,319,182,891,219
6,418,351,195,964,219
7,403,349,235,987,219
8,401,376,246,1023,219
9,384,388,266,1038,219
10,385,421,265,1071,219
11,405,409,294,1108,219
1,500,200,50,750,220
2,472,226,100,798,220
3,441,243,141,825,220
4,414,284,166,864,220
5,406,309,200,915,220
6,395,345,216,956,220
7,405,357,222,984,220
8,404,361,248,1013,220
9,394,370,261,1025,220
10,404,396,274,1074,220
11,397,395,298,1090,220
1,500,200,50,750,221
2,467,233,96,796,221
3,431,273,122,826,221
4,405,291,163,859,221
5,415,305,201,921,221
6,416,367,197,980,221
7,396,381,207,984,221
8,393,379,222,994,221
9,402,394,230,1026,221
10,427,392,233,1052,221
11,414,418,240,1072,221
1,500,200,50,750,222
2,453,236,96,785,222
3,441,254,129,824,222
4,411,295,152,858,222
5,418,331,167,916,222
6,439,341,192,972,222
7,406,341,225,972,222
8,404,368,229,1001,222
9,403,363,261,1027,222
10,406,382,256,1044,222
11,411,382,284,1077,222
1,500,200,50,750,223
2,446,245,89,780,223
3,423,283,127,833,223
4,409,318,153,880,223
5,407,343,171,921,223
6,395,369,205,969,223
7,389,386,226,1001,223
8,376,390,239,1005,223
9,374,384,263,1021,223
10,396,394,268,1058,223
11,405,395,276,1076,223
1,500,200,50,750,224
2,461,237,94,792,224
3,430,251,142,823,224
4,405,298,172,875,224
5,400,315,200,915,224
6,409,337,214,960,224
7,388,355,242,985,224
8,393,368,243,1004,224
9,373,376,269,1018,224
10,382,399,286,1067,224
11,381,426,293,1100,224
1,500,200,50,750,225
2,451,226,99,776,225
3,433,270,128,831,225
4,423,292,164,879,225
5,415,318,180,913,225
6,387,343,219,949,225
7,379,352,250,981,225
8,385,382,244,1011,225
9,388,392,244,1024,225
10,386,393,279,1058,225
11,373,417,288,1078,225
1,500,200,50,750,226
2,452,239,98,789,226
3,448,244,149,841,226
4,397,288,171,856,226
5,402,312,189,903,226
6,403,358,214,975,226
7,395,356,233,984,226
8,380,365,255,1000,226
9,365,375,281,1021,226
10,408,387,283,1078,226
11,414,390,281,1085,226
1,500,200,50,750,227
2,438,243,102,783,227
3,403,272,141,816,227
4,391,298,182,871,227
5,401,309,211,921,227
6,385,337,227,949,227
7,386,362,228,976,227
8,396,368,245,1009,227
9,366,402,257,1025,227
10,403,389,268,1060,227
11,417,386,278,1081,227
1,500,200,50,750,228
2,470,231,90,791,228
3,430,279,115,824,228
4,417,298,147,862,228
5,423,294,191,908,228
6,421,346,212,979,228
7,395,355,226,976,228
8,389,373,244,1006,228
9,405,372,260,1037,228
10,398,397,266,1061,228
11,373,434,266,1073,228
1,500,200,50,750,229
2,454,235,91,780,229
3,435,268,124,827,229
4,412,291,159,862,229
5,420,298,182,900,229
6,430,321,210,961,229
7,399,357,214,970,229
8,410,387,220,1017,229
9,393,393,234,1020,229
10,412,398,254,1064,229
11,410,402,269,1081,229
1,500,200,50,750,230
2,437,238,100,775,230
3,423,267,145,835,230
4,396,290,174,860,230
5,407,299,207,913,230
6,404,332,227,963,230
7,415,352,230,997,230
8,397,370,238,1005,230
9,399,352,281,1032,230
10,423,375,281,1079,230
11,402,398,268,1068,230
1,500,200,50,750,231
2,453,231,94,778,231
3,430,277,130,837,231
4,417,313,164,894,231
5,411,324,184,919,231
6,412,334,200,946,231
7,413,359,217,989,231
8,407,360,226,993,231
9,407,393,233,1033,231
10,411,411,246,1068,231
11,417,408,262,1087,231
1,500,200,50,750,232
2,439,241,108,788,232
3,400,280,143,823,232
4,371,307,175,853,232
5,382,342,202,926,232
6,399,354,211,964,232
7,382,373,224,979,232
8,369,381,247,997,232
9,396,382,247,1025,232
10,408,380,271,1059,232
11,412,395,288,1095,232
1,500,200,50,750,233
2,468,226,103,797,233
3,430,253,157,840,233
4,402,284,179,865,233
5,380,336,180,896,233
6,404,364,192,960,233
7,381,378,211,970,233
8,388,382,228,998,233
9,380,402,238,1020,233
10,369,414,264,1047,233
11,385,409,288,1082,233
1,500,200,50,750,234
2,452,231,95,778,234
3,424,276,132,832,234
4,402,294,170,866,234
5,404,335,195,934,234
6,366,362,234,962,234
7,365,358,240,963,234
8,358,375,264,997,234
9,367,391,271,1029,234
10,404,378,286,1068,234
11,409,383,294,1086,234
1,500,200,50,750,235
2,434,242,111,787,235
3,398,276,147,821,235
4,387,311,177,875,235
5,374,343,189,906,235
6,362,370,232,964,235
7,376,384,233,993,235
8,363,397,240,1000,235
9,387,389,252,1028,235
10,388,390,276,1054,235
11,373,416,284,1073,235
1,500,200,50,750,236
2,465,224,102,791,236
3,444,262,128,834,236
4,422,281,161,864,236
5,422,306,180,908,236
6,433,349,208,990,236
7,411,350,217,978,236
8,403,360,247,1010,236
9,410,358,276,1044,236
10,389,388,268,1045,236
11,414,396,292,1102,236
1,500,200,50,750,237
2,432,256,95,783,237
3,427,264,136,827,237
4,412,290,163,865,237
5,401,308,197,906,237
6,389,342,217,948,237
7,368,374,248,990,237
8,345,391,263,999,237
9,343,396,276,1015,237
10,375,414,269,1058,237
11,394,402,289,1085,237
1,500,200,50,750,238
2,463,233,100,796,238
3,423,260,136,819,238
4,411,298,155,864,238
5,390,335,173,898,238
6,421,366,198,985,238
7,385,385,214,984,238
8,383,387,239,1009,238
9,387,416,235,1038,238
10,385,402,265,1052,238
11,393,424,273,1090,238
1,500,200,50,750,239
2,434,249,102,785,239
3,425,266,146,837,239
4,410,281,182,873,239
5,392,329,198,919,239
6,384,359,202,945,239
7,391,377,214,982,239
8,392,379,230,1001,239
9,387,385,259,1031,239
10,402,391,273,1066,239
11,404,404,285,1093,239
1,500,200,50,750,240
2,456,238,93,787,240
3,452,252,134,838,240
4,439,274,157,870,240
5,407,305,177,889,240
6,430,329,189,948,240
7,415,360,200,975,240
8,432,359,218,1009,240
9,414,364,247,1025,240
10,421,384,249,1054,240
11,412,381,284,1077,240
1,500,200,50,750,241
2,473,232,96,801,241
3,435,260,132,827,241
4,406,310,160,876,241
5,403,334,178,915,241
6,411,338,209,958,241
7,405,372,210,987,241
8,399,381,229,1009,241
9,389,395,250,1034,241
10,396,399,265,1060,241
11,408,384,281,1073,241
1,500,200,50,750,242
2,467,241,91,799,242
3,441,277,116,834,242
4,412,299,147,858,242
5,412,323,175,910,242
6,426,331,217,974,242
7,411,342,236,989,242
8,388,389,234,1011,242
9,373,393,259,1025,242
10,395,415,268,1078,242
11,370,433,274,1077,242
1,500,200,50,750,243
2,471,233,92,796,243
3,421,263,141,825,243
4,420,284,174,878,243
5,405,328,185,918,243
6,395,348,204,947,243
7,407,364,208,979,243
8,383,395,235,1013,243
9,373,404,253,1030,243
10,386,397,272,1055,243
11,409,416,265,1090,243
1,500,200,50,750,244
2,445,232,101,778,244
3,406,260,157,823,244
4,383,294,180,857,244
5,362,308,210,880,244
6,378,337,229,944,244
7,383,349,245,977,244
8,359,379,257,995,244
9,376,385,265,1026,244
10,378,402,266,1046,244
11,387,422,263,1072,244
1,500,200,50,750,245
2,441,238,98,777,245
3,439,265,134,838,245
4,409,299,174,882,245
5,402,308,196,906,245
6,410,341,212,963,245
7,382,379,207,968,245
8,395,399,218,1012,245
9,407,359,263,1029,245
10,404,382,271,1057,245
11,395,389,289,1073,245
1,500,200,50,750,246
2,451,246,98,795,246
3,414,266,149,829,246
4,417,299,162,878,246
5,422,317,190,929,246
6,409,327,217,953,246
7,408,370,213,991,246
8,382,382,246,1010,246
9,395,374,250,1019,246
10,419,378,273,1070,246
11,425,387,280,1092,246
1,500,200,50,750,247
2,467,223,99,789,247
3,428,264,127,819,247
4,439,290,148,877,247
5,426,296,175,897,247
6,433,328,202,963,247
7,423,360,208,991,247
8,394,367,248,1009,247
9,380,383,259,1022,247
10,379,405,279,1063,247
11,380,430,277,1087,247
1,500,200,50,750,248
2,457,228,104,789,248
3,426,255,148,829,248
4,395,292,182,869,248
5,402,320,192,914,248
6,397,354,216,967,248
7,397,369,213,979,248
8,404,380,231,1015,248
9,421,368,248,1037,248
10,418,378,253,1049,248
11,413,402,270,1085,248
1,500,200,50,750,249
2,466,229,95,790,249
3,433,271,133,837,249
4,428,289,165,882,249
5,416,297,200,913,249
6,385,331,220,936,249
7,395,360,226,981,249
8,383,381,233,997,249
9,375,417,241,1033,249
10,368,438,247,1053,249
11,382,421,279,1082,249
1,500,200,50,750,250
2,458,222,97,777,250
3,455,232,137,824,250
4,443,265,160,868,250
5,427,301,182,910,250
6,428,328,204,960,250
7,421,347,226,994,250
8,393,360,246,999,250
9,371,390,268,1029,250
10,361,414,286,1061,250
11,377,413,293,1083,250
1,500,200,50,750,251
2,453,237,96,786,251
3,429,260,146,835,251
4,409,271,189,869,251
5,385,296,206,887,251
6,428,330,224,982,251
7,408,352,235,995,251
8,388,384,240,1012,251
9,380,386,251,1017,251
10,392,399,253,1044,251
11,406,434,247,1087,251
1,500,200,50,750,252
2,462,238,101,801,252
3,423,266,127,816,252
4,401,285,165,851,252
5,403,325,188,916,252
6,399,347,193,939,252
7,400,353,213,966,252
8,392,372,230,994,252
9,396,370,262,1028,252
10,400,375,270,1045,252
11,409,396,295,1100,252
1,500,200,50,750,253
2,470,218,103,791,253
3,442,239,140,821,253
4,441,268,161,870,253
5,429,313,184,926,253
6,422,329,194,945,253
7,416,357,217,990,253
8,418,383,219,1020,253
9,407,381,241,1029,253
10,376,408,269,1053,253
11,381,427,281,1089,253
1,500,200,50,750,254
2,449,234,100,783,254
3,443,270,118,831,254
4,421,289,153,863,254
5,418,317,172,907,254
6,401,342,202,945,254
7,398,372,215,985,254
8,397,399,214,1010,254
9,383,379,259,1021,254
10,398,382,282,1062,254
11,394,396,307,1097,254
1,500,200,50,750,255
2,455,216,112,783,255
3,423,244,154,821,255
4,414,286,173,873,255
5,400,318,192,910,255
6,389,323,237,949,255
7,395,361,233,989,255
8,398,366,246,1010,255
9,385,394,240,1019,255
10,386,422,251,1059,255
11,385,418,271,1074,255
1,500,200,50,750,256
2,461,253,79,793,256
3,416,267,135,818,256
4,399,286,171,856,256
5,397,316,196,909,256
6,393,351,200,944,256
7,379,377,225,981,256
8,386,408,221,1015,256
9,378,421,234,1033,256
10,396,415,249,1060,256
11,395,421,262,1078,256
1,500,200,50,750,257
2,461,217,100,778,257
3,434,250,127,811,257
4,402,283,160,845,257
5,426,333,183,942,257
6,416,331,205,952,257
7,409,348,223,980,257
8,406,383,216,1005,257
9,411,382,227,1020,257
10,402,392,253,1047,257
11,413,412,251,1076,257
1,500,200,50,750,258
2,457,238,88,783,258
3,440,263,118,821,258
4,437,279,153,869,258
5,409,324,166,899,258
6,406,340,194,940,258
7,391,363,227,981,258
8,399,363,233,995,258
9,407,388,232,1027,258
10,401,394,260,1055,258
11,405,430,253,1088,258
1,500,200,50,750,259
2,459,224,100,783,259
3,427,255,130,812,259
4,430,294,137,861,259
5,438,321,164,923,259
6,404,332,216,952,259
7,381,341,252,974,259
8,390,368,255,1013,259
9,387,354,287,1028,259
10,389,373,288,1050,259
11,406,403,291,1100,259
1,500,200,50,750,260
2,464,247,79,790,260
3,444,263,132,839,260
4,416,284,163,863,260
5,399,326,170,895,260
6,419,351,190,960,260
7,411,355,218,984,260
8,409,365,235,1009,260
9,404,372,259,1035,260
10,373,400,280,1053,260
11,370,409,278,1057,260
1,500,200,50,750,261
2,454,235,92,781,261
3,423,270,133,826,261
4,426,285,155,866,261
5,439,299,186,924,261
6,432,331,202,965,261
7,425,342,218,985,261
8,423,359,226,1008,261
9,412,374,241,1027,261
10,418,384,259,1061,261
11,418,386,265,1069,261
1,500,200,50,750,262
2,452,246,92,790,262
3,424,277,125,826,262
4,411,301,143,855,262
5,423,328,164,915,262
6,421,343,186,950,262
7,407,362,205,974,262
8,394,372,227,993,262
9,420,386,232,1038,262
10,425,373,268,1066,262
11,427,403,262,1092,262
1,500,200,50,750,263
2,440,235,110,785,263
3,402,273,153,828,263
4,385,299,177,861,263
5,403,328,201,932,263
6,412,335,223,970,263
7,384,361,229,974,263
8,385,395,229,1009,263
9,380,401,257,1038,263
10,385,390,266,1041,263
11,408,398,284,1090,263
1,500,200,50,750,264
2,459,246,89,794,264
3,414,274,141,829,264
4,378,295,179,852,264
5,366,330,204,900,264
6,367,365,226,958,264
7,351,368,232,951,264
8,390,373,247,1010,264
9,389,396,234,1019,264
10,397,403,259,1059,264
11,397,428,263,1088,264
1,500,200,50,750,265
2,454,248,90,792,265
3,430,272,123,825,265
4,405,297,153,855,265
5,408,321,174,903,265
6,410,351,187,948,265
7,401,376,202,979,265
8,374,389,219,982,265
9,389,411,238,1038,265
10,386,420,251,1057,265
11,396,397,280,1073,265
1,500,200,50,750,266
2,470,243,82,795,266
3,443,263,111,817,266
4,435,290,146,871,266
5,438,313,175,926,266
6,395,341,206,942,266
7,395,356,230,981,266
8,381,391,240,1012,266
9,377,369,285,1031,266
10,359,370,319,1048,266
11,384,379,328,1091,266
1,500,200,50,750,267
2,470,218,106,794,267
3,441,256,140,837,267
4,419,270,178,867,267
5,425,297,179,901,267
6,429,341,200,970,267
7,400,366,218,984,267
8,393,374,244,1011,267
9,390,360,274,1024,267
10,400,376,274,1050,267
11,408,400,285,1093,267
1,500,200,50,750,268
2,458,235,91,784,268
3,429,253,141,823,268
4,415,270,172,857,268
5,439,302,180,921,268
6,431,306,210,947,268
7,416,346,218,980,268
8,420,369,228,1017,268
9,403,393,236,1032,268
10,409,402,255,1066,268
11,402,423,263,1088,268
1,500,200,50,750,269
2,462,224,105,791,269
3,429,253,137,819,269
4,436,292,161,889,269
5,409,298,192,899,269
6,432,307,219,958,269
7,430,331,217,978,269
8,407,369,217,993,269
9,414,392,229,1035,269
10,410,389,253,1052,269
11,408,402,269,1079,269
1,500,200,50,750,270
2,478,223,98,799,270
3,451,253,125,829,270
4,426,288,163,877,270
5,402,305,194,901,270
6,391,330,234,955,270
7,372,382,241,995,270
8,382,363,275,1020,270
9,372,374,289,1035,270
10,373,385,298,1056,270
11,386,390,315,1091,270
1,500,200,50,750,271
2,446,228,115,789,271
3,422,248,145,815,271
4,411,286,169,866,271
5,403,323,184,910,271
6,409,332,220,961,271
7,395,366,219,980,271
8,402,381,228,1011,271
9,386,388,262,1036,271
10,379,386,287,1052,271
11,371,415,305,1091,271
1,500,200,50,750,272
2,464,230,102,796,272
3,427,272,134,833,272
4,413,303,161,877,272
5,418,321,179,918,272
6,404,350,198,952,272
7,402,365,219,986,272
8,415,362,229,1006,272
9,422,367,239,1028,272
10,420,382,256,1058,272
11,416,393,285,1094,272
1,500,200,50,750,273
2,461,240,95,796,273
3,425,252,142,819,273
4,404,286,175,865,273
5,395,310,190,895,273
6,407,328,205,940,273
7,397,376,192,965,273
8,399,387,202,988,273
9,384,403,237,1024,273
10,425,417,245,1087,273
11,393,424,269,1086,273
1,500,200,50,750,274
2,453,238,94,785,274
3,434,263,134,831,274
4,412,278,164,854,274
5,398,300,203,901,274
6,419,337,210,966,274
7,412,345,240,997,274
8,397,356,258,1011,274
9,394,375,276,1045,274
10,406,381,269,1056,274
11,404,394,271,1069,274
1,500,200,50,750,275
2,441,242,109,792,275
3,398,270,154,822,275
4,387,285,175,847,275
5,368,327,194,889,275
6,373,344,224,941,275
7,382,357,231,970,275
8,397,366,248,1011,275
9,374,391,266,1031,275
10,377,410,280,1067,275
11,404,415,282,1101,275
1,500,200,50,750,276
2,463,234,94,791,276
3,426,264,135,825,276
4,408,294,169,871,276
5,399,318,194,911,276
6,405,338,211,954,276
7,383,376,217,976,276
8,384,381,244,1009,276
9,392,383,266,1041,276
10,389,402,268,1059,276
11,410,408,264,1082,276
1,500,200,50,750,277
2,474,220,91,785,277
3,454,235,135,824,277
4,448,259,173,880,277
5,416,286,199,901,277
6,411,328,209,948,277
7,381,345,250,976,277
8,394,362,250,1006,277
9,396,380,261,1037,277
10,397,378,272,1047,277
11,410,411,260,1081,277
1,500,200,50,750,278
2,440,239,104,783,278
3,421,255,152,828,278
4,416,277,180,873,278
5,413,322,186,921,278
6,412,346,190,948,278
7,386,378,215,979,278
8,388,377,239,1004,278
9,405,397,235,1037,278
10,400,393,259,1052,278
11,395,420,276,1091,278
1,500,200,50,750,279
2,453,247,105,805,279
3,433,256,139,828,279
4,408,276,174,858,279
5,401,337,187,925,279
6,395,359,213,967,279
7,382,370,234,986,279
8,387,373,258,1018,279
9,377,391,257,1025,279
10,378,434,248,1060,279
11,392,427,263,1082,279
1,500,200,50,750,280
2,441,239,94,774,280
3,431,267,131,829,280
4,414,297,161,872,280
5,413,305,213,931,280
6,391,345,218,954,280
7,387,369,232,988,280
8,383,372,252,1007,280
9,389,362,277,1028,280
10,403,378,276,1057,280
11,399,415,277,1091,280
1,500,200,50,750,281
2,442,232,105,779,281
3,420,262,142,824,281
4,429,274,172,875,281
5,386,324,180,890,281
6,412,347,208,967,281
7,381,352,237,970,281
8,386,368,255,1009,281
9,393,384,268,1045,281
10,395,398,263,1056,281
11,390,411,272,1073,281
1,500,200,50,750,282
2,453,244,102,799,282
3,419,268,135,822,282
4,412,298,166,876,282
5,411,331,179,921,282
6,378,387,190,955,282
7,377,393,215,985,282
8,390,406,226,1022,282
9,383,380,263,1026,282
10,385,388,281,1054,282
11,390,406,285,1081,282
1,500,200,50,750,283
2,467,237,84,788,283
3,441,255,131,827,283
4,425,283,156,864,283
5,437,314,177,928,283
6,398,357,195,950,283
7,402,356,231,989,283
8,403,348,258,1009,283
9,400,376,265,1041,283
10,410,370,286,1066,283
11,411,382,301,1094,283
1,500,200,50,750,284
2,461,213,100,774,284
3,443,255,138,836,284
4,414,285,160,859,284
5,423,313,175,911,284
6,407,335,200,942,284
7,407,347,240,994,284
8,387,363,243,993,284
9,398,379,259,1036,284
10,401,394,257,1052,284
11,410,405,252,1067,284
1,500,200,50,750,285
2,475,211,99,785,285
3,449,237,141,827,285
4,434,284,163,881,285
5,417,310,186,913,285
6,417,341,206,964,285
7,390,377,216,983,285
8,388,372,243,1003,285
9,380,394,260,1034,285
10,393,390,281,1064,285
11,391,402,301,1094,285
1,500,200,50,750,286
2,444,231,107,782,286
3,415,243,149,807,286
4,417,265,176,858,286
5,406,315,194,915,286
6,408,344,215,967,286
7,390,354,220,964,286
8,406,373,225,1004,286
9,413,385,233,1031,286
10,435,382,251,1068,286
11,425,400,249,1074,286
1,500,200,50,750,287
2,446,240,96,782,287
3,435,271,117,823,287
4,414,277,162,853,287
5,427,320,181,928,287
6,431,320,196,947,287
7,411,350,219,980,287
8,390,360,244,994,287
9,407,382,267,1056,287
10,390,373,290,1053,287
11,386,392,295,1073,287
1,500,200,50,750,288
2,445,232,110,787,288
3,439,248,138,825,288
4,425,275,166,866,288
5,416,297,199,912,288
6,420,305,228,953,288
7,417,333,238,988,288
8,406,356,247,1009,288
9,391,387,256,1034,288
10,376,399,276,1051,288
11,385,437,268,1090,288
1,500,200,50,750,289
2,443,258,92,793,289
3,413,273,137,823,289
4,421,293,176,890,289
5,385,327,194,906,289
6,403,338,211,952,289
7,406,334,253,993,289
8,374,359,253,986,289
9,385,406,241,1032,289
10,404,364,288,1056,289
11,417,382,294,1093,289
1,500,200,50,750,290
2,466,225,96,787,290
3,440,258,122,820,290
4,416,301,149,866,290
5,405,318,172,895,290
6,402,355,197,954,290
7,390,336,249,975,290
8,392,369,256,1017,290
9,399,380,241,1020,290
10,406,387,251,1044,290
11,398,396,286,1080,290
1,500,200,50,750,291
2,448,226,101,775,291
3,434,280,129,843,291
4,403,319,150,872,291
5,412,336,171,919,291
6,420,324,225,969,291
7,384,348,244,976,291
8,376,363,252,991,291
9,391,379,257,1027,291
10,398,392,264,1054,291
11,415,397,269,1081,291
1,500,200,50,750,292
2,458,218,108,784,292
3,439,237,150,826,292
4,421,277,180,878,292
5,401,329,188,918,292
6,400,358,192,950,292
7,406,356,233,995,292
8,398,354,236,988,292
9,386,389,244,1019,292
10,385,406,259,1050,292
11,400,430,270,1100,292
1,500,200,50,750,293
2,458,243,87,788,293
3,421,276,135,832,293
4,403,307,157,867,293
5,404,313,181,898,293
6,431,343,189,963,293
7,407,342,221,970,293
8,411,355,238,1004,293
9,400,367,265,1032,293
10,411,377,263,1051,293
11,423,382,279,1084,293
1,500,200,50,750,294
2,445,236,102,783,294
3,428,260,130,818,294
4,433,293,144,870,294
5,414,303,201,918,294
6,416,329,208,953,294
7,406,358,211,975,294
8,386,373,255,1014,294
9,380,390,255,1025,294
10,367,423,270,1060,294
11,392,417,284,1093,294
1,500,200,50,750,295
2,438,254,92,784,295
3,429,266,136,831,295
4,421,292,160,873,295
5,409,301,197,907,295
6,392,352,213,957,295
7,373,388,220,981,295
8,377,382,252,1011,295
9,377,377,265,1019,295
10,399,388,280,1067,295
11,379,392,291,1062,295
1,500,200,50,750,296
2,466,214,100,780,296
3,426,242,140,808,296
4,416,287,175,878,296
5,420,292,202,914,296
6,426,320,214,960,296
7,410,347,232,989,296
8,393,380,217,990,296
9,402,389,228,1019,296
10,411,394,251,1056,296
11,417,379,277,1073,296
1,500,200,50,750,297
2,449,244,88,781,297
3,430,289,107,826,297
4,406,305,156,867,297
5,427,305,177,909,297
6,435,330,205,970,297
7,415,336,232,983,297
8,404,357,242,1003,297
9,409,394,222,1025,297
10,413,397,251,1061,297
11,419,408,265,1092,297
1,500,200,50,750,298
2,474,226,103,803,298
3,449,240,143,832,298
4,421,258,187,866,298
5,405,297,195,897,298
6,406,331,223,960,298
7,384,350,239,973,298
8,363,354,279,996,298
9,384,374,270,1028,298
10,375,388,284,1047,298
11,409,381,289,1079,298
1,500,200,50,750,299
2,469,230,92,791,299
3,437,254,139,830,299
4,415,289,164,868,299
5,414,302,180,896,299
6,429,311,216,956,299
7,423,318,236,977,299
8,415,345,251,1011,299
9,413,356,247,1016,299
10,399,379,254,1032,299
11,434,390,273,1097,299
1,500,200,50,750,300
2,469,236,86,791,300
3,435,269,125,829,300
4,421,279,171,871,300
5,417,317,187,921,300
6,428,342,197,967,300
7,424,347,209,980,300
8,428,359,231,1018,300
9,414,373,241,1028,300
10,420,395,239,1054,300
11,418,402,271,1091,300
1,500,200,50,750,301
2,431,245,111,787,301
3,421,268,150,839,301
4,403,275,173,851,301
5,391,317,193,901,301
6,394,354,215,963,301
7,392,363,218,973,301
8,374,387,249,1010,301
9,356,401,259,1016,301
10,386,412,268,1066,301
11,386,424,278,1088,301
1,500,200,50,750,302
2,470,245,89,804,302
3,434,268,122,824,302
4,418,295,164,877,302
5,406,299,197,902,302
6,414,331,207,952,302
7,424,344,220,988,302
8,420,335,245,1000,302
9,441,360,246,1047,302
10,428,383,255,1066,302
11,415,369,293,1077,302
1,500,200,50,750,303
2,468,222,100,790,303
3,436,255,134,825,303
4,430,277,167,874,303
5,421,304,188,913,303
6,404,336,218,958,303
7,403,345,240,988,303
8,406,356,236,998,303
9,420,374,253,1047,303
10,411,376,275,1062,303
11,394,402,278,1074,303
1,500,200,50,750,304
2,476,235,76,787,304
3,437,266,117,820,304
4,433,289,153,875,304
5,431,319,165,915,304
6,421,333,202,956,304
7,419,342,211,972,304
8,419,366,230,1015,304
9,412,364,269,1045,304
10,391,390,271,1052,304
11,379,414,277,1070,304
1,500,200,50,750,305
2,460,236,89,785,305
3,424,263,142,829,305
4,406,303,146,855,305
5,404,341,164,909,305
6,416,343,200,959,305
7,393,359,223,975,305
8,388,389,229,1006,305
9,402,412,228,1042,305
10,392,398,262,1052,305
11,395,416,256,1067,305
1,500,200,50,750,306
2,449,240,90,779,306
3,401,278,124,803,306
4,399,297,169,865,306
5,408,329,203,940,306
6,399,342,213,954,306
7,392,348,232,972,306
8,404,358,239,1001,306
9,402,373,255,1030,306
10,401,407,242,1050,306
11,398,428,263,1089,306
1,500,200,50,750,307
2,454,243,94,791,307
3,425,278,128,831,307
4,387,318,157,862,307
5,363,343,210,916,307
6,375,360,221,956,307
7,373,372,228,973,307
8,380,378,243,1001,307
9,395,400,243,1038,307
10,380,415,265,1060,307
11,381,418,279,1078,307
1,500,200,50,750,308
2,466,229,99,794,308
3,424,275,132,831,308
4,415,306,149,870,308
5,398,313,209,920,308
6,381,334,222,937,308
7,396,364,218,978,308
8,389,375,227,991,308
9,405,363,256,1024,308
10,402,383,263,1048,308
11,397,429,273,1099,308
1,500,200,50,750,309
2,461,220,108,789,309
3,424,251,143,818,309
4,408,296,177,881,309
5,382,328,199,909,309
6,399,350,202,951,309
7,405,360,235,1000,309
8,384,379,241,1004,309
9,371,390,256,1017,309
10,384,418,251,1053,309
11,389,431,268,1088,309
1,500,200,50,750,310
2,452,230,103,785,310
3,448,258,128,834,310
4,434,278,150,862,310
5,433,285,208,926,310
6,411,320,221,952,310
7,401,349,223,973,310
8,399,364,237,1000,310
9,378,385,258,1021,310
10,391,402,267,1060,310
11,398,401,286,1085,310
1,500,200,50,750,311
2,468,222,107,797,311
3,448,242,142,832,311
4,425,282,157,864,311
5,420,322,157,899,311
6,423,346,184,953,311
7,438,342,207,987,311
8,410,347,239,996,311
9,408,388,260,1056,311
10,391,381,288,1060,311
11,375,426,287,1088,311
1,500,200,50,750,312
2,452,238,94,784,312
3,429,250,142,821,312
4,401,294,171,866,312
5,395,317,185,897,312
6,406,345,219,970,312
7,396,354,226,976,312
8,405,358,250,1013,312
9,386,365,271,1022,312
10,382,370,287,1039,312
11,393,393,289,1075,312
1,500,200,50,750,313
2,452,250,86,788,313
3,435,261,130,826,313
4,422,300,154,876,313
5,408,317,175,900,313
6,417,341,204,962,313
7,404,356,225,985,313
8,418,385,217,1020,313
9,415,383,228,1026,313
10,417,400,241,1058,313
11,405,403,277,1085,313
1,500,200,50,750,314
2,445,249,103,797,314
3,400,270,161,831,314
4,383,289,175,847,314
5,404,303,212,919,314
6,424,332,216,972,314
7,410,359,225,994,314
8,399,381,246,1026,314
9,395,396,245,1036,314
10,389,407,256,1052,314
11,396,430,268,1094,314
1,500,200,50,750,315
2,482,229,81,792,315
3,462,251,121,834,315
4,442,289,145,876,315
5,406,311,174,891,315
6,420,319,197,936,315
7,399,357,227,983,315
8,397,396,234,1027,315
9,386,379,260,1025,315
10,384,428,262,1074,315
11,384,419,280,1083,315
1,500,200,50,750,316
2,463,240,91,794,316
3,436,260,133,829,316
4,422,270,167,859,316
5,411,292,204,907,316
6,417,340,213,970,316
7,403,329,234,966,316
8,412,359,239,1010,316
9,392,379,256,1027,316
10,394,378,279,1051,316
11,381,413,276,1070,316
1,500,200,50,750,317
2,465,230,86,781,317
3,443,267,124,834,317
4,425,276,171,872,317
5,424,281,200,905,317
6,428,313,224,965,317
7,399,366,216,981,317
8,393,366,244,1003,317
9,383,372,255,1010,317
10,387,401,264,1052,317
11,400,414,269,1083,317
1,500,200,50,750,318
2,446,230,103,779,318
3,425,252,146,823,318
4,416,298,165,879,318
5,396,315,182,893,318
6,415,343,215,973,318
7,411,354,226,991,318
8,391,365,238,994,318
9,408,386,232,1026,318
10,437,384,252,1073,318
11,420,373,289,1082,318
1,500,200,50,750,319
2,454,230,99,783,319
3,421,258,145,824,319
4,417,308,146,871,319
5,412,308,199,919,319
6,406,353,204,963,319
7,405,353,216,974,319
8,402,355,260,1017,319
9,389,379,248,1016,319
10,411,378,264,1053,319
11,413,398,281,1092,319
1,500,200,50,750,320
2,462,240,101,803,320
3,421,277,135,833,320
4,404,322,152,878,320
5,388,331,191,910,320
6,392,350,212,954,320
7,374,358,235,967,320
8,378,392,239,1009,320
9,375,415,248,1038,320
10,371,423,255,1049,320
11,407,423,263,1093,320
1,500,200,50,750,321
2,461,227,95,783,321
3,452,260,126,838,321
4,413,305,159,877,321
5,399,315,183,897,321
6,408,346,193,947,321
7,399,350,219,968,321
8,390,373,228,991,321
9,405,381,239,1025,321
10,397,384,281,1062,321
11,396,418,264,1078,321
1,500,200,50,750,322
2,477,214,104,795,322
3,447,257,132,836,322
4,418,277,168,863,322
5,426,290,201,917,322
6,427,292,237,956,322
7,408,340,224,972,322
8,414,345,231,990,322
9,399,368,248,1015,322
10,408,405,253,1066,322
11,390,414,271,1075,322
1,500,200,50,750,323
2,457,224,100,781,323
3,427,255,141,823,323
4,416,295,153,864,323
5,401,321,183,905,323
6,405,328,216,949,323
7,373,369,231,973,323
8,368,390,250,1008,323
9,373,394,268,1035,323
10,383,389,283,1055,323
11,413,419,274,1106,323
1,500,200,50,750,324
2,473,239,91,803,324
3,451,269,115,835,324
4,410,299,149,858,324
5,411,331,180,922,324
6,377,384,195,956,324
7,373,387,232,992,324
8,364,398,243,1005,324
9,356,417,253,1026,324
10,379,398,269,1046,324
11,406,427,277,1110,324
1,500,200,50,750,325
2,439,238,101,778,325
3,397,286,138,821,325
4,398,304,168,870,325
5,397,315,196,908,325
6,405,334,223,962,325
7,399,345,247,991,325
8,387,364,243,994,325
9,393,391,253,1037,325
10,409,395,263,1067,325
11,410,401,262,1073,325
1,500,200,50,750,326
2,465,224,94,783,326
3,439,257,131,827,326
4,414,289,155,858,326
5,399,313,179,891,326
6,430,353,193,976,326
7,400,358,221,979,326
8,406,379,239,1024,326
9,385,383,263,1031,326
10,407,368,281,1056,326
11,400,392,285,1077,326
1,500,200,50,750,327
2,476,228,82,786,327
3,469,249,116,834,327
4,426,268,164,858,327
5,393,322,180,895,327
6,403,357,195,955,327
7,377,366,228,971,327
8,399,382,240,1021,327
9,393,363,281,1037,327
10,406,392,259,1057,327
11,418,392,275,1085,327
1,500,200,50,750,328
2,454,233,90,777,328
3,420,293,126,839,328
4,403,302,166,871,328
5,414,333,173,920,328
6,415,371,184,970,328
7,393,378,216,987,328
8,373,384,238,995,328
9,389,399,243,1031,328
10,389,407,254,1050,328
11,406,400,267,1073,328
1,500,200,50,750,329
2,470,233,106,809,329
3,430,263,141,834,329
4,398,307,158,863,329
5,390,337,183,910,329
6,392,357,216,965,329
7,392,361,233,986,329
8,391,389,252,1032,329
9,350,409,267,1026,329
10,372,439,247,1058,329
11,380,452,261,1093,329
1,500,200,50,750,330
2,461,231,82,774,330
3,419,270,131,820,330
4,416,269,184,869,330
5,395,316,210,921,330
6,385,325,244,954,330
7,401,342,265,1008,330
8,382,359,260,1001,330
9,376,371,278,1025,330
10,385,388,287,1060,330
11,407,401,302,1110,330
1,500,200,50,750,331
2,454,233,101,788,331
3,416,278,135,829,331
4,406,294,171,871,331
5,414,309,186,909,331
6,426,347,203,976,331
7,400,372,208,980,331
8,406,391,227,1024,331
9,386,397,249,1032,331
10,364,413,266,1043,331
11,395,437,265,1097,331
1,500,200,50,750,332
2,454,209,119,782,332
3,425,263,150,838,332
4,403,288,181,872,332
5,408,295,213,916,332
6,409,333,216,958,332
7,390,359,237,986,332
8,378,370,244,992,332
9,403,382,252,1037,332
10,402,415,237,1054,332
11,407,401,277,1085,332
1,500,200,50,750,333
2,445,263,96,804,333
3,402,285,142,829,333
4,407,282,188,877,333
5,396,344,185,925,333
6,393,349,227,969,333
7,381,356,243,980,333
8,381,362,249,992,333
9,391,364,255,1010,333
10,406,373,282,1061,333
11,390,387,288,1065,333
1,500,200,50,750,334
2,481,222,88,791,334
3,460,248,128,836,334
4,442,271,156,869,334
5,427,287,187,901,334
6,440,329,206,975,334
7,422,333,227,982,334
8,437,365,225,1027,334
9,431,368,233,1032,334
10,402,391,263,1056,334
11,391,419,270,1080,334
1,500,200,50,750,335
2,465,227,84,776,335
3,454,253,118,825,335
4,448,295,143,886,335
5,427,311,173,911,335
6,439,323,204,966,335
7,418,362,206,986,335
8,403,389,223,1015,335
9,403,373,251,1027,335
10,413,387,273,1073,335
11,389,400,282,1071,335
1,500,200,50,750,336
2,452,232,96,780,336
3,435,257,132,824,336
4,418,266,179,863,336
5,415,298,187,900,336
6,399,326,209,934,336
7,398,340,235,973,336
8,412,355,257,1024,336
9,412,362,257,1031,336
10,412,357,282,1051,336
11,422,380,282,1084,336
1,500,200,50,750,337
2,437,224,115,776,337
3,433,255,143,831,337
4,409,292,146,847,337
5,406,323,186,915,337
6,398,336,209,943,337
7,383,356,232,971,337
8,393,379,236,1008,337
9,392,386,258,1036,337
10,388,391,275,1054,337
11,392,410,275,1077,337
1,500,200,50,750,338
2,447,238,98,783,338
3,411,261,142,814,338
4,410,284,181,875,338
5,398,295,218,911,338
6,407,324,223,954,338
7,390,357,232,979,338
8,401,347,248,996,338
9,431,346,268,1045,338
10,418,359,289,1066,338
11,394,396,290,1080,338
1,500,200,50,750,339
2,433,243,94,770,339
3,436,275,112,823,339
4,440,280,137,857,339
5,442,313,166,921,339
6,438,328,204,970,339
7,418,341,229,988,339
8,409,359,234,1002,339
9,413,370,250,1033,339
10,414,393,249,1056,339
11,423,402,266,1091,339
1,500,200,50,750,340
2,444,222,100,766,340
3,443,268,135,846,340
4,439,285,159,883,340
5,427,293,201,921,340
6,408,304,241,953,340
7,409,353,224,986,340
8,416,367,231,1014,340
9,398,395,240,1033,340
10,394,417,245,1056,340
11,407,421,255,1083,340
1,500,200,50,750,341
2,448,219,120,787,341
3,431,244,159,834,341
4,393,298,170,861,341
5,404,327,186,917,341
6,410,356,199,965,341
7,394,392,200,986,341
8,374,392,235,1001,341
9,391,386,242,1019,341
10,391,431,248,1070,341
11,387,415,278,1080,341
1,500,200,50,750,342
2,465,226,91,782,342
3,451,238,138,827,342
4,418,287,161,866,342
5,412,327,186,925,342
6,390,347,209,946,342
7,393,366,212,971,342
8,391,378,241,1010,342
9,395,385,251,1031,342
10,380,403,261,1044,342
11,390,412,278,1080,342
1,500,200,50,750,343
2,438,259,92,789,343
3,413,287,120,820,343
4,402,291,161,854,343
5,409,322,175,906,343
6,395,344,212,951,343
7,400,360,217,977,343
8,405,375,236,1016,343
9,383,385,248,1016,343
10,376,408,265,1049,343
11,377,428,284,1089,343
1,500,200,50,750,344
2,447,233,110,790,344
3,418,262,153,833,344
4,416,280,167,863,344
5,404,310,200,914,344
6,409,324,205,938,344
7,412,340,226,978,344
8,440,354,231,1025,344
9,411,366,250,1027,344
10,409,386,259,1054,344
11,404,405,276,1085,344
1,500,200,50,750,345
2,440,234,101,775,345
3,417,264,132,813,345
4,409,295,164,868,345
5,372,350,189,911,345
6,376,364,224,964,345
7,371,382,225,978,345
8,369,374,266,1009,345
9,386,401,253,1040,345
10,382,412,258,1052,345
11,368,416,275,1059,345
1,500,200,50,750,346
2,461,224,106,791,346
3,425,250,146,821,346
4,392,301,164,857,346
5,399,326,193,918,346
6,406,330,228,964,346
7,396,349,237,982,346
8,406,367,234,1007,346
9,412,391,235,1038,346
10,392,414,235,1041,346
11,447,422,251,1120,346
1,500,200,50,750,347
2,472,235,101,808,347
3,426,254,138,818,347
4,429,296,165,890,347
5,407,316,185,908,347
6,390,348,203,941,347
7,419,355,213,987,347
8,410,355,245,1010,347
9,398,370,256,1024,347
10,413,396,263,1072,347
11,412,399,267,1078,347
1,500,200,50,750,348
2,472,211,96,779,348
3,469,237,127,833,348
4,429,266,180,875,348
5,397,306,206,909,348
6,381,344,217,942,348
7,386,357,228,971,348
8,380,392,235,1007,348
9,397,395,245,1037,348
10,392,416,259,1067,348
11,383,420,270,1073,348
1,500,200,50,750,349
2,474,239,74,787,349
3,425,276,115,816,349
4,433,280,159,872,349
5,414,309,189,912,349
6,412,327,208,947,349
7,422,345,212,979,349
8,402,353,249,1004,349
9,409,377,248,1034,349
10,391,389,256,1036,349
11,396,424,254,1074,349
1,500,200,50,750,350
2,453,226,111,790,350
3,425,233,163,821,350
4,415,252,188,855,350
5,407,302,186,895,350
6,405,350,207,962,350
7,376,353,240,969,350
8,370,368,245,983,350
9,386,410,235,1031,350
10,411,403,258,1072,350
11,403,400,279,1082,350
1,500,200,50,750,351
2,452,244,99,795,351
3,407,278,134,819,351
4,412,300,170,882,351
5,407,318,186,911,351
6,408,355,212,975,351
7,392,363,219,974,351
8,393,397,220,1010,351
9,394,393,228,1015,351
10,421,390,231,1042,351
11,424,402,248,1074,351
1,500,200,50,750,352
2,465,235,95,795,352
3,439,264,129,832,352
4,412,288,161,861,352
5,399,298,197,894,352
6,431,314,214,959,352
7,405,346,224,975,352
8,407,355,248,1010,352
9,395,370,268,1033,352
10,399,402,268,1069,352
11,402,425,271,1098,352
1,500,200,50,750,353
2,450,251,101,802,353
3,424,265,128,817,353
4,415,290,171,876,353
5,409,299,190,898,353
6,428,323,207,958,353
7,406,337,223,966,353
8,406,363,231,1000,353
9,386,388,257,1031,353
10,382,397,276,1055,353
11,391,432,272,1095,353
1,500,200,50,750,354
2,449,242,101,792,354
3,433,250,143,826,354
4,409,280,177,866,354
5,407,320,194,921,354
6,399,360,211,970,354
7,380,358,230,968,354
8,392,378,241,1011,354
9,389,384,256,1029,354
10,411,409,260,1080,354
11,393,417,256,1066,354
1,500,200,50,750,355
2,464,233,93,790,355
3,419,259,148,826,355
4,393,293,167,853,355
5,421,319,188,928,355
6,436,338,190,964,355
7,410,349,219,978,355
8,397,352,239,988,355
9,414,369,251,1034,355
10,419,366,275,1060,355
11,398,393,286,1077,355
1,500,200,50,750,356
2,463,253,81,797,356
3,431,284,105,820,356
4,415,302,154,871,356
5,404,320,179,903,356
6,410,324,225,959,356
7,383,339,235,957,356
8,387,361,236,984,356
9,397,377,264,1038,356
10,396,384,268,1048,356
11,419,393,279,1091,356
1,500,200,50,750,357
2,462,213,108,783,357
3,418,251,140,809,357
4,413,305,152,870,357
5,420,318,182,920,357
6,416,341,206,963,357
7,388,378,207,973,357
8,377,392,245,1014,357
9,380,400,267,1047,357
10,399,388,278,1065,357
11,391,392,277,1060,357
1,500,200,50,750,358
2,456,242,81,779,358
3,420,290,126,836,358
4,382,317,169,868,358
5,377,339,194,910,358
6,403,332,222,957,358
7,403,363,221,987,358
8,394,383,228,1005,358
9,404,382,251,1037,358
10,388,386,285,1059,358
11,400,416,274,1090,358
1,500,200,50,750,359
2,427,257,95,779,359
3,416,291,138,845,359
4,405,305,168,878,359
5,397,312,197,906,359
6,402,337,212,951,359
7,390,352,241,983,359
8,405,376,232,1013,359
9,398,384,261,1043,359
10,393,376,278,1047,359
11,392,399,282,1073,359
1,500,200,50,750,360
2,479,233,89,801,360
3,442,251,117,810,360
4,429,276,161,866,360
5,425,305,173,903,360
6,421,359,175,955,360
7,403,379,207,989,360
8,394,379,227,1000,360
9,384,407,242,1033,360
10,413,419,231,1063,360
11,406,425,260,1091,360
1,500,200,50,750,361
2,461,220,114,795,361
3,416,251,156,823,361
4,391,294,175,860,361
5,412,303,190,905,361
6,409,326,220,955,361
7,388,330,256,974,361
8,398,353,269,1020,361
9,358,388,283,1029,361
10,397,408,268,1073,361
11,401,420,271,1092,361
1,500,200,50,750,362
2,456,209,112,777,362
3,440,253,139,832,362
4,422,280,167,869,362
5,432,318,176,926,362
6,398,336,202,936,362
7,412,343,227,982,362
8,413,367,239,1019,362
9,419,389,239,1047,362
10,401,400,247,1048,362
11,427,410,261,1098,362
1,500,200,50,750,363
2,461,229,102,792,363
3,449,262,131,842,363
4,396,305,171,872,363
5,393,313,196,902,363
6,394,349,211,954,363
7,401,351,232,984,363
8,381,352,251,984,363
9,377,394,273,1044,363
10,382,399,274,1055,363
11,372,426,288,1086,363
1,500,200,50,750,364
2,474,225,102,801,364
3,423,274,137,834,364
4,403,295,166,864,364
5,405,321,184,910,364
6,396,351,208,955,364
7,414,347,225,986,364
8,396,343,250,989,364
9,412,380,234,1026,364
10,425,378,248,1051,364
11,425,386,258,1069,364
1,500,200,50,750,365
2,464,220,115,799,365
3,411,277,146,834,365
4,399,307,170,876,365
5,405,338,173,916,365
6,401,340,212,953,365
7,395,366,218,979,365
8,412,363,235,1010,365
9,404,390,242,1036,365
10,430,390,248,1068,365
11,424,415,262,1101,365
1,500,200,50,750,366
2,464,232,95,791,366
3,427,258,137,822,366
4,421,283,170,874,366
5,415,292,207,914,366
6,415,322,225,962,366
7,400,364,224,988,366
8,387,383,227,997,366
9,404,382,240,1026,366
10,444,360,258,1062,366
11,435,397,257,1089,366
1,500,200,50,750,367
2,454,240,82,776,367
3,438,251,142,831,367
4,410,291,166,867,367
5,409,318,196,923,367
6,410,353,191,954,367
7,391,345,242,978,367
8,380,364,260,1004,367
9,370,406,251,1027,367
10,362,414,289,1065,367
11,390,436,262,1088,367
1,500,200,50,750,368
2,441,243,101,785,368
3,408,279,145,832,368
4,388,297,182,867,368
5,389,300,209,898,368
6,407,355,209,971,368
7,394,364,224,982,368
8,393,362,268,1023,368
9,364,387,271,1022,368
10,390,380,286,1056,368
11,391,400,290,1081,368
1,500,200,50,750,369
2,456,234,92,782,369
3,427,249,132,808,369
4,420,293,159,872,369
5,386,326,182,894,369
6,398,353,210,961,369
7,380,376,228,984,369
8,405,361,255,1021,369
9,383,378,265,1026,369
10,386,408,277,1071,369
11,383,410,290,1083,369
1,500,200,50,750,370
2,467,233,89,789,370
3,440,247,138,825,370
4,423,289,163,875,370
5,406,301,207,914,370
6,383,327,239,949,370
7,388,350,238,976,370
8,371,361,260,992,370
9,389,377,265,1031,370
10,400,389,272,1061,370
11,398,425,267,1090,370
1,500,200,50,750,371
2,464,231,96,791,371
3,433,257,131,821,371
4,422,296,170,888,371
5,399,321,182,902,371
6,393,341,211,945,371
7,390,350,251,991,371
8,400,361,236,997,371
9,410,385,238,1033,371
10,411,393,251,1055,371
11,413,390,269,1072,371
1,500,200,50,750,372
2,455,237,98,790,372
3,432,269,130,831,372
4,411,321,138,870,372
5,384,326,187,897,372
6,400,344,210,954,372
7,388,347,240,975,372
8,397,366,251,1014,372
9,391,384,263,1038,372
10,391,399,257,1047,372
11,411,396,269,1076,372
1,500,200,50,750,373
2,455,236,91,782,373
3,443,250,140,833,373
4,408,286,179,873,373
5,387,320,200,907,373
6,420,346,206,972,373
7,417,366,198,981,373
8,406,378,233,1017,373
9,382,385,267,1034,373
10,391,394,268,1053,373
11,386,404,290,1080,373
1,500,200,50,750,374
2,455,223,112,790,374
3,427,262,138,827,374
4,412,296,170,878,374
5,402,312,201,915,374
6,396,330,208,934,374
7,407,361,212,980,374
8,401,361,242,1004,374
9,412,386,243,1041,374
10,428,384,247,1059,374
11,399,405,269,1073,374
1,500,200,50,750,375
2,447,242,95,784,375
3,426,272,129,827,375
4,405,293,151,849,375
5,405,319,188,912,375
6,400,336,214,950,375
7,394,357,234,985,375
8,394,342,272,1008,375
9,411,372,268,1051,375
10,397,382,280,1059,375
11,417,395,280,1092,375
1,500,200,50,750,376
2,473,223,99,795,376
3,438,254,126,818,376
4,432,269,165,866,376
5,415,317,183,915,376
6,405,338,201,944,376
7,397,349,226,972,376
8,396,378,240,1014,376
9,404,373,242,1019,376
10,401,389,252,1042,376
11,422,410,258,1090,376
1,500,200,50,750,377
2,465,232,94,791,377
3,430,287,116,833,377
4,421,311,142,874,377
5,392,343,179,914,377
6,407,336,211,954,377
7,390,349,239,978,377
8,386,362,242,990,377
9,415,371,252,1038,377
10,419,364,281,1064,377
11,407,390,280,1077,377
1,500,200,50,750,378
2,462,243,86,791,378
3,416,257,145,818,378
4,382,290,183,855,378
5,408,307,208,923,378
6,409,338,204,951,378
7,413,342,222,977,378
8,418,355,237,1010,378
9,392,374,261,1027,378
10,381,399,264,1044,378
11,374,410,280,1064,378
1,500,200,50,750,379
2,478,220,88,786,379
3,431,272,129,832,379
4,417,301,154,872,379
5,386,316,185,887,379
6,404,327,222,953,379
7,386,353,237,976,379
8,368,374,254,996,379
9,387,396,252,1035,379
10,401,376,279,1056,379
11,400,407,274,1081,379
1,500,200,50,750,380
2,440,251,98,789,380
3,412,277,144,833,380
4,394,303,163,860,380
5,380,320,187,887,380
6,395,347,202,944,380
7,382,375,222,979,380
8,392,365,252,1009,380
9,386,400,255,1041,380
10,370,415,274,1059,380
11,389,435,264,1088,380
1,500,200,50,750,381
2,473,233,85,791,381
3,434,266,119,819,381
4,402,292,172,866,381
5,388,334,189,911,381
6,420,343,212,975,381
7,405,343,239,987,381
8,402,360,261,1023,381
9,392,387,252,1031,381
10,379,392,271,1042,381
11,422,413,269,1104,381
1,500,200,50,750,382
2,451,225,106,782,382
3,435,243,154,832,382
4,402,272,186,860,382
5,397,275,213,885,382
6,412,316,226,954,382
7,418,339,236,993,382
8,401,387,224,1012,382
9,397,388,250,1035,382
10,394,415,260,1069,382
11,376,430,276,1082,382
1,500,200,50,750,383
2,448,223,103,774,383
3,438,264,128,830,383
4,426,289,163,878,383
5,414,328,190,932,383
6,390,334,213,937,383
7,415,330,240,985,383
8,387,364,263,1014,383
9,396,363,275,1034,383
10,421,400,256,1077,383
11,390,408,285,1083,383
1,500,200,50,750,384
2,461,232,98,791,384
3,430,241,159,830,384
4,433,289,155,877,384
5,435,299,170,904,384
6,425,324,195,944,384
7,408,357,209,974,384
8,417,350,233,1000,384
9,406,372,247,1025,384
10,409,383,261,1053,384
11,412,396,281,1089,384
1,500,200,50,750,385
2,466,249,87,802,385
3,418,284,127,829,385
4,426,294,150,870,385
5,435,307,168,910,385
6,422,341,186,949,385
7,394,364,214,972,385
8,386,382,237,1005,385
9,388,398,245,1031,385
10,388,402,277,1067,385
11,390,420,276,1086,385
1,500,200,50,750,386
2,457,228,101,786,386
3,435,248,136,819,386
4,450,275,159,884,386
5,429,279,188,896,386
6,432,328,203,963,386
7,414,359,200,973,386
8,389,368,228,985,386
9,406,373,251,1030,386
10,419,394,256,1069,386
11,375,413,273,1061,386
1,500,200,50,750,387
2,464,221,104,789,387
3,418,271,133,822,387
4,403,303,168,874,387
5,397,320,187,904,387
6,397,357,196,950,387
7,409,374,208,991,387
8,393,380,229,1002,387
9,387,399,247,1033,387
10,406,396,248,1050,387
11,410,405,254,1069,387
1,500,200,50,750,388
2,450,251,95,796,388
3,425,277,136,838,388
4,402,287,169,858,388
5,419,330,184,933,388
6,417,314,210,941,388
7,424,340,248,1012,388
8,409,358,238,1005,388
9,414,372,250,1036,388
10,424,393,248,1065,388
11,424,385,279,1088,388
1,500,200,50,750,389
2,455,243,79,777,389
3,442,280,113,835,389
4,417,302,156,875,389
5,422,322,182,926,389
6,404,347,202,953,389
7,378,357,238,973,389
8,389,363,250,1002,389
9,399,381,244,1024,389
10,414,384,259,1057,389
11,438,389,266,1093,389
1,500,200,50,750,390
2,463,224,84,771,390
3,441,237,131,809,390
4,447,276,162,885,390
5,419,299,190,908,390
6,445,325,199,969,390
7,411,355,220,986,390
8,396,384,239,1019,390
9,399,373,262,1034,390
10,392,386,269,1047,390
11,407,403,280,1090,390
1,500,200,50,750,391
2,460,236,95,791,391
3,440,262,121,823,391
4,420,292,159,871,391
5,396,313,195,904,391
6,418,318,222,958,391
7,410,340,234,984,391
8,400,377,240,1017,391
9,398,381,264,1043,391
10,432,384,248,1064,391
11,423,390,272,1085,391
1,500,200,50,750,392
2,440,247,110,797,392
3,409,293,137,839,392
4,390,300,169,859,392
5,389,352,177,918,392
6,407,367,195,969,392
7,395,389,203,987,392
8,391,387,241,1019,392
9,386,403,252,1041,392
10,363,413,270,1046,392
11,395,421,276,1092,392
1,500,200,50,750,393
2,460,249,91,800,393
3,427,273,129,829,393
4,387,298,172,857,393
5,398,310,208,916,393
6,397,343,209,949,393
7,390,357,236,983,393
8,360,397,249,1006,393
9,364,407,261,1032,393
10,376,416,260,1052,393
11,362,430,280,1072,393
1,500,200,50,750,394
2,442,238,108,788,394
3,435,255,138,828,394
4,431,273,167,871,394
5,401,302,203,906,394
6,397,305,236,938,394
7,383,341,254,978,394
8,385,364,261,1010,394
9,385,388,262,1035,394
10,385,392,274,1051,394
11,405,396,261,1062,394
1,500,200,50,750,395
2,449,240,105,794,395
3,414,279,129,822,395
4,408,287,184,879,395
5,389,319,194,902,395
6,404,349,225,978,395
7,366,358,257,981,395
8,361,376,274,1011,395
9,357,388,285,1030,395
10,382,395,288,1065,395
11,383,405,287,1075,395
1,500,200,50,750,396
2,464,247,92,803,396
3,436,276,114,826,396
4,424,281,155,860,396
5,384,334,184,902,396
6,377,349,217,943,396
7,383,356,240,979,396
8,380,390,233,1003,396
9,400,397,254,1051,396
10,380,404,271,1055,396
11,397,404,288,1089,396
1,500,200,50,750,397
2,471,236,90,797,397
3,441,252,137,830,397
4,422,290,164,876,397
5,416,325,174,915,397
6,391,336,205,932,397
7,388,370,217,975,397
8,379,400,234,1013,397
9,370,397,240,1007,397
10,408,395,259,1062,397
11,412,413,275,1100,397
1,500,200,50,750,398
2,459,244,89,792,398
3,430,267,135,832,398
4,418,279,157,854,398
5,405,296,183,884,398
6,403,327,209,939,398
7,397,346,220,963,398
8,385,372,218,975,398
9,399,377,247,1023,398
10,404,372,275,1051,398
11,402,400,273,1075,398
1,500,200,50,750,399
2,428,260,93,781,399
3,404,301,140,845,399
4,380,302,166,848,399
5,398,311,202,911,399
6,404,322,211,937,399
7,405,344,230,979,399
8,404,358,247,1009,399
9,396,372,260,1028,399
10,383,393,276,1052,399
11,376,405,286,1067,399
1,500,200,50,750,400
2,448,233,97,778,400
3,420,281,133,834,400
4,397,310,154,861,400
5,398,334,170,902,400
6,403,330,218,951,400
7,392,335,241,968,400
8,418,347,263,1028,400
9,409,354,259,1022,400
10,377,382,279,1038,400
11,383,398,309,1090,400
1,500,200,50,750,401
2,464,235,94,793,401
3,434,258,131,823,401
4,413,285,170,868,401
5,428,306,193,927,401
6,420,309,218,947,401
7,425,338,226,989,401
8,417,374,229,1020,401
9,415,365,253,1033,401
10,419,371,276,1066,401
11,422,391,267,1080,401
1,500,200,50,750,402
2,452,238,105,795,402
3,424,273,136,833,402
4,404,299,157,860,402
5,392,345,160,897,402
6,408,345,200,953,402
7,407,345,220,972,402
8,411,351,234,996,402
9,414,357,251,1022,402
10,411,397,258,1066,402
11,391,409,271,1071,402
1,500,200,50,750,403
2,445,245,101,791,403
3,425,268,130,823,403
4,423,287,168,878,403
5,410,314,180,904,403
6,409,330,214,953,403
7,418,354,221,993,403
8,368,388,236,992,403
9,386,385,245,1016,403
10,389,408,264,1061,403
11,402,388,286,1076,403
1,500,200,50,750,404
2,451,221,108,780,404
3,443,236,157,836,404
4,426,267,166,859,404
5,427,305,183,915,404
6,418,345,194,957,404
7,402,355,221,978,404
8,398,387,224,1009,404
9,403,390,247,1040,404
10,406,378,273,1057,404
11,406,397,280,1083,404
1,500,200,50,750,405
2,456,218,114,788,405
3,436,254,147,837,405
4,414,297,159,870,405
5,426,310,179,915,405
6,434,334,204,972,405
7,433,337,208,978,405
8,430,347,234,1011,405
9,425,368,240,1033,405
10,430,368,264,1062,405
11,417,391,270,1078,405
1,500,200,50,750,406
2,468,229,90,787,406
3,449,259,114,822,406
4,436,282,152,870,406
5,431,304,186,921,406
6,421,319,214,954,406
7,393,344,243,980,406
8,401,366,251,1018,406
9,401,387,247,1035,406
10,397,404,248,1049,406
11,403,417,270,1090,406
1,500,200,50,750,407
2,459,237,95,791,407
3,424,264,146,834,407
4,411,271,183,865,407
5,384,316,192,892,407
6,429,348,194,971,407
7,421,370,196,987,407
8,421,366,218,1005,407
9,413,370,241,1024,407
10,403,372,258,1033,407
11,408,408,253,1069,407
1,500,200,50,750,408
2,461,245,83,789,408
3,441,274,119,834,408
4,414,298,148,860,408
5,417,320,187,924,408
6,435,321,208,964,408
7,414,331,230,975,408
8,407,370,220,997,408
9,401,386,231,1018,408
10,404,402,253,1059,408
11,405,417,281,1103,408
1,500,200,50,750,409
2,459,230,95,784,409
3,431,273,133,837,409
4,394,314,161,869,409
5,398,326,199,923,409
6,406,339,205,950,409
7,385,369,227,981,409
8,395,365,243,1003,409
9,411,384,243,1038,409
10,401,392,269,1062,409
11,392,394,304,1090,409
1,500,200,50,750,410
2,467,218,98,783,410
3,442,246,138,826,410
4,426,283,162,871,410
5,399,323,187,909,410
6,411,342,203,956,410
7,387,364,233,984,410
8,384,388,235,1007,410
9,404,388,254,1046,410
10,391,395,274,1060,410
11,380,404,292,1076,410
1,500,200,50,750,411
2,448,232,111,791,411
3,424,254,132,810,411
4,411,301,158,870,411
5,391,325,175,891,411
6,410,362,193,965,411
7,392,364,224,980,411
8,388,386,234,1008,411
9,393,399,253,1045,411
10,385,403,275,1063,411
11,374,417,295,1086,411
1,500,200,50,750,412
2,475,225,85,785,412
3,447,250,132,829,412
4,438,282,161,881,412
5,427,296,190,913,412
6,427,331,204,962,412
7,419,336,217,972,412
8,418,358,235,1011,412
9,406,370,262,1038,412
10,410,398,253,1061,412
11,405,403,255,1063,412
1,500,200,50,750,413
2,454,246,92,792,413
3,413,273,133,819,413
4,402,301,163,866,413
5,402,329,182,913,413
6,390,346,211,947,413
7,402,363,221,986,413
8,391,379,231,1001,413
9,392,369,251,1012,413
10,413,382,262,1057,413
11,391,404,289,1084,413
1,500,200,50,750,414
2,446,232,103,781,414
3,423,264,145,832,414
4,406,306,153,865,414
5,380,346,176,902,414
6,390,363,212,965,414
7,400,369,220,989,414
8,399,363,242,1004,414
9,417,380,237,1034,414
10,403,389,258,1050,414
11,401,418,253,1072,414
1,500,200,50,750,415
2,462,231,101,794,415
3,429,265,118,812,415
4,410,305,146,861,415
5,434,310,181,925,415
6,441,313,200,954,415
7,422,348,224,994,415
8,394,351,253,998,415
9,412,357,277,1046,415
10,374,390,284,1048,415
11,381,394,301,1076,415
1,500,200,50,750,416
2,461,246,96,803,416
3,436,263,126,825,416
4,422,309,147,878,416
5,401,323,188,912,416
6,395,348,207,950,416
7,395,359,224,978,416
8,424,354,235,1013,416
9,403,358,260,1021,416
10,406,372,275,1053,416
11,404,412,256,1072,416
1,500,200,50,750,417
2,465,213,104,782,417
3,437,272,123,832,417
4,409,307,155,871,417
5,401,313,185,899,417
6,391,349,202,942,417
7,397,351,229,977,417
8,389,363,251,1003,417
9,389,373,252,1014,417
10,427,367,268,1062,417
11,424,378,278,1080,417
1,500,200,50,750,418
2,441,239,87,767,418
3,423,257,136,816,418
4,412,260,180,852,418
5,415,299,201,915,418
6,413,320,221,954,418
7,410,349,233,992,418
8,409,368,248,1025,418
9,398,378,261,1037,418
10,402,387,272,1061,418
11,407,417,275,1099,418
1,500,200,50,750,419
2,456,252,91,799,419
3,416,273,130,819,419
4,428,289,159,876,419
5,410,304,202,916,419
6,412,341,224,977,419
7,386,361,238,985,419
8,372,375,245,992,419
9,380,387,262,1029,419
10,390,399,273,1062,419
11,386,400,299,1085,419
1,500,200,50,750,420
2,446,241,96,783,420
3,430,251,143,824,420
4,423,287,163,873,420
5,433,304,182,919,420
6,438,313,197,948,420
7,422,347,208,977,420
8,412,359,238,1009,420
9,421,378,244,1043,420
10,389,399,262,1050,420
11,379,387,309,1075,420
1,500,200,50,750,421
2,470,219,105,794,421
3,443,258,126,827,421
4,427,278,154,859,421
5,433,279,184,896,421
6,433,318,207,958,421
7,414,334,223,971,421
8,391,372,234,997,421
9,398,344,291,1033,421
10,413,372,288,1073,421
11,400,418,265,1083,421
1,500,200,50,750,422
2,465,222,105,792,422
3,435,259,137,831,422
4,407,291,175,873,422
5,404,311,195,910,422
6,385,355,217,957,422
7,390,363,232,985,422
8,385,355,259,999,422
9,383,363,278,1024,422
10,394,391,276,1061,422
11,393,397,274,1064,422
1,500,200,50,750,423
2,443,230,103,776,423
3,410,283,131,824,423
4,409,309,151,869,423
5,404,317,183,904,423
6,402,368,180,950,423
7,402,357,220,979,423
8,424,364,227,1015,423
9,403,379,234,1016,423
10,416,402,236,1054,423
11,421,411,252,1084,423
1,500,200,50,750,424
2,479,220,102,801,424
3,449,258,129,836,424
4,416,287,169,872,424
5,416,294,213,923,424
6,404,347,209,960,424
7,381,354,238,973,424
8,402,350,255,1007,424
9,413,361,268,1042,424
10,417,379,276,1072,424
11,398,392,288,1078,424
1,500,200,50,750,425
2,479,238,87,804,425
3,433,245,140,818,425
4,422,288,157,867,425
5,419,309,182,910,425
6,416,334,200,950,425
7,409,332,231,972,425
8,404,345,263,1012,425
9,407,359,266,1032,425
10,390,401,272,1063,425
11,402,430,271,1103,425
1,500,200,50,750,426
2,453,219,99,771,426
3,428,270,115,813,426
4,429,283,155,867,426
5,408,307,195,910,426
6,400,330,221,951,426
7,400,338,248,986,426
8,379,362,261,1002,426
9,397,369,254,1020,426
10,397,377,261,1035,426
11,415,387,263,1065,426
1,500,200,50,750,427
2,449,232,107,788,427
3,407,267,151,825,427
4,398,308,165,871,427
5,387,323,185,895,427
6,399,353,207,959,427
7,373,353,246,972,427
8,389,371,257,1017,427
9,406,386,256,1048,427
10,404,403,261,1068,427
11,395,413,278,1086,427
1,500,200,50,750,428
2,438,232,114,784,428
3,431,259,129,819,428
4,412,301,156,869,428
5,402,316,200,918,428
6,397,327,226,950,428
7,387,350,236,973,428
8,382,364,272,1018,428
9,362,380,283,1025,428
10,360,397,280,1037,428
11,395,413,291,1099,428
1,500,200,50,750,429
2,459,221,112,792,429
3,423,285,124,832,429
4,410,296,168,874,429
5,419,295,195,909,429
6,404,339,216,959,429
7,397,374,214,985,429
8,413,375,232,1020,429
9,421,380,244,1045,429
10,407,396,266,1069,429
11,394,396,294,1084,429
1,500,200,50,750,430
2,492,222,91,805,430
3,440,258,134,832,430
4,441,283,153,877,430
5,411,303,180,894,430
6,428,309,214,951,430
7,416,328,234,978,430
8,428,328,247,1003,430
9,420,374,246,1040,430
10,407,383,272,1062,430
11,405,391,277,1073,430
1,500,200,50,750,431
2,465,224,93,782,431
3,443,250,130,823,431
4,443,269,163,875,431
5,430,318,173,921,431
6,413,348,206,967,431
7,377,373,223,973,431
8,408,393,230,1031,431
9,384,386,252,1022,431
10,383,396,279,1058,431
11,396,414,261,1071,431
1,500,200,50,750,432
2,467,219,94,780,432
3,428,277,108,813,432
4,407,320,140,867,432
5,410,338,172,920,432
6,404,333,209,946,432
7,398,352,227,977,432
8,395,372,237,1004,432
9,408,385,242,1035,432
10,409,409,235,1053,432
11,427,422,249,1098,432
1,500,200,50,750,433
2,459,243,102,804,433
3,407,277,139,823,433
4,404,301,159,864,433
5,374,319,199,892,433
6,394,329,218,941,433
7,406,359,230,995,433
8,383,379,258,1020,433
9,380,385,267,1032,433
10,363,406,274,1043,433
11,401,406,279,1086,433
1,500,200,50,750,434
2,443,244,94,781,434
3,419,254,144,817,434
4,419,274,173,866,434
5,428,307,179,914,434
6,431,318,216,965,434
7,433,338,210,981,434
8,404,370,228,1002,434
9,385,385,253,1023,434
10,389,390,271,1050,434
11,412,416,265,1093,434
1,500,200,50,750,435
2,452,253,85,790,435
3,462,274,95,831,435
4,438,301,141,880,435
5,438,307,170,915,435
6,429,347,188,964,435
7,416,356,209,981,435
8,393,373,238,1004,435
9,387,406,231,1024,435
10,414,394,255,1063,435
11,408,398,276,1082,435
1,500,200,50,750,436
2,456,217,110,783,436
3,425,271,145,841,436
4,405,276,186,867,436
5,396,327,208,931,436
6,412,342,213,967,436
7,400,355,230,985,436
8,389,349,247,985,436
9,409,362,253,1024,436
10,423,378,260,1061,436
11,415,383,277,1075,436
1,500,200,50,750,437
2,463,233,102,798,437
3,413,281,128,822,437
4,391,332,153,876,437
5,380,331,199,910,437
6,381,348,215,944,437
7,371,359,243,973,437
8,373,389,257,1019,437
9,391,393,252,1036,437
10,391,376,276,1043,437
11,418,399,274,1091,437
1,500,200,50,750,438
2,464,232,87,783,438
3,427,284,125,836,438
4,393,311,166,870,438
5,406,317,190,913,438
6,418,323,224,965,438
7,395,341,240,976,438
8,395,360,245,1000,438
9,390,387,256,1033,438
10,412,396,260,1068,438
11,388,428,255,1071,438
1,500,200,50,750,439
2,466,229,85,780,439
3,447,281,114,842,439
4,406,297,152,855,439
5,413,313,195,921,439
6,415,333,203,951,439
7,415,334,232,981,439
8,405,357,221,983,439
9,409,396,235,1040,439
10,412,410,251,1073,439
11,409,423,247,1079,439
1,500,200,50,750,440
2,468,243,79,790,440
3,452,251,124,827,440
4,434,296,150,880,440
5,410,298,190,898,440
6,422,313,221,956,440
7,412,345,230,987,440
8,394,346,255,995,440
9,428,351,248,1027,440
10,400,396,255,1051,440
11,409,423,258,1090,440
1,500,200,50,750,441
2,456,232,92,780,441
3,445,257,131,833,441
4,420,291,159,870,441
5,422,320,178,920,441
6,415,334,200,949,441
7,410,372,206,988,441
8,402,367,242,1011,441
9,418,365,262,1045,441
10,417,378,252,1047,441
11,433,394,271,1098,441
1,500,200,50,750,442
2,455,229,97,781,442
3,426,269,145,840,442
4,411,294,182,887,442
5,361,322,214,897,442
6,404,335,206,945,442
7,397,348,236,981,442
8,398,362,249,1009,442
9,405,373,261,1039,442
10,393,385,282,1060,442
11,393,401,289,1083,442
1,500,200,50,750,443
2,483,233,94,810,443
3,444,259,126,829,443
4,427,283,165,875,443
5,423,292,185,900,443
6,428,332,214,974,443
7,405,330,241,976,443
8,408,347,271,1026,443
9,392,377,255,1024,443
10,408,388,270,1066,443
11,401,396,296,1093,443
1,500,200,50,750,444
2,472,218,99,789,444
3,453,237,141,831,444
4,431,268,170,869,444
5,410,305,201,916,444
6,416,315,218,949,444
7,422,330,243,995,444
8,389,347,262,998,444
9,402,369,264,1035,444
10,408,398,254,1060,444
11,409,388,274,1071,444
1,500,200,50,750,445
2,462,238,91,791,445
3,434,257,137,828,445
4,421,290,158,869,445
5,424,309,184,917,445
6,440,318,218,976,445
7,389,334,247,970,445
8,382,340,259,981,445
9,399,373,264,1036,445
10,379,392,288,1059,445
11,375,421,291,1087,445
1,500,200,50,750,446
2,447,239,100,786,446
3,424,286,118,828,446
4,410,287,162,859,446
5,403,306,203,912,446
6,399,345,218,962,446
7,384,368,235,987,446
8,380,371,256,1007,446
9,394,383,278,1055,446
10,390,414,257,1061,446
11,413,407,278,1098,446
1,500,200,50,750,447
2,454,227,99,780,447
3,403,270,131,804,447
4,425,306,141,872,447
5,439,298,181,918,447
6,431,317,204,952,447
7,412,338,227,977,447
8,406,362,229,997,447
9,419,368,235,1022,447
10,421,385,249,1055,447
11,409,406,269,1084,447
1,500,200,50,750,448
2,460,244,92,796,448
3,416,266,146,828,448
4,431,267,178,876,448
5,424,294,186,904,448
6,416,350,198,964,448
7,413,367,211,991,448
8,409,355,233,997,448
9,426,349,256,1031,448
10,419,395,254,1068,448
11,420,416,248,1084,448
1,500,200,50,750,449
2,448,239,101,788,449
3,429,257,134,820,449
4,420,283,157,860,449
5,404,315,180,899,449
6,445,346,189,980,449
7,419,345,194,958,449
8,414,356,236,1006,449
9,411,382,222,1015,449
10,414,385,267,1066,449
11,418,411,256,1085,449
1,500,200,50,750,450
2,457,232,99,788,450
3,443,257,131,831,450
4,418,290,165,873,450
5,413,315,197,925,450
6,409,322,221,952,450
7,412,328,249,989,450
8,407,354,248,1009,450
9,387,373,260,1020,450
10,410,399,268,1077,450
11,411,392,283,1086,450
1,500,200,50,750,451
2,456,237,90,783,451
3,435,260,135,830,451
4,417,285,155,857,451
5,408,306,195,909,451
6,416,331,222,969,451
7,379,341,258,978,451
8,388,365,257,1010,451
9,395,378,261,1034,451
10,390,385,280,1055,451
11,402,395,287,1084,451
1,500,200,50,750,452
2,467,233,89,789,452
3,430,265,120,815,452
4,426,274,173,873,452
5,417,295,201,913,452
6,417,338,208,963,452
7,409,352,235,996,452
8,397,356,252,1005,452
9,394,372,253,1019,452
10,386,401,268,1055,452
11,386,423,275,1084,452
1,500,200,50,750,453
2,470,234,92,796,453
3,418,276,129,823,453
4,399,312,157,868,453
5,391,308,207,906,453
6,422,357,202,981,453
7,393,379,219,991,453
8,396,385,221,1002,453
9,388,385,258,1031,453
10,395,407,254,1056,453
11,397,431,263,1091,453
1,500,200,50,750,454
2,467,223,105,795,454
3,426,256,148,830,454
4,431,286,169,886,454
5,428,296,184,908,454
6,412,335,213,960,454
7,401,348,239,988,454
8,391,366,253,1010,454
9,378,380,262,1020,454
10,393,411,261,1065,454
11,389,409,274,1072,454
1,500,200,50,750,455
2,465,238,98,801,455
3,435,252,138,825,455
4,420,265,184,869,455
5,415,289,200,904,455
6,406,309,225,940,455
7,418,332,233,983,455
8,417,345,252,1014,455
9,405,363,263,1031,455
10,416,376,267,1059,455
11,401,391,290,1082,455
1,500,200,50,750,456
2,442,245,94,781,456
3,435,270,139,844,456
4,426,298,151,875,456
5,398,321,177,896,456
6,425,353,203,981,456
7,394,367,215,976,456
8,400,357,243,1000,456
9,413,347,273,1033,456
10,420,347,282,1049,456
11,427,382,283,1092,456
1,500,200,50,750,457
2,466,233,96,795,457
3,429,271,132,832,457
4,404,281,173,858,457
5,399,310,208,917,457
6,386,334,214,934,457
7,397,379,217,993,457
8,378,393,235,1006,457
9,398,415,247,1060,457
10,397,424,256,1077,457
11,388,428,278,1094,457
1,500,200,50,750,458
2,458,230,110,798,458
3,435,267,122,824,458
4,431,274,160,865,458
5,394,307,195,896,458
6,403,350,216,969,458
7,372,372,235,979,458
8,378,388,247,1013,458
9,382,385,264,1031,458
10,389,405,255,1049,458
11,394,438,264,1096,458
1,500,200,50,750,459
2,449,245,99,793,459
3,426,276,133,835,459
4,388,304,172,864,459
5,413,343,177,933,459
6,414,332,208,954,459
7,388,378,218,984,459
8,381,398,233,1012,459
9,387,400,257,1044,459
10,384,422,261,1067,459
11,369,435,275,1079,459
1,500,200,50,750,460
2,466,223,97,786,460
3,452,264,126,842,460
4,408,276,168,852,460
5,400,321,196,917,460
6,415,329,230,974,460
7,402,332,251,985,460
8,399,345,265,1009,460
9,391,357,285,1033,460
10,412,373,282,1067,460
11,413,395,281,1089,460
1,500,200,50,750,461
2,455,236,99,790,461
3,414,258,146,818,461
4,426,272,163,861,461
5,414,330,174,918,461
6,400,360,201,961,461
7,396,360,220,976,461
8,403,367,235,1005,461
9,402,366,260,1028,461
10,402,387,266,1055,461
11,401,419,263,1083,461
1,500,200,50,750,462
2,460,238,90,788,462
3,429,256,127,812,462
4,418,295,155,868,462
5,413,327,184,924,462
6,388,357,212,957,462
7,392,348,245,985,462
8,400,383,224,1007,462
9,395,405,231,1031,462
10,396,403,258,1057,462
11,405,436,257,1098,462
1,500,200,50,750,463
2,442,245,91,778,463
3,426,268,129,823,463
4,389,294,159,842,463
5,400,329,192,921,463
6,393,357,203,953,463
7,384,360,234,978,463
8,391,369,260,1020,463
9,380,400,253,1033,463
10,395,413,269,1077,463
11,405,433,261,1099,463
1,500,200,50,750,464
2,434,242,104,780,464
3,414,282,136,832,464
4,404,307,168,879,464
5,380,318,226,924,464
6,389,334,241,964,464
7,405,346,246,997,464
8,380,350,260,990,464
9,388,377,266,1031,464
10,392,384,269,1045,464
11,390,419,286,1095,464
1,500,200,50,750,465
2,476,207,103,786,465
3,446,237,140,823,465
4,410,289,168,867,465
5,422,312,185,919,465
6,408,341,216,965,465
7,396,350,230,976,465
8,410,354,237,1001,465
9,418,367,244,1029,465
10,413,394,245,1052,465
11,425,422,243,1090,465
1,500,200,50,750,466
2,442,220,110,772,466
3,424,242,146,812,466
4,415,289,171,875,466
5,411,317,192,920,466
6,388,341,227,956,466
7,373,357,246,976,466
8,370,392,248,1010,466
9,371,402,254,1027,466
10,401,411,271,1083,466
11,375,432,275,1082,466
1,500,200,50,750,467
2,465,228,101,794,467
3,440,267,133,840,467
4,428,297,153,878,467
5,390,326,191,907,467
6,403,359,204,966,467
7,398,370,223,991,467
8,388,386,230,1004,467
9,407,375,266,1048,467
10,383,393,286,1062,467
11,387,396,305,1088,467
1,500,200,50,750,468
2,481,222,102,805,468
3,450,247,129,826,468
4,425,294,149,868,468
5,422,323,181,926,468
6,437,340,198,975,468
7,390,384,206,980,468
8,373,396,239,1008,468
9,370,414,243,1027,468
10,381,431,244,1056,468
11,386,425,270,1081,468
1,500,200,50,750,469
2,463,230,99,792,469
3,462,248,133,843,469
4,433,276,150,859,469
5,434,287,193,914,469
6,425,323,198,946,469
7,412,349,210,971,469
8,408,379,223,1010,469
9,410,372,248,1030,469
10,401,402,254,1057,469
11,408,400,272,1080,469
1,500,200,50,750,470
2,457,232,98,787,470
3,434,241,155,830,470
4,418,277,171,866,470
5,427,308,182,917,470
6,414,317,208,939,470
7,425,335,231,991,470
8,428,336,251,1015,470
9,417,359,253,1029,470
10,398,389,253,1040,470
11,397,402,266,1065,470
1,500,200,50,750,471
2,446,229,109,784,471
3,415,264,136,815,471
4,397,294,167,858,471
5,408,310,179,897,471
6,403,336,209,948,471
7,410,356,214,980,471
8,407,384,217,1008,471
9,407,383,241,1031,471
10,417,380,254,1051,471
11,400,400,261,1061,471
1,500,200,50,750,472
2,462,237,91,790,472
3,423,293,122,838,472
4,395,309,159,863,472
5,387,336,186,909,472
6,377,350,211,938,472
7,381,354,249,984,472
8,379,354,272,1005,472
9,384,360,291,1035,472
10,363,412,271,1046,472
11,374,445,275,1094,472
1,500,200,50,750,473
2,481,240,84,805,473
3,439,269,122,830,473
4,421,280,154,855,473
5,411,300,181,892,473
6,426,342,185,953,473
7,411,370,213,994,473
8,390,366,237,993,473
9,391,377,255,1023,473
10,403,405,250,1058,473
11,380,414,273,1067,473
1,500,200,50,750,474
2,466,239,90,795,474
3,430,264,127,821,474
4,424,286,173,883,474
5,400,302,196,898,474
6,406,322,222,950,474
7,415,326,222,963,474
8,425,338,248,1011,474
9,401,374,249,1024,474
10,404,410,246,1060,474
11,410,409,271,1090,474
1,500,200,50,750,475
2,452,226,107,785,475
3,445,246,143,834,475
4,419,281,152,852,475
5,438,316,168,922,475
6,424,339,201,964,475
7,388,361,232,981,475
8,377,371,252,1000,475
9,354,421,252,1027,475
10,357,443,264,1064,475
11,365,437,282,1084,475
1,500,200,50,750,476
2,465,225,93,783,476
3,452,253,121,826,476
4,431,287,151,869,476
5,407,330,169,906,476
6,422,337,195,954,476
7,402,350,228,980,476
8,376,354,250,980,476
9,403,383,255,1041,476
10,393,415,258,1066,476
11,365,430,273,1068,476
1,500,200,50,750,477
2,462,245,90,797,477
3,434,255,147,836,477
4,419,281,178,878,477
5,417,305,198,920,477
6,407,328,215,950,477
7,388,359,226,973,477
8,382,379,252,1013,477
9,394,383,247,1024,477
10,389,394,251,1034,477
11,386,437,248,1071,477
1,500,200,50,750,478
2,462,234,104,800,478
3,415,263,139,817,478
4,411,282,172,865,478
5,413,322,199,934,478
6,407,327,228,962,478
7,391,355,231,977,478
8,419,354,222,995,478
9,390,385,234,1009,478
10,417,394,254,1065,478
11,411,403,275,1089,478
1,500,200,50,750,479
2,476,228,82,786,479
3,473,246,122,841,479
4,445,269,155,869,479
5,434,313,179,926,479
6,412,332,212,956,479
7,397,355,218,970,479
8,388,389,227,1004,479
9,401,420,223,1044,479
10,395,416,251,1062,479
11,381,415,285,1081,479
1,500,200,50,750,480
2,447,238,100,785,480
3,437,270,128,835,480
4,422,300,162,884,480
5,388,331,177,896,480
6,416,348,212,976,480
7,403,339,236,978,480
8,401,362,233,996,480
9,410,386,236,1032,480
10,408,386,264,1058,480
11,395,408,276,1079,480
1,500,200,50,750,481
2,470,236,79,785,481
3,427,278,119,824,481
4,405,302,151,858,481
5,450,307,184,941,481
6,408,336,209,953,481
7,393,357,234,984,481
8,378,378,241,997,481
9,370,377,259,1006,481
10,401,377,293,1071,481
11,402,393,280,1075,481
1,500,200,50,750,482
2,447,243,96,786,482
3,426,266,134,826,482
4,411,273,168,852,482
5,405,297,205,907,482
6,399,323,223,945,482
7,411,336,234,981,482
8,388,348,256,992,482
9,394,371,271,1036,482
10,390,401,271,1062,482
11,404,396,282,1082,482
1,500,200,50,750,483
2,467,220,100,787,483
3,437,252,146,835,483
4,416,308,151,875,483
5,408,304,195,907,483
6,408,339,216,963,483
7,386,325,247,958,483
8,418,348,240,1006,483
9,408,359,254,1021,483
10,415,406,239,1060,483
11,435,395,263,1093,483
1,500,200,50,750,484
2,461,219,107,787,484
3,429,260,153,842,484
4,418,274,184,876,484
5,399,307,187,893,484
6,413,341,209,963,484
7,399,360,214,973,484
8,405,375,231,1011,484
9,406,392,230,1028,484
10,407,415,242,1064,484
11,416,421,251,1088,484
1,500,200,50,750,485
2,471,217,97,785,485
3,443,254,134,831,485
4,407,289,166,862,485
5,405,307,200,912,485
6,428,338,210,976,485
7,398,359,215,972,485
8,413,360,239,1012,485
9,405,399,232,1036,485
10,409,390,262,1061,485
11,388,392,296,1076,485
1,500,200,50,750,486
2,454,227,105,786,486
3,446,234,136,816,486
4,449,270,155,874,486
5,437,295,197,929,486
6,397,312,221,930,486
7,412,338,230,980,486
8,399,355,248,1002,486
9,396,381,246,1023,486
10,410,400,250,1060,486
11,401,403,273,1077,486
1,500,200,50,750,487
2,449,246,99,794,487
3,413,273,134,820,487
4,390,289,179,858,487
5,411,300,202,913,487
6,440,327,204,971,487
7,414,338,237,989,487
8,387,366,253,1006,487
9,403,381,251,1035,487
10,421,406,239,1066,487
11,397,426,264,1087,487
1,500,200,50,750,488
2,448,236,106,790,488
3,407,280,148,835,488
4,408,292,166,866,488
5,405,309,194,908,488
6,387,345,212,944,488
7,400,371,224,995,488
8,392,366,243,1001,488
9,408,378,251,1037,488
10,413,405,243,1061,488
11,420,409,241,1070,488
1,500,200,50,750,489
2,451,244,105,800,489
3,440,255,134,829,489
4,431,262,165,858,489
5,425,303,179,907,489
6,422,328,201,951,489
7,411,346,213,970,489
8,418,364,237,1019,489
9,426,371,251,1048,489
10,400,388,264,1052,489
11,442,402,243,1087,489
1,500,200,50,750,490
2,455,216,106,777,490
3,435,261,132,828,490
4,414,296,155,865,490
5,415,323,167,905,490
6,401,331,214,946,490
7,404,347,239,990,490
8,383,381,236,1000,490
9,388,381,275,1044,490
10,391,379,280,1050,490
11,404,395,286,1085,490
1,500,200,50,750,491
2,461,224,103,788,491
3,452,229,150,831,491
4,426,275,161,862,491
5,412,305,187,904,491
6,424,306,218,948,491
7,434,335,217,986,491
8,424,350,233,1007,491
9,395,359,253,1007,491
10,395,405,247,1047,491
11,404,407,274,1085,491
1,500,200,50,750,492
2,456,229,84,769,492
3,450,247,137,834,492
4,439,260,165,864,492
5,425,310,184,919,492
6,421,339,198,958,492
7,421,353,209,983,492
8,404,376,231,1011,492
9,393,384,255,1032,492
10,402,397,256,1055,492
11,403,421,257,1081,492
1,500,200,50,750,493
2,475,236,87,798,493
3,453,256,118,827,493
4,441,276,149,866,493
5,450,298,169,917,493
6,450,331,191,972,493
7,434,342,215,991,493
8,409,354,233,996,493
9,412,355,258,1025,493
10,411,377,261,1049,493
11,437,382,263,1082,493
1,500,200,50,750,494
2,456,248,87,791,494
3,429,257,146,832,494
4,411,265,187,863,494
5,402,319,189,910,494
6,402,320,218,940,494
7,405,338,228,971,494
8,408,342,244,994,494
9,422,360,250,1032,494
10,428,354,279,1061,494
11,434,367,279,1080,494
1,500,200,50,750,495
2,444,245,96,785,495
3,415,286,137,838,495
4,386,328,160,874,495
5,362,349,203,914,495
6,364,353,240,957,495
7,346,381,265,992,495
8,352,391,268,1011,495
9,369,404,273,1046,495
10,373,402,285,1060,495
11,377,421,280,1078,495
1,500,200,50,750,496
2,448,235,87,770,496
3,423,280,124,827,496
4,408,299,152,859,496
5,427,311,180,918,496
6,406,322,205,933,496
7,408,330,225,963,496
8,429,364,231,1024,496
9,403,394,243,1040,496
10,405,398,273,1076,496
11,382,404,289,1075,496
1,500,200,50,750,497
2,454,226,104,784,497
3,429,268,138,835,497
4,409,309,153,871,497
5,390,341,181,912,497
6,407,356,194,957,497
7,394,356,228,978,497
8,385,381,234,1000,497
9,368,401,247,1016,497
10,392,411,245,1048,497
11,400,418,270,1088,497
1,500,200,50,750,498
2,465,223,121,809,498
3,412,261,155,828,498
4,409,288,174,871,498
5,413,305,191,909,498
6,430,320,218,968,498
7,415,335,227,977,498
8,390,379,236,1005,498
9,368,389,270,1027,498
10,366,422,285,1073,498
11,352,424,303,1079,498
1,500,200,50,750,499
2,454,219,108,781,499
3,432,244,139,815,499
4,431,272,156,859,499
5,427,304,192,923,499
6,411,331,199,941,499
7,423,351,216,990,499
8,407,362,247,1016,499
9,413,383,232,1028,499
10,423,404,243,1070,499
11,417,415,245,1077,499
1,500,200,50,750,500
2,453,229,104,786,500
3,439,256,128,823,500
4,434,281,177,892,500
5,428,299,192,919,500
6,419,325,210,954,500
7,415,334,244,993,500
8,389,355,247,991,500
9,377,349,295,1021,500
10,392,405,269,1066,500
11,405,408,276,1089,500
1,500,200,50,750,501
2,455,254,107,816,501
3,405,286,138,829,501
4,380,325,169,874,501
5,374,332,214,920,501
6,398,341,228,967,501
7,375,348,254,977,501
8,348,387,250,985,501
9,380,393,274,1047,501
10,386,382,289,1057,501
11,376,398,301,1075,501
1,500,200,50,750,502
2,450,242,91,783,502
3,418,276,145,839,502
4,415,303,159,877,502
5,404,317,193,914,502
6,378,354,216,948,502
7,394,376,218,988,502
8,375,388,243,1006,502
9,383,381,265,1029,502
10,404,389,272,1065,502
11,391,423,274,1088,502
1,500,200,50,750,503
2,455,239,103,797,503
3,429,246,144,819,503
4,423,293,158,874,503
5,420,312,184,916,503
6,418,323,212,953,503
7,411,348,225,984,503
8,410,361,251,1022,503
9,387,376,268,1031,503
10,402,372,262,1036,503
11,410,393,276,1079,503
1,500,200,50,750,504
2,450,239,93,782,504
3,412,283,124,819,504
4,398,318,170,886,504
5,381,346,189,916,504
6,361,379,223,963,504
7,352,366,255,973,504
8,355,390,256,1001,504
9,358,379,286,1023,504
10,364,388,290,1042,504
11,387,411,268,1066,504
1,500,200,50,750,505
2,433,234,102,769,505
3,420,260,147,827,505
4,399,285,160,844,505
5,394,333,187,914,505
6,417,344,201,962,505
7,425,348,216,989,505
8,409,355,234,998,505
9,389,374,255,1018,505
10,399,395,276,1070,505
11,409,392,281,1082,505
1,500,200,50,750,506
2,453,232,111,796,506
3,409,258,152,819,506
4,404,296,166,866,506
5,404,298,204,906,506
6,378,331,236,945,506
7,398,353,235,986,506
8,365,372,266,1003,506
9,395,386,259,1040,506
10,406,384,278,1068,506
11,396,376,299,1071,506
1,500,200,50,750,507
2,450,233,104,787,507
3,416,290,132,838,507
4,410,308,147,865,507
5,413,302,185,900,507
6,431,304,215,950,507
7,423,334,235,992,507
8,419,342,239,1000,507
9,418,369,241,1028,507
10,409,399,246,1054,507
11,426,394,269,1089,507
1,500,200,50,750,508
2,467,229,103,799,508
3,432,271,125,828,508
4,420,287,168,875,508
5,406,315,203,924,508
6,398,339,223,960,508
7,407,366,226,999,508
8,388,379,233,1000,508
9,382,393,237,1012,508
10,409,422,236,1067,508
11,387,444,257,1088,508
1,500,200,50,750,509
2,479,222,93,794,509
3,438,256,129,823,509
4,427,284,166,877,509
5,414,326,189,929,509
6,397,334,226,957,509
7,372,360,239,971,509
8,378,382,239,999,509
9,389,385,250,1024,509
10,384,399,271,1054,509
11,411,396,288,1095,509
1,500,200,50,750,510
2,454,235,104,793,510
3,407,282,147,836,510
4,387,311,172,870,510
5,386,334,194,914,510
6,386,364,200,950,510
7,399,365,226,990,510
8,375,364,258,997,510
9,416,371,259,1046,510
10,417,392,245,1054,510
11,407,410,250,1067,510
1,500,200,50,750,511
2,458,238,96,792,511
3,423,274,136,833,511
4,399,303,175,877,511
5,400,318,197,915,511
6,410,337,208,955,511
7,415,320,242,977,511
8,385,363,253,1001,511
9,402,383,245,1030,511
10,417,388,257,1062,511
11,394,417,270,1081,511
1,500,200,50,750,512
2,469,232,93,794,512
3,428,261,130,819,512
4,422,293,155,870,512
5,420,303,189,912,512
6,402,343,205,950,512
7,372,382,228,982,512
8,399,378,230,1007,512
9,399,381,249,1029,512
10,410,389,262,1061,512
11,406,381,292,1079,512
1,500,200,50,750,513
2,455,246,87,788,513
3,441,262,127,830,513
4,441,270,154,865,513
5,452,292,165,909,513
6,433,339,189,961,513
7,422,353,211,986,513
8,411,334,252,997,513
9,388,347,269,1004,513
10,422,364,278,1064,513
11,427,389,288,1104,513
1,500,200,50,750,514
2,434,244,103,781,514
3,410,261,140,811,514
4,407,290,174,871,514
5,400,328,180,908,514
6,400,340,203,943,514
7,413,367,220,1000,514
8,388,392,223,1003,514
9,401,386,261,1048,514
10,394,415,251,1060,514
11,387,409,284,1080,514
1,500,200,50,750,515
2,448,223,109,780,515
3,436,259,134,829,515
4,438,276,160,874,515
5,422,304,186,912,515
6,407,344,212,963,515
7,387,376,224,987,515
8,399,382,232,1013,515
9,387,406,233,1026,515
10,376,429,256,1061,515
11,385,435,259,1079,515
1,500,200,50,750,516
2,455,254,96,805,516
3,421,272,136,829,516
4,385,311,157,853,516
5,376,339,178,893,516
6,401,346,215,962,516
7,409,356,234,999,516
8,390,360,258,1008,516
9,403,369,256,1028,516
10,397,410,270,1077,516
11,399,407,273,1079,516
1,500,200,50,750,517
2,470,217,106,793,517
3,443,255,131,829,517
4,403,287,163,853,517
5,402,321,189,912,517
6,410,328,215,953,517
7,405,347,225,977,517
8,412,341,248,1001,517
9,413,358,258,1029,517
10,419,374,264,1057,517
11,398,377,287,1062,517
1,500,200,50,750,518
2,451,228,97,776,518
3,436,274,110,820,518
4,431,295,159,885,518
5,414,327,173,914,518
6,410,335,205,950,518
7,406,349,231,986,518
8,396,362,240,998,518
9,382,379,263,1024,518
10,388,397,281,1066,518
11,407,390,286,1083,518
1,500,200,50,750,519
2,469,226,93,788,519
3,466,261,115,842,519
4,441,255,166,862,519
5,421,317,171,909,519
6,408,331,208,947,519
7,421,339,214,974,519
8,428,338,237,1003,519
9,436,366,249,1051,519
10,415,398,242,1055,519
11,413,403,278,1094,519
1,500,200,50,750,520
2,463,220,86,769,520
3,442,266,117,825,520
4,430,292,146,868,520
5,426,342,166,934,520
6,431,339,186,956,520
7,438,360,196,994,520
8,434,356,218,1008,520
9,417,375,237,1029,520
10,400,394,247,1041,520
11,397,401,282,1080,520
1,500,200,50,750,521
2,447,232,103,782,521
3,420,279,125,824,521
4,413,296,159,868,521
5,406,313,199,918,521
6,393,332,226,951,521
7,375,369,237,981,521
8,372,393,243,1008,521
9,386,363,265,1014,521
10,406,392,266,1064,521
11,392,431,263,1086,521
1,500,200,50,750,522
2,455,227,96,778,522
3,435,265,134,834,522
4,404,311,148,863,522
5,393,333,183,909,522
6,411,333,218,962,522
7,411,352,230,993,522
8,386,367,250,1003,522
9,358,405,265,1028,522
10,383,418,265,1066,522
11,374,422,284,1080,522
1,500,200,50,750,523
2,456,232,95,783,523
3,423,276,126,825,523
4,411,293,175,879,523
5,412,295,200,907,523
6,404,343,228,975,523
7,390,367,239,996,523
8,366,379,258,1003,523
9,400,362,281,1043,523
10,380,383,293,1056,523
11,382,397,311,1090,523
1,500,200,50,750,524
2,458,223,105,786,524
3,412,266,129,807,524
4,413,311,148,872,524
5,392,332,184,908,524
6,400,362,192,954,524
7,392,383,205,980,524
8,390,397,227,1014,524
9,376,399,260,1035,524
10,387,383,283,1053,524
11,410,417,269,1096,524
1,500,200,50,750,525
2,455,215,109,779,525
3,442,262,137,841,525
4,393,292,174,859,525
5,385,348,199,932,525
6,384,364,210,958,525
7,405,363,212,980,525
8,381,377,242,1000,525
9,373,401,252,1026,525
10,392,385,269,1046,525
11,426,405,265,1096,525
1,500,200,50,750,526
2,465,232,99,796,526
3,440,262,131,833,526
4,407,285,149,841,526
5,398,336,183,917,526
6,402,335,215,952,526
7,402,350,219,971,526
8,400,370,236,1006,526
9,411,369,242,1022,526
10,390,403,247,1040,526
11,423,394,274,1091,526
1,500,200,50,750,527
2,466,241,80,787,527
3,430,274,121,825,527
4,433,289,160,882,527
5,394,315,201,910,527
6,397,353,211,961,527
7,399,368,211,978,527
8,396,377,223,996,527
9,406,379,244,1029,527
10,403,401,254,1058,527
11,395,424,265,1084,527
1,500,200,50,750,528
2,459,223,93,775,528
3,440,268,131,839,528
4,427,295,157,879,528
5,401,315,185,901,528
6,419,317,224,960,528
7,386,352,239,977,528
8,380,380,245,1005,528
9,393,405,244,1042,528
10,398,416,240,1054,528
11,415,406,269,1090,528
1,500,200,50,750,529
2,452,229,108,789,529
3,428,256,147,831,529
4,381,295,198,874,529
5,385,320,186,891,529
6,400,351,210,961,529
7,397,355,234,986,529
8,368,374,238,980,529
9,379,401,265,1045,529
10,382,417,271,1070,529
11,400,420,270,1090,529
1,500,200,50,750,530
2,478,226,93,797,530
3,452,248,128,828,530
4,421,282,153,856,530
5,429,309,185,923,530
6,410,309,218,937,530
7,433,335,219,987,530
8,448,355,212,1015,530
9,447,371,223,1041,530
10,432,379,246,1057,530
11,428,384,274,1086,530
1,500,200,50,750,531
2,454,220,107,781,531
3,407,265,143,815,531
4,415,282,187,884,531
5,390,316,211,917,531
6,397,324,231,952,531
7,397,337,249,983,531
8,381,368,253,1002,531
9,380,374,263,1017,531
10,404,379,277,1060,531
11,405,400,286,1091,531
1,500,200,50,750,532
2,450,226,112,788,532
3,429,247,148,824,532
4,422,259,182,863,532
5,422,307,189,918,532
6,396,359,209,964,532
7,384,385,207,976,532
8,373,389,248,1010,532
9,373,385,272,1030,532
10,380,378,286,1044,532
11,405,371,303,1079,532
1,500,200,50,750,533
2,460,244,87,791,533
3,419,278,128,825,533
4,420,301,153,874,533
5,398,324,192,914,533
6,391,340,208,939,533
7,403,350,234,987,533
8,414,361,235,1010,533
9,401,372,252,1025,533
10,402,385,259,1046,533
11,419,367,262,1048,533
1,500,200,50,750,534
2,457,224,108,789,534
3,449,235,138,822,534
4,415,286,165,866,534
5,406,306,189,901,534
6,423,311,214,948,534
7,401,336,244,981,534
8,390,367,239,996,534
9,397,377,256,1030,534
10,390,402,264,1056,534
11,397,412,267,1076,534
1,500,200,50,750,535
2,465,227,97,789,535
3,417,267,139,823,535
4,401,286,184,871,535
5,400,324,190,914,535
6,395,339,221,955,535
7,401,353,235,989,535
8,397,375,245,1017,535
9,394,388,247,1029,535
10,404,409,258,1071,535
11,389,403,287,1079,535
1,500,200,50,750,536
2,463,236,81,780,536
3,437,268,121,826,536
4,421,289,147,857,536
5,416,314,182,912,536
6,408,343,208,959,536
7,380,348,251,979,536
8,381,349,271,1001,536
9,370,394,260,1024,536
10,393,388,291,1072,536
11,395,419,281,1095,536
1,500,200,50,750,537
2,456,230,105,791,537
3,424,269,151,844,537
4,409,285,181,875,537
5,391,316,198,905,537
6,407,342,199,948,537
7,408,337,232,977,537
8,422,354,244,1020,537
9,404,376,245,1025,537
10,409,375,262,1046,537
11,418,403,273,1094,537
1,500,200,50,750,538
2,470,228,98,796,538
3,438,247,132,817,538
4,411,297,160,868,538
5,398,316,186,900,538
6,408,350,189,947,538
7,411,362,224,997,538
8,390,391,233,1014,538
9,380,376,270,1026,538
10,408,383,271,1062,538
11,411,412,259,1082,538
1,500,200,50,750,539
2,465,210,105,780,539
3,456,243,138,837,539
4,440,273,168,881,539
5,415,291,194,900,539
6,435,339,202,976,539
7,402,383,208,993,539
8,366,400,236,1002,539
9,364,429,249,1042,539
10,353,429,275,1057,539
11,392,434,282,1108,539
1,500,200,50,750,540
2,454,237,92,783,540
3,421,263,154,838,540
4,426,272,183,881,540
5,415,315,186,916,540
6,408,339,217,964,540
7,389,351,237,977,540
8,391,384,230,1005,540
9,394,398,247,1039,540
10,378,422,251,1051,540
11,391,420,273,1084,540
1,500,200,50,750,541
2,433,245,99,777,541
3,424,258,138,820,541
4,401,294,177,872,541
5,381,337,189,907,541
6,395,352,219,966,541
7,388,352,232,972,541
8,406,358,240,1004,541
9,405,385,244,1034,541
10,391,405,271,1067,541
11,406,431,264,1101,541
1,500,200,50,750,542
2,452,245,97,794,542
3,414,264,147,825,542
4,386,277,191,854,542
5,390,319,204,913,542
6,377,345,236,958,542
7,380,373,227,980,542
8,396,367,247,1010,542
9,389,372,260,1021,542
10,403,380,279,1062,542
11,407,412,278,1097,542
1,500,200,50,750,543
2,458,238,103,799,543
3,418,264,140,822,543
4,405,285,180,870,543
5,407,321,205,933,543
6,395,339,219,953,543
7,387,358,235,980,543
8,362,405,249,1016,543
9,366,399,255,1020,543
10,386,388,280,1054,543
11,416,399,279,1094,543
1,500,200,50,750,544
2,480,214,94,788,544
3,452,248,134,834,544
4,420,275,173,868,544
5,427,298,185,910,544
6,412,328,193,933,544
7,417,352,213,982,544
8,388,362,246,996,544
9,404,378,243,1025,544
10,432,385,258,1075,544
11,432,391,265,1088,544
1,500,200,50,750,545
2,456,240,92,788,545
3,425,259,130,814,545
4,433,282,142,857,545
5,426,310,172,908,545
6,422,324,199,945,545
7,430,302,238,970,545
8,413,352,238,1003,545
9,411,374,252,1037,545
10,425,375,258,1058,545
11,414,413,251,1078,545
1,500,200,50,750,546
2,473,212,105,790,546
3,446,255,137,838,546
4,432,284,150,866,546
5,390,321,171,882,546
6,421,335,198,954,546
7,416,358,213,987,546
8,398,391,218,1007,546
9,398,348,275,1021,546
10,390,391,270,1051,546
11,376,418,283,1077,546
1,500,200,50,750,547
2,469,232,88,789,547
3,430,261,124,815,547
4,438,278,160,876,547
5,429,312,177,918,547
6,425,326,209,960,547
7,400,360,221,981,547
8,406,377,219,1002,547
9,416,382,227,1025,547
10,392,384,260,1036,547
11,432,400,261,1093,547
1,500,200,50,750,548
2,454,239,104,797,548
3,438,257,129,824,548
4,414,297,174,885,548
5,405,318,186,909,548
6,415,332,217,964,548
7,405,329,249,983,548
8,407,359,240,1006,548
9,392,381,252,1025,548
10,404,391,259,1054,548
11,416,387,274,1077,548
1,500,200,50,750,549
2,449,239,100,788,549
3,434,253,144,831,549
4,407,269,170,846,549
5,424,294,191,909,549
6,436,336,191,963,549
7,417,360,211,988,549
8,398,378,232,1008,549
9,406,379,249,1034,549
10,429,373,262,1064,549
11,414,391,276,1081,549
1,500,200,50,750,550
2,456,243,104,803,550
3,425,274,135,834,550
4,428,268,171,867,550
5,414,300,187,901,550
6,400,341,206,947,550
7,406,366,203,975,550
8,394,386,244,1024,550
9,392,403,244,1039,550
10,390,406,271,1067,550
11,402,406,283,1091,550
1,500,200,50,750,551
2,462,229,103,794,551
3,440,255,141,836,551
4,418,283,160,861,551
5,416,320,184,920,551
6,400,368,189,957,551
7,398,356,229,983,551
8,385,385,250,1020,551
9,375,377,275,1027,551
10,387,404,270,1061,551
11,368,430,285,1083,551
1,500,200,50,750,552
2,447,221,104,772,552
3,400,270,126,796,552
4,407,285,163,855,552
5,421,307,188,916,552
6,399,336,224,959,552
7,406,351,226,983,552
8,410,363,232,1005,552
9,394,390,244,1028,552
10,422,387,251,1060,552
11,402,401,266,1069,552
1,500,200,50,750,553
2,464,221,100,785,553
3,450,242,135,827,553
4,437,280,150,867,553
5,421,303,187,911,553
6,400,335,225,960,553
7,411,352,229,992,553
8,398,360,245,1003,553
9,407,377,241,1025,553
10,401,401,254,1056,553
11,406,406,280,1092,553
1,500,200,50,750,554
2,442,238,99,779,554
3,419,270,139,828,554
4,403,279,172,854,554
5,414,304,197,915,554
6,420,337,207,964,554
7,396,355,228,979,554
8,373,383,233,989,554
9,402,378,266,1046,554
10,382,389,279,1050,554
11,372,439,267,1078,554
1,500,200,50,750,555
2,467,210,107,784,555
3,448,250,131,829,555
4,423,278,171,872,555
5,412,311,176,899,555
6,405,357,213,975,555
7,384,357,232,973,555
8,419,337,264,1020,555
9,391,383,254,1028,555
10,395,385,264,1044,555
11,404,389,298,1091,555
1,500,200,50,750,556
2,466,222,107,795,556
3,446,242,144,832,556
4,440,259,170,869,556
5,426,291,196,913,556
6,433,316,213,962,556
7,408,350,216,974,556
8,407,368,229,1004,556
9,416,366,237,1019,556
10,411,392,250,1053,556
11,434,390,269,1093,556
1,500,200,50,750,557
2,477,225,98,800,557
3,446,247,133,826,557
4,435,275,155,865,557
5,444,324,162,930,557
6,412,345,199,956,557
7,397,358,220,975,557
8,393,353,257,1003,557
9,378,361,287,1026,557
10,377,371,312,1060,557
11,367,404,304,1075,557
1,500,200,50,750,558
2,444,235,99,778,558
3,443,238,153,834,558
4,430,246,182,858,558
5,420,273,204,897,558
6,432,311,232,975,558
7,389,346,239,974,558
8,387,378,238,1003,558
9,376,395,246,1017,558
10,391,396,264,1051,558
11,410,400,276,1086,558
1,500,200,50,750,559
2,450,233,119,802,559
3,415,263,145,823,559
4,410,271,184,865,559
5,402,328,168,898,559
6,391,376,194,961,559
7,373,362,241,976,559
8,363,384,259,1006,559
9,353,404,269,1026,559
10,359,416,272,1047,559
11,369,419,283,1071,559
1,500,200,50,750,560
2,457,238,88,783,560
3,436,264,133,833,560
4,419,297,163,879,560
5,417,315,185,917,560
6,413,326,218,957,560
7,410,360,209,979,560
8,415,376,214,1005,560
9,404,374,251,1029,560
10,401,402,269,1072,560
11,403,417,269,1089,560
1,500,200,50,750,561
2,461,229,97,787,561
3,443,270,124,837,561
4,412,276,184,872,561
5,389,326,184,899,561
6,383,353,199,935,561
7,389,358,219,966,561
8,386,385,240,1011,561
9,381,400,249,1030,561
10,388,417,261,1066,561
11,387,402,279,1068,561
1,500,200,50,750,562
2,461,243,81,785,562
3,446,283,124,853,562
4,405,303,157,865,562
5,433,336,165,934,562
6,431,337,189,957,562
7,406,364,214,984,562
8,399,382,221,1002,562
9,413,381,242,1036,562
10,410,370,257,1037,562
11,420,392,257,1069,562
1,500,200,50,750,563
2,461,224,97,782,563
3,444,260,145,849,563
4,414,270,184,868,563
5,400,316,208,924,563
6,395,363,200,958,563
7,377,355,239,971,563
8,386,386,257,1029,563
9,394,367,274,1035,563
10,392,399,260,1051,563
11,405,403,280,1088,563
1,500,200,50,750,564
2,479,225,79,783,564
3,453,267,116,836,564
4,439,294,137,870,564
5,427,292,192,911,564
6,423,323,210,956,564
7,433,321,241,995,564
8,395,352,252,999,564
9,375,372,265,1012,564
10,413,374,285,1072,564
11,413,393,296,1102,564
1,500,200,50,750,565
2,454,219,110,783,565
3,426,231,160,817,565
4,402,292,176,870,565
5,379,324,203,906,565
6,374,344,216,934,565
7,358,372,236,966,565
8,362,368,258,988,565
9,381,387,257,1025,565
10,393,411,257,1061,565
11,388,421,268,1077,565
1,500,200,50,750,566
2,471,202,110,783,566
3,445,235,148,828,566
4,445,285,156,886,566
5,414,326,179,919,566
6,406,321,211,938,566
7,392,359,244,995,566
8,374,385,246,1005,566
9,372,376,283,1031,566
10,372,387,301,1060,566
11,383,408,292,1083,566
1,500,200,50,750,567
2,455,232,100,787,567
3,416,260,145,821,567
4,430,276,175,881,567
5,410,284,209,903,567
6,433,315,231,979,567
7,410,325,243,978,567
8,411,346,250,1007,567
9,420,368,238,1026,567
10,407,369,267,1043,567
11,426,363,292,1081,567
1,500,200,50,750,568
2,461,241,99,801,568
3,436,287,118,841,568
4,421,304,156,881,568
5,417,318,173,908,568
6,406,352,204,962,568
7,412,353,227,992,568
8,414,353,252,1019,568
9,427,371,247,1045,568
10,406,411,236,1053,568
11,430,440,250,1120,568
1,500,200,50,750,569
2,464,217,108,789,569
3,431,277,124,832,569
4,411,312,159,882,569
5,406,335,178,919,569
6,389,352,197,938,569
7,405,353,217,975,569
8,398,347,251,996,569
9,418,358,270,1046,569
10,413,389,267,1069,569
11,418,420,265,1103,569
1,500,200,50,750,570
2,477,241,75,793,570
3,458,261,121,840,570
4,432,276,150,858,570
5,415,323,170,908,570
6,414,340,191,945,570
7,408,350,226,984,570
8,384,386,240,1010,570
9,376,397,248,1021,570
10,395,419,247,1061,570
11,405,418,272,1095,570
1,500,200,50,750,571
2,462,216,93,771,571
3,426,266,139,831,571
4,401,304,168,873,571
5,363,335,200,898,571
6,369,364,220,953,571
7,352,383,245,980,571
8,354,396,241,991,571
9,391,396,255,1042,571
10,385,379,281,1045,571
11,416,428,274,1118,571
1,500,200,50,750,572
2,453,242,92,787,572
3,421,264,131,816,572
4,383,310,164,857,572
5,399,320,192,911,572
6,407,327,223,957,572
7,402,342,242,986,572
8,405,341,267,1013,572
9,376,384,272,1032,572
10,377,397,275,1049,572
11,378,432,289,1099,572
1,500,200,50,750,573
2,479,229,84,792,573
3,443,250,125,818,573
4,441,273,152,866,573
5,415,302,180,897,573
6,421,325,195,941,573
7,422,342,217,981,573
8,425,356,228,1009,573
9,411,375,244,1030,573
10,408,382,250,1040,573
11,418,400,269,1087,573
1,500,200,50,750,574
2,454,233,97,784,574
3,420,249,142,811,574
4,434,281,169,884,574
5,410,299,185,894,574
6,407,335,212,954,574
7,384,346,251,981,574
8,379,362,260,1001,574
9,394,377,246,1017,574
10,398,390,266,1054,574
11,414,422,260,1096,574
1,500,200,50,750,575
2,463,220,97,780,575
3,447,241,142,830,575
4,425,285,169,879,575
5,415,296,194,905,575
6,427,330,205,962,575
7,412,327,240,979,575
8,422,370,237,1029,575
9,381,381,257,1019,575
10,412,391,274,1077,575
11,402,401,281,1084,575
1,500,200,50,750,576
2,459,222,115,796,576
3,412,262,144,818,576
4,414,286,179,879,576
5,424,312,194,930,576
6,393,346,220,959,576
7,385,386,216,987,576
8,375,368,258,1001,576
9,405,358,266,1029,576
10,398,428,257,1083,576
11,376,424,286,1086,576
1,500,200,50,750,577
2,469,233,88,790,577
3,441,251,141,833,577
4,414,303,149,866,577
5,397,317,193,907,577
6,408,327,226,961,577
7,390,339,251,980,577
8,390,384,238,1012,577
9,370,383,268,1021,577
10,362,393,285,1040,577
11,393,418,283,1094,577
1,500,200,50,750,578
2,458,238,79,775,578
3,438,264,120,822,578
4,434,274,161,869,578
5,403,318,170,891,578
6,436,346,181,963,578
7,431,340,218,989,578
8,424,354,238,1016,578
9,422,381,233,1036,578
10,401,387,258,1046,578
11,400,415,280,1095,578
1,500,200,50,750,579
2,457,230,97,784,579
3,441,265,132,838,579
4,436,270,169,875,579
5,441,308,170,919,579
6,431,333,185,949,579
7,416,351,219,986,579
8,400,377,223,1000,579
9,388,397,255,1040,579
10,377,390,286,1053,579
11,407,372,302,1081,579
1,500,200,50,750,580
2,445,223,96,764,580
3,441,261,133,835,580
4,421,277,164,862,580
5,417,314,176,907,580
6,435,338,200,973,580
7,432,335,225,992,580
8,434,363,222,1019,580
9,411,369,251,1031,580
10,412,389,260,1061,580
11,400,412,276,1088,580
1,500,200,50,750,581
2,463,221,99,783,581
3,445,257,146,848,581
4,423,275,182,880,581
5,389,318,205,912,581
6,373,346,237,956,581
7,362,376,236,974,581
8,389,386,250,1025,581
9,377,379,264,1020,581
10,381,387,269,1037,581
11,403,423,272,1098,581
1,500,200,50,750,582
2,451,241,108,800,582
3,426,263,139,828,582
4,426,276,170,872,582
5,421,310,192,923,582
6,407,340,210,957,582
7,389,359,232,980,582
8,381,372,238,991,582
9,405,382,251,1038,582
10,382,384,275,1041,582
11,393,406,270,1069,582
1,500,200,50,750,583
2,463,231,95,789,583
3,417,256,154,827,583
4,393,285,186,864,583
5,412,343,181,936,583
6,397,351,209,957,583
7,399,355,224,978,583
8,400,370,242,1012,583
9,399,378,257,1034,583
10,392,368,297,1057,583
11,417,375,293,1085,583
1,500,200,50,750,584
2,460,221,106,787,584
3,421,261,140,822,584
4,417,296,165,878,584
5,397,325,191,913,584
6,414,332,214,960,584
7,413,345,238,996,584
8,388,382,229,999,584
9,400,403,248,1051,584
10,393,398,260,1051,584
11,398,412,277,1087,584
1,500,200,50,750,585
2,459,227,103,789,585
3,422,272,145,839,585
4,415,283,168,866,585
5,404,292,213,909,585
6,429,300,243,972,585
7,395,318,258,971,585
8,401,325,280,1006,585
9,398,359,272,1029,585
10,421,375,281,1077,585
11,398,386,300,1084,585
1,500,200,50,750,586
2,457,244,82,783,586
3,440,245,131,816,586
4,445,274,149,868,586
5,413,315,200,928,586
6,394,325,221,940,586
7,389,364,239,992,586
8,384,368,245,997,586
9,396,389,243,1028,586
10,406,387,255,1048,586
11,406,419,258,1083,586
1,500,200,50,750,587
2,439,240,89,768,587
3,423,264,141,828,587
4,410,274,171,855,587
5,423,298,191,912,587
6,404,325,213,942,587
7,395,362,218,975,587
8,389,375,247,1011,587
9,390,372,265,1027,587
10,404,403,256,1063,587
11,421,394,288,1103,587
1,500,200,50,750,588
2,449,244,101,794,588
3,415,258,147,820,588
4,387,281,181,849,588
5,416,298,208,922,588
6,408,316,223,947,588
7,392,362,227,981,588
8,379,399,237,1015,588
9,387,398,257,1042,588
10,404,403,261,1068,588
11,409,401,274,1084,588
1,500,200,50,750,589
2,452,239,96,787,589
3,436,258,134,828,589
4,420,288,155,863,589
5,405,323,180,908,589
6,423,342,197,962,589
7,422,355,211,988,589
8,411,360,233,1004,589
9,433,359,242,1034,589
10,442,378,247,1067,589
11,422,404,245,1071,589
1,500,200,50,750,590
2,483,214,83,780,590
3,449,260,131,840,590
4,436,282,156,874,590
5,405,312,191,908,590
6,411,363,219,993,590
7,382,349,252,983,590
8,389,373,249,1011,590
9,377,374,272,1023,590
10,378,374,286,1038,590
11,408,395,295,1098,590
1,500,200,50,750,591
2,475,231,91,797,591
3,441,240,147,828,591
4,419,261,188,868,591
5,427,298,196,921,591
6,424,327,211,962,591
7,428,331,226,985,591
8,407,362,225,994,591
9,406,379,231,1016,591
10,415,384,266,1065,591
11,386,436,265,1087,591
1,500,200,50,750,592
2,447,235,103,785,592
3,432,241,146,819,592
4,437,251,174,862,592
5,431,294,180,905,592
6,437,328,194,959,592
7,431,353,202,986,592
8,402,342,244,988,592
9,408,385,248,1041,592
10,399,411,249,1059,592
11,402,417,261,1080,592
1,500,200,50,750,593
2,476,217,87,780,593
3,437,256,126,819,593
4,410,274,180,864,593
5,421,316,183,920,593
6,413,348,199,960,593
7,388,371,222,981,593
8,379,382,250,1011,593
9,388,394,266,1048,593
10,375,409,267,1051,593
11,394,433,264,1091,593
1,500,200,50,750,594
2,464,216,96,776,594
3,446,271,119,836,594
4,419,301,146,866,594
5,411,308,182,901,594
6,405,340,213,958,594
7,408,340,223,971,594
8,412,361,225,998,594
9,415,391,236,1042,594
10,406,420,236,1062,594
11,416,420,259,1095,594
1,500,200,50,750,595
2,440,235,105,780,595
3,438,260,134,832,595
4,420,279,170,869,595
5,384,315,193,892,595
6,409,360,207,976,595
7,402,345,232,979,595
8,395,388,225,1008,595
9,382,413,228,1023,595
10,399,422,242,1063,595
11,380,416,263,1059,595
1,500,200,50,750,596
2,452,238,106,796,596
3,410,242,162,814,596
4,398,272,187,857,596
5,395,308,192,895,596
6,399,340,223,962,596
7,391,352,223,966,596
8,398,366,252,1016,596
9,390,390,258,1038,596
10,394,391,264,1049,596
11,413,411,268,1092,596
1,500,200,50,750,597
2,457,237,84,778,597
3,420,264,149,833,597
4,416,294,171,881,597
5,396,316,205,917,597
6,391,359,208,958,597
7,385,358,224,967,597
8,385,393,220,998,597
9,379,384,248,1011,597
10,372,415,262,1049,597
11,389,410,282,1081,597
1,500,200,50,750,598
2,477,219,94,790,598
3,446,246,135,827,598
4,444,279,154,877,598
5,418,316,177,911,598
6,407,351,203,961,598
7,404,358,225,987,598
8,383,387,239,1009,598
9,382,399,243,1024,598
10,377,412,268,1057,598
11,381,440,272,1093,598
1,500,200,50,750,599
2,457,239,88,784,599
3,439,254,130,823,599
4,425,278,162,865,599
5,412,308,187,907,599
6,428,339,197,964,599
7,406,349,225,980,599
8,407,370,229,1006,599
9,410,379,257,1046,599
10,392,376,280,1048,599
11,403,420,267,1090,599
1,500,200,50,750,600
2,472,226,94,792,600
3,462,254,130,846,600
4,431,281,156,868,600
5,421,296,192,909,600
6,413,329,204,946,600
7,394,376,209,979,600
8,369,400,236,1005,600
9,382,396,256,1034,600
10,366,422,270,1058,600
11,376,410,291,1077,600
1,500,200,50,750,601
2,454,237,84,775,601
3,428,264,131,823,601
4,402,298,172,872,601
5,378,305,224,907,601
6,380,336,235,951,601
7,389,347,250,986,601
8,380,378,256,1014,601
9,383,368,281,1032,601
10,388,382,284,1054,601
11,383,420,287,1090,601
1,500,200,50,750,602
2,456,237,106,799,602
3,432,266,133,831,602
4,411,287,163,861,602
5,419,324,177,920,602
6,405,354,200,959,602
7,394,359,233,986,602
8,392,375,243,1010,602
9,390,378,252,1020,602
10,400,394,267,1061,602
11,404,418,276,1098,602
1,500,200,50,750,603
2,442,235,104,781,603
3,436,281,130,847,603
4,407,300,166,873,603
5,402,300,202,904,603
6,399,333,215,947,603
7,395,359,243,997,603
8,377,369,248,994,603
9,399,383,264,1046,603
10,375,397,277,1049,603
11,386,435,274,1095,603
1,500,200,50,750,604
2,458,237,90,785,604
3,461,242,126,829,604
4,441,264,148,853,604
5,429,298,179,906,604
6,417,332,193,942,604
7,411,353,225,989,604
8,386,389,230,1005,604
9,390,386,252,1028,604
10,377,398,268,1043,604
11,396,400,277,1073,604
1,500,200,50,750,605
2,449,235,88,772,605
3,437,268,125,830,605
4,430,284,162,876,605
5,414,306,181,901,605
6,408,333,225,966,605
7,384,347,252,983,605
8,374,372,254,1000,605
9,388,405,252,1045,605
10,391,392,283,1066,605
11,411,413,275,1099,605
1,500,200,50,750,606
2,445,236,103,784,606
3,409,263,142,814,606
4,397,277,177,851,606
5,431,301,199,931,606
6,394,320,238,952,606
7,400,348,247,995,606
8,393,364,256,1013,606
9,413,365,261,1039,606
10,407,379,265,1051,606
11,419,397,278,1094,606
1,500,200,50,750,607
2,428,230,113,771,607
3,425,270,142,837,607
4,405,304,169,878,607
5,379,325,196,900,607
6,405,341,213,959,607
7,384,360,252,996,607
8,375,396,247,1018,607
9,363,412,255,1030,607
10,380,413,266,1059,607
11,390,417,278,1085,607
1,500,200,50,750,608
2,476,220,104,800,608
3,458,247,119,824,608
4,427,292,142,861,608
5,429,301,186,916,608
6,420,336,214,970,608
7,416,325,237,978,608
8,409,339,258,1006,608
9,419,355,270,1044,608
10,413,377,278,1068,608
11,400,381,284,1065,608
1,500,200,50,750,609
2,456,223,105,784,609
3,431,258,127,816,609
4,434,294,159,887,609
5,434,313,180,927,609
6,408,339,211,958,609
7,401,325,254,980,609
8,365,368,254,987,609
9,414,387,249,1050,609
10,405,391,275,1071,609
11,424,401,262,1087,609
1,500,200,50,750,610
2,468,233,84,785,610
3,441,272,108,821,610
4,420,281,157,858,610
5,421,326,178,925,610
6,413,347,203,963,610
7,409,352,225,986,610
8,401,383,225,1009,610
9,407,382,248,1037,610
10,419,387,255,1061,610
11,395,405,279,1079,610
1,500,200,50,750,611
2,461,228,101,790,611
3,436,248,133,817,611
4,427,285,173,885,611
5,433,305,186,924,611
6,402,341,207,950,611
7,391,368,226,985,611
8,377,386,244,1007,611
9,361,412,255,1028,611
10,374,403,263,1040,611
11,356,419,281,1056,611
1,500,200,50,750,612
2,471,223,94,788,612
3,439,267,121,827,612
4,431,283,155,869,612
5,405,323,183,911,612
6,414,329,216,959,612
7,391,358,232,981,612
8,407,395,223,1025,612
9,382,381,279,1042,612
10,387,396,268,1051,612
11,408,400,276,1084,612
1,500,200,50,750,613
2,469,207,107,783,613
3,442,257,130,829,613
4,428,298,158,884,613
5,404,319,199,922,613
6,415,345,212,972,613
7,391,368,217,976,613
8,389,359,247,995,613
9,383,376,272,1031,613
10,371,388,286,1045,613
11,355,422,277,1054,613
1,500,200,50,750,614
2,424,269,108,801,614
3,394,293,133,820,614
4,388,313,168,869,614
5,391,335,192,918,614
6,396,350,206,952,614
7,411,343,230,984,614
8,410,363,240,1013,614
9,397,378,247,1022,614
10,412,408,256,1076,614
11,402,436,253,1091,614
1,500,200,50,750,615
2,448,233,95,776,615
3,436,273,119,828,615
4,399,302,174,875,615
5,394,324,194,912,615
6,395,347,219,961,615
7,390,347,238,975,615
8,394,358,263,1015,615
9,395,372,268,1035,615
10,371,395,284,1050,615
11,397,407,278,1082,615
1,500,200,50,750,616
2,483,211,96,790,616
3,418,249,137,804,616
4,399,281,178,858,616
5,412,296,208,916,616
6,404,322,223,949,616
7,388,325,262,975,616
8,410,361,253,1024,616
9,381,383,268,1032,616
10,379,405,266,1050,616
11,400,396,281,1077,616
1,500,200,50,750,617
2,468,220,96,784,617
3,442,245,133,820,617
4,417,282,166,865,617
5,406,307,195,908,617
6,409,361,200,970,617
7,386,371,217,974,617
8,390,380,236,1006,617
9,376,400,263,1039,617
10,353,419,276,1048,617
11,375,402,293,1070,617
1,500,200,50,750,618
2,447,233,103,783,618
3,449,268,127,844,618
4,415,291,157,863,618
5,417,313,185,915,618
6,400,324,208,932,618
7,390,354,238,982,618
8,403,356,266,1025,618
9,404,398,245,1047,618
10,402,404,257,1063,618
11,408,414,266,1088,618
1,500,200,50,750,619
2,468,238,88,794,619
3,427,263,135,825,619
4,418,290,166,874,619
5,405,301,200,906,619
6,396,335,226,957,619
7,368,355,250,973,619
8,375,386,242,1003,619
9,373,406,233,1012,619
10,379,421,253,1053,619
11,362,440,264,1066,619
1,500,200,50,750,620
2,472,235,80,787,620
3,445,272,117,834,620
4,431,285,158,874,620
5,419,295,197,911,620
6,406,340,221,967,620
7,379,353,241,973,620
8,383,373,246,1002,620
9,379,416,254,1049,620
10,382,406,263,1051,620
11,408,424,271,1103,620
1,500,200,50,750,621
2,464,228,84,776,621
3,429,263,123,815,621
4,407,284,173,864,621
5,396,306,202,904,621
6,411,332,205,948,621
7,426,349,222,997,621
8,386,351,255,992,621
9,404,360,277,1041,621
10,402,380,280,1062,621
11,395,395,298,1088,621
1,500,200,50,750,622
2,465,230,87,782,622
3,417,278,124,819,622
4,405,305,144,854,622
5,424,308,187,919,622
6,416,340,194,950,622
7,418,350,207,975,622
8,451,359,201,1011,622
9,460,347,233,1040,622
10,471,378,222,1071,622
11,449,403,226,1078,622
1,500,200,50,750,623
2,452,220,112,784,623
3,426,255,144,825,623
4,412,303,153,868,623
5,408,324,181,913,623
6,415,330,208,953,623
7,427,355,211,993,623
8,414,373,225,1012,623
9,402,368,260,1030,623
10,397,398,249,1044,623
11,401,423,247,1071,623
1,500,200,50,750,624
2,470,233,90,793,624
3,458,237,130,825,624
4,437,261,155,853,624
5,423,283,205,911,624
6,426,311,224,961,624
7,412,348,219,979,624
8,387,383,239,1009,624
9,393,367,273,1033,624
10,379,374,289,1042,624
11,375,389,312,1076,624
1,500,200,50,750,625
2,450,244,87,781,625
3,409,284,132,825,625
4,378,318,174,870,625
5,373,346,209,928,625
6,381,371,208,960,625
7,364,385,225,974,625
8,365,383,244,992,625
9,387,397,257,1041,625
10,397,387,278,1062,625
11,402,389,296,1087,625
1,500,200,50,750,626
2,467,236,102,805,626
3,432,271,129,832,626
4,415,285,173,873,626
5,414,329,184,927,626
6,411,356,215,982,626
7,383,375,219,977,626
8,380,364,262,1006,626
9,397,389,246,1032,626
10,391,397,265,1053,626
11,401,388,285,1074,626
1,500,200,50,750,627
2,456,246,97,799,627
3,417,284,134,835,627
4,391,306,166,863,627
5,387,339,184,910,627
6,383,369,203,955,627
7,385,359,220,964,627
8,381,374,245,1000,627
9,389,370,280,1039,627
10,380,386,282,1048,627
11,394,394,284,1072,627
1,500,200,50,750,628
2,445,239,100,784,628
3,415,276,133,824,628
4,391,307,169,867,628
5,387,321,199,907,628
6,396,347,221,964,628
7,387,385,221,993,628
8,384,379,251,1014,628
9,397,382,260,1039,628
10,419,408,232,1059,628
11,409,431,250,1090,628
1,500,200,50,750,629
2,453,254,91,798,629
3,432,272,130,834,629
4,406,311,155,872,629
5,401,321,201,923,629
6,392,346,219,957,629
7,380,363,235,978,629
8,377,389,239,1005,629
9,386,391,250,1027,629
10,386,413,259,1058,629
11,391,429,254,1074,629
1,500,200,50,750,630
2,464,234,95,793,630
3,444,236,151,831,630
4,415,271,177,863,630
5,424,327,165,916,630
6,416,350,175,941,630
7,427,348,208,983,630
8,410,348,243,1001,630
9,406,351,262,1019,630
10,410,361,268,1039,630
11,426,370,272,1068,630
1,500,200,50,750,631
2,455,235,102,792,631
3,447,264,127,838,631
4,406,289,164,859,631
5,411,296,183,890,631
6,414,323,223,960,631
7,405,354,222,981,631
8,403,368,234,1005,631
9,405,383,259,1047,631
10,394,379,263,1036,631
11,396,413,273,1082,631
1,500,200,50,750,632
2,459,231,99,789,632
3,443,252,134,829,632
4,408,279,171,858,632
5,399,327,184,910,632
6,420,354,197,971,632
7,400,361,225,986,632
8,397,371,239,1007,632
9,389,382,256,1027,632
10,388,390,260,1038,632
11,391,392,287,1070,632
1,500,200,50,750,633
2,455,239,97,791,633
3,423,255,157,835,633
4,424,288,181,893,633
5,413,296,203,912,633
6,396,324,214,934,633
7,410,348,222,980,633
8,406,393,211,1010,633
9,413,390,237,1040,633
10,398,401,266,1065,633
11,383,434,280,1097,633
1,500,200,50,750,634
2,446,237,98,781,634
3,420,244,142,806,634
4,425,268,161,854,634
5,419,300,196,915,634
6,424,316,223,963,634
7,402,334,243,979,634
8,414,352,240,1006,634
9,422,338,264,1024,634
10,419,358,269,1046,634
11,427,368,273,1068,634
1,500,200,50,750,635
2,461,212,109,782,635
3,439,236,143,818,635
4,427,249,181,857,635
5,413,298,198,909,635
6,421,321,210,952,635
7,396,344,222,962,635
8,404,374,228,1006,635
9,409,392,233,1034,635
10,415,395,257,1067,635
11,417,379,279,1075,635
1,500,200,50,750,636
2,443,222,105,770,636
3,415,269,145,829,636
4,407,282,176,865,636
5,411,305,208,924,636
6,396,317,238,951,636
7,375,345,261,981,636
8,397,352,263,1012,636
9,383,363,280,1026,636
10,384,391,297,1072,636
11,393,398,288,1079,636
1,500,200,50,750,637
2,475,220,98,793,637
3,442,263,127,832,637
4,430,285,147,862,637
5,401,333,174,908,637
6,400,345,212,957,637
7,410,375,217,1002,637
8,401,377,229,1007,637
9,391,379,248,1018,637
10,388,420,251,1059,637
11,407,405,278,1090,637
1,500,200,50,750,638
2,461,229,102,792,638
3,431,252,139,822,638
4,411,283,173,867,638
5,395,323,197,915,638
6,392,340,215,947,638
7,418,340,225,983,638
8,419,363,231,1013,638
9,418,363,254,1035,638
10,417,384,262,1063,638
11,417,405,263,1085,638
1,500,200,50,750,639
2,443,230,101,774,639
3,440,268,129,837,639
4,411,305,149,865,639
5,394,334,183,911,639
6,411,327,216,954,639
7,385,363,228,976,639
8,399,405,218,1022,639
9,407,400,234,1041,639
10,407,410,245,1062,639
11,410,412,271,1093,639
1,500,200,50,750,640
2,462,227,101,790,640
3,444,247,129,820,640
4,426,274,161,861,640
5,429,302,178,909,640
6,401,341,200,942,640
7,365,363,246,974,640
8,388,376,252,1016,640
9,367,401,255,1023,640
10,361,411,269,1041,640
11,406,416,284,1106,640
1,500,200,50,750,641
2,448,229,122,799,641
3,426,255,138,819,641
4,411,278,168,857,641
5,405,321,177,903,641
6,393,361,206,960,641
7,407,367,213,987,641
8,398,368,249,1015,641
9,391,372,265,1028,641
10,396,385,273,1054,641
11,389,397,288,1074,641
1,500,200,50,750,642
2,446,236,110,792,642
3,421,255,155,831,642
4,399,258,197,854,642
5,393,306,209,908,642
6,404,342,229,975,642
7,398,373,215,986,642
8,400,356,242,998,642
9,415,373,240,1028,642
10,436,391,235,1062,642
11,429,394,260,1083,642
1,500,200,50,750,643
2,467,234,94,795,643
3,413,265,142,820,643
4,407,287,166,860,643
5,405,302,196,903,643
6,426,323,222,971,643
7,414,330,244,988,643
8,396,368,244,1008,643
9,388,356,270,1014,643
10,411,378,278,1067,643
11,408,392,279,1079,643
1,500,200,50,750,644
2,465,231,95,791,644
3,412,256,145,813,644
4,405,299,170,874,644
5,424,323,181,928,644
6,403,336,213,952,644
7,424,337,229,990,644
8,405,368,229,1002,644
9,408,378,241,1027,644
10,424,407,233,1064,644
11,436,394,250,1080,644
1,500,200,50,750,645
2,456,236,96,788,645
3,450,252,135,837,645
4,395,275,175,845,645
5,418,295,210,923,645
6,377,350,227,954,645
7,357,370,258,985,645
8,347,376,261,984,645
9,362,407,259,1028,645
10,373,401,271,1045,645
11,379,432,270,1081,645
1,500,200,50,750,646
2,438,242,102,782,646
3,437,267,134,838,646
4,415,282,172,869,646
5,411,313,203,927,646
6,389,331,235,955,646
7,371,354,245,970,646
8,393,355,248,996,646
9,391,358,271,1020,646
10,396,398,275,1069,646
11,397,416,267,1080,646
1,500,200,50,750,647
2,453,239,100,792,647
3,427,268,134,829,647
4,403,284,182,869,647
5,392,322,203,917,647
6,407,357,205,969,647
7,400,366,218,984,647
8,395,410,215,1020,647
9,397,390,250,1037,647
10,383,408,260,1051,647
11,382,410,287,1079,647
1,500,200,50,750,648
2,460,228,88,776,648
3,441,249,135,825,648
4,438,285,152,875,648
5,437,323,160,920,648
6,422,338,195,955,648
7,417,334,224,975,648
8,437,370,221,1028,648
9,410,399,226,1035,648
10,418,375,257,1050,648
11,434,384,287,1105,648
1,500,200,50,750,649
2,459,241,92,792,649
3,443,252,131,826,649
4,416,309,150,875,649
5,408,315,179,902,649
6,426,330,217,973,649
7,394,364,219,977,649
8,400,360,246,1006,649
9,397,376,263,1036,649
10,378,406,278,1062,649
11,389,418,270,1077,649
1,500,200,50,750,650
2,439,252,100,791,650
3,404,282,144,830,650
4,401,294,163,858,650
5,401,328,193,922,650
6,385,343,223,951,650
7,374,351,229,954,650
8,374,366,253,993,650
9,381,369,279,1029,650
10,385,382,288,1055,650
11,387,421,285,1093,650
1,500,200,50,750,651
2,452,247,84,783,651
3,429,262,132,823,651
4,403,313,156,872,651
5,383,336,189,908,651
6,389,337,217,943,651
7,403,358,225,986,651
8,406,351,258,1015,651
9,378,388,260,1026,651
10,370,416,270,1056,651
11,373,420,275,1068,651
1,500,200,50,750,652
2,470,209,106,785,652
3,437,255,130,822,652
4,404,319,156,879,652
5,377,330,203,910,652
6,370,385,203,958,652
7,356,399,221,976,652
8,376,420,211,1007,652
9,388,417,237,1042,652
10,375,427,253,1055,652
11,392,422,254,1068,652
1,500,200,50,750,653
2,445,239,92,776,653
3,428,266,129,823,653
4,421,271,156,848,653
5,440,294,184,918,653
6,426,324,213,963,653
7,414,353,226,993,653
8,404,358,249,1011,653
9,412,379,247,1038,653
10,407,386,258,1051,653
11,403,435,244,1082,653
1,500,200,50,750,654
2,469,235,93,797,654
3,441,246,141,828,654
4,422,275,171,868,654
5,410,290,191,891,654
6,410,319,222,951,654
7,401,359,220,980,654
8,402,365,236,1003,654
9,401,382,245,1028,654
10,391,392,266,1049,654
11,395,404,284,1083,654
1,500,200,50,750,655
2,447,251,88,786,655
3,407,277,138,822,655
4,401,292,173,866,655
5,391,311,204,906,655
6,385,335,224,944,655
7,379,369,226,974,655
8,381,395,236,1012,655
9,378,392,261,1031,655
10,383,395,266,1044,655
11,395,433,260,1088,655
1,500,200,50,750,656
2,454,241,101,796,656
3,414,255,146,815,656
4,418,302,181,901,656
5,418,308,196,922,656
6,425,332,215,972,656
7,407,344,219,970,656
8,391,358,252,1001,656
9,376,397,259,1032,656
10,360,410,283,1053,656
11,370,399,309,1078,656
1,500,200,50,750,657
2,457,222,103,782,657
3,436,243,140,819,657
4,403,294,164,861,657
5,407,318,188,913,657
6,412,328,217,957,657
7,410,341,225,976,657
8,419,342,247,1008,657
9,407,365,257,1029,657
10,421,379,260,1060,657
11,418,380,284,1082,657
1,500,200,50,750,658
2,453,247,91,791,658
3,408,282,132,822,658
4,405,307,161,873,658
5,407,302,201,910,658
6,411,334,213,958,658
7,404,338,232,974,658
8,390,389,215,994,658
9,399,404,245,1048,658
10,380,408,268,1056,658
11,383,396,295,1074,658
1,500,200,50,750,659
2,457,242,97,796,659
3,444,257,132,833,659
4,437,264,172,873,659
5,429,305,202,936,659
6,386,332,210,928,659
7,376,347,235,958,659
8,402,350,263,1015,659
9,396,382,270,1048,659
10,397,381,284,1062,659
11,403,419,269,1091,659
1,500,200,50,750,660
2,446,239,99,784,660
3,427,260,137,824,660
4,401,285,180,866,660
5,413,308,192,913,660
6,415,326,211,952,660
7,404,357,232,993,660
8,402,371,235,1008,660
9,416,395,235,1046,660
10,411,404,244,1059,660
11,412,413,256,1081,660
1,500,200,50,750,661
2,453,236,98,787,661
3,411,262,141,814,661
4,406,293,161,860,661
5,380,327,182,889,661
6,423,354,214,991,661
7,388,341,248,977,661
8,386,358,256,1000,661
9,385,381,265,1031,661
10,366,417,262,1045,661
11,388,415,262,1065,661
1,500,200,50,750,662
2,454,214,98,766,662
3,427,259,130,816,662
4,437,284,175,896,662
5,412,309,202,923,662
6,395,345,214,954,662
7,395,361,232,988,662
8,391,369,249,1009,662
9,414,370,263,1047,662
10,400,377,276,1053,662
11,417,401,268,1086,662
1,500,200,50,750,663
2,434,249,104,787,663
3,421,271,132,824,663
4,408,296,161,865,663
5,386,340,192,918,663
6,381,364,200,945,663
7,397,359,235,991,663
8,400,371,240,1011,663
9,423,390,255,1068,663
10,378,403,267,1048,663
11,389,424,276,1089,663
1,500,200,50,750,664
2,442,247,97,786,664
3,413,266,146,825,664
4,409,279,181,869,664
5,444,309,181,934,664
6,430,345,201,976,664
7,399,371,205,975,664
8,402,372,236,1010,664
9,387,381,260,1028,664
10,393,392,264,1049,664
11,385,397,290,1072,664
1,500,200,50,750,665
2,488,205,98,791,665
3,449,240,132,821,665
4,433,274,159,866,665
5,415,313,178,906,665
6,416,332,208,956,665
7,390,381,221,992,665
8,389,403,208,1000,665
9,374,422,236,1032,665
10,392,400,266,1058,665
11,384,406,289,1079,665
1,500,200,50,750,666
2,472,228,91,791,666
3,441,270,117,828,666
4,434,295,152,881,666
5,411,333,179,923,666
6,383,350,218,951,666
7,389,362,237,988,666
8,393,390,231,1014,666
9,387,402,242,1031,666
10,394,427,237,1058,666
11,400,410,274,1084,666
1,500,200,50,750,667
2,448,226,107,781,667
3,424,255,151,830,667
4,402,310,154,866,667
5,397,331,191,919,667
6,390,344,220,954,667
7,385,358,238,981,667
8,384,375,246,1005,667
9,375,374,251,1000,667
10,426,376,261,1063,667
11,427,370,276,1073,667
1,500,200,50,750,668
2,470,217,105,792,668
3,436,253,149,838,668
4,420,265,187,872,668
5,410,301,188,899,668
6,417,332,200,949,668
7,434,345,214,993,668
8,418,373,216,1007,668
9,418,374,250,1042,668
10,421,377,271,1069,668
11,403,404,258,1065,668
1,500,200,50,750,669
2,468,227,81,776,669
3,463,260,125,848,669
4,431,294,151,876,669
5,397,316,184,897,669
6,407,344,202,953,669
7,412,340,239,991,669
8,406,361,245,1012,669
9,417,370,244,1031,669
10,429,370,266,1065,669
11,416,381,293,1090,669
1,500,200,50,750,670
2,449,247,84,780,670
3,442,280,122,844,670
4,397,311,158,866,670
5,389,339,182,910,670
6,379,344,225,948,670
7,377,336,262,975,670
8,386,354,264,1004,670
9,381,382,262,1025,670
10,391,388,286,1065,670
11,382,402,293,1077,670
1,500,200,50,750,671
2,459,238,95,792,671
3,422,268,134,824,671
4,398,289,179,866,671
5,419,295,190,904,671
6,411,330,213,954,671
7,385,359,245,989,671
8,383,370,256,1009,671
9,420,365,256,1041,671
10,416,402,244,1062,671
11,399,411,279,1089,671
1,500,200,50,750,672
2,477,221,97,795,672
3,423,256,132,811,672
4,384,296,169,849,672
5,394,329,189,912,672
6,410,338,213,961,672
7,409,339,231,979,672
8,422,358,239,1019,672
9,387,381,251,1019,672
10,405,403,251,1059,672
11,413,399,249,1061,672
1,500,200,50,750,673
2,438,246,94,778,673
3,425,277,135,837,673
4,398,297,168,863,673
5,396,305,205,906,673
6,402,332,217,951,673
7,386,343,225,954,673
8,389,371,243,1003,673
9,410,369,269,1048,673
10,382,379,283,1044,673
11,401,403,280,1084,673
1,500,200,50,750,674
2,465,213,120,798,674
3,433,248,146,827,674
4,405,293,170,868,674
5,398,289,200,887,674
6,430,333,208,971,674
7,407,347,231,985,674
8,395,361,241,997,674
9,422,385,232,1039,674
10,430,388,253,1071,674
11,439,369,277,1085,674
1,500,200,50,750,675
2,452,239,95,786,675
3,420,277,133,830,675
4,403,304,169,876,675
5,393,315,196,904,675
6,421,350,203,974,675
7,401,355,221,977,675
8,387,362,255,1004,675
9,380,379,277,1036,675
10,373,388,282,1043,675
11,401,394,293,1088,675
1,500,200,50,750,676
2,462,229,98,789,676
3,445,252,147,844,676
4,428,274,176,878,676
5,410,286,219,915,676
6,423,324,220,967,676
7,416,337,231,984,676
8,448,341,230,1019,676
9,412,381,232,1025,676
10,391,400,266,1057,676
11,394,403,265,1062,676
1,500,200,50,750,677
2,458,220,97,775,677
3,448,239,133,820,677
4,421,282,163,866,677
5,417,303,184,904,677
6,418,334,215,967,677
7,388,356,232,976,677
8,396,390,228,1014,677
9,383,408,230,1021,677
10,391,411,261,1063,677
11,400,418,272,1090,677
1,500,200,50,750,678
2,472,202,110,784,678
3,457,254,119,830,678
4,418,271,160,849,678
5,399,298,184,881,678
6,411,312,213,936,678
7,408,342,233,983,678
8,386,354,252,992,678
9,403,393,234,1030,678
10,381,416,241,1038,678
11,394,429,255,1078,678
1,500,200,50,750,679
2,463,226,104,793,679
3,443,238,149,830,679
4,397,292,175,864,679
5,402,327,185,914,679
6,390,341,208,939,679
7,395,378,203,976,679
8,398,391,226,1015,679
9,386,375,256,1017,679
10,396,384,271,1051,679
11,400,413,254,1067,679
1,500,200,50,750,680
2,456,230,102,788,680
3,436,242,137,815,680
4,422,289,162,873,680
5,406,307,191,904,680
6,406,354,199,959,680
7,407,358,220,985,680
8,396,381,227,1004,680
9,403,374,254,1031,680
10,412,386,283,1081,680
11,422,377,290,1089,680
1,500,200,50,750,681
2,443,228,106,777,681
3,433,266,126,825,681
4,431,274,155,860,681
5,434,286,185,905,681
6,429,347,182,958,681
7,435,376,191,1002,681
8,416,359,231,1006,681
9,414,373,250,1037,681
10,411,403,250,1064,681
11,397,402,278,1077,681
1,500,200,50,750,682
2,452,232,100,784,682
3,421,249,146,816,682
4,413,281,175,869,682
5,407,316,203,926,682
6,390,329,230,949,682
7,375,349,254,978,682
8,381,337,271,989,682
9,392,353,276,1021,682
10,399,354,283,1036,682
11,410,402,288,1100,682
1,500,200,50,750,683
2,447,224,109,780,683
3,442,259,146,847,683
4,406,301,157,864,683
5,415,306,187,908,683
6,421,348,198,967,683
7,409,345,221,975,683
8,397,359,229,985,683
9,391,405,240,1036,683
10,395,423,252,1070,683
11,396,416,267,1079,683
1,500,200,50,750,684
2,464,224,96,784,684
3,443,252,137,832,684
4,430,283,166,879,684
5,412,296,200,908,684
6,401,307,221,929,684
7,425,327,224,976,684
8,402,348,268,1018,684
9,406,341,289,1036,684
10,393,389,278,1060,684
11,405,381,298,1084,684
1,500,200,50,750,685
2,455,228,107,790,685
3,427,254,144,825,685
4,402,273,180,855,685
5,392,293,208,893,685
6,382,345,232,959,685
7,375,348,255,978,685
8,382,373,263,1018,685
9,383,387,252,1022,685
10,401,384,264,1049,685
11,413,392,285,1090,685
1,500,200,50,750,686
2,445,244,104,793,686
3,417,261,146,824,686
4,438,279,162,879,686
5,417,311,183,911,686
6,412,342,207,961,686
7,401,371,200,972,686
8,408,370,231,1009,686
9,402,384,248,1034,686
10,403,364,290,1057,686
11,390,409,292,1091,686
1,500,200,50,750,687
2,473,234,89,796,687
3,436,277,126,839,687
4,398,291,176,865,687
5,373,317,207,897,687
6,366,352,231,949,687
7,390,344,245,979,687
8,394,368,250,1012,687
9,382,395,253,1030,687
10,406,388,271,1065,687
11,429,397,273,1099,687
1,500,200,50,750,688
2,470,238,86,794,688
3,421,261,127,809,688
4,409,291,161,861,688
5,423,317,191,931,688
6,405,348,206,959,688
7,405,369,209,983,688
8,397,387,229,1013,688
9,399,380,252,1031,688
10,389,414,247,1050,688
11,403,422,257,1082,688
1,500,200,50,750,689
2,468,231,83,782,689
3,429,256,125,810,689
4,414,288,163,865,689
5,404,333,181,918,689
6,398,335,210,943,689
7,391,364,218,973,689
8,405,364,241,1010,689
9,390,391,251,1032,689
10,398,385,266,1049,689
11,415,414,254,1083,689
1,500,200,50,750,690
2,464,237,88,789,690
3,450,256,119,825,690
4,440,282,154,876,690
5,423,321,169,913,690
6,412,356,176,944,690
7,416,349,218,983,690
8,399,387,227,1013,690
9,393,406,231,1030,690
10,382,427,240,1049,690
11,395,437,261,1093,690
1,500,200,50,750,691
2,464,218,111,793,691
3,424,248,154,826,691
4,436,305,142,883,691
5,421,326,162,909,691
6,411,340,200,951,691
7,411,339,229,979,691
8,413,365,226,1004,691
9,424,383,249,1056,691
10,386,413,249,1048,691
11,395,418,273,1086,691
1,500,200,50,750,692
2,452,231,94,777,692
3,423,264,124,811,692
4,410,289,165,864,692
5,401,322,192,915,692
6,402,324,242,968,692
7,381,344,255,980,692
8,362,370,272,1004,692
9,374,405,273,1052,692
10,368,423,273,1064,692
11,373,425,284,1082,692
1,500,200,50,750,693
2,457,222,100,779,693
3,429,242,131,802,693
4,439,282,164,885,693
5,422,300,181,903,693
6,410,348,201,959,693
7,397,362,225,984,693
8,374,393,239,1006,693
9,381,391,262,1034,693
10,373,409,271,1053,693
11,384,423,279,1086,693
1,500,200,50,750,694
2,449,235,104,788,694
3,440,245,146,831,694
4,414,285,168,867,694
5,410,324,186,920,694
6,400,361,210,971,694
7,386,391,213,990,694
8,368,377,256,1001,694
9,376,391,254,1021,694
10,382,387,281,1050,694
11,390,407,282,1079,694
1,500,200,50,750,695
2,443,247,94,784,695
3,398,269,142,809,695
4,386,301,163,850,695
5,377,327,205,909,695
6,385,322,246,953,695
7,384,355,242,981,695
8,396,365,261,1022,695
9,397,370,265,1032,695
10,404,392,267,1063,695
11,421,384,275,1080,695
1,500,200,50,750,696
2,469,243,89,801,696
3,417,281,118,816,696
4,428,287,157,872,696
5,398,327,184,909,696
6,378,365,210,953,696
7,390,351,238,979,696
8,383,366,256,1005,696
9,390,401,253,1044,696
10,376,415,268,1059,696
11,387,408,292,1087,696
1,500,200,50,750,697
2,460,237,93,790,697
3,457,246,140,843,697
4,423,281,159,863,697
5,415,316,182,913,697
6,391,372,203,966,697
7,360,397,229,986,697
8,367,409,244,1020,697
9,338,435,266,1039,697
10,339,424,285,1048,697
11,349,418,304,1071,697
1,500,200,50,750,698
2,459,239,91,789,698
3,424,258,136,818,698
4,429,288,167,884,698
5,370,328,211,909,698
6,369,357,229,955,698
7,381,362,241,984,698
8,403,381,233,1017,698
9,393,409,243,1045,698
10,397,399,256,1052,698
11,407,419,255,1081,698
1,500,200,50,750,699
2,457,232,112,801,699
3,417,243,159,819,699
4,401,271,194,866,699
5,403,300,199,902,699
6,407,328,220,955,699
7,399,351,244,994,699
8,382,375,240,997,699
9,384,406,250,1040,699
10,399,424,248,1071,699
11,389,428,276,1093,699
1,500,200,50,750,700
2,482,219,110,811,700
3,444,253,142,839,700
4,407,291,178,876,700
5,415,331,180,926,700
6,414,329,213,956,700
7,400,344,236,980,700
8,404,357,268,1029,700
9,392,381,258,1031,700
10,378,415,247,1040,700
11,413,404,266,1083,700
1,500,200,50,750,701
2,451,232,105,788,701
3,425,264,131,820,701
4,405,305,161,871,701
5,382,327,202,911,701
6,422,336,227,985,701
7,383,345,249,977,701
8,393,363,251,1007,701
9,368,381,268,1017,701
10,409,364,282,1055,701
11,424,379,284,1087,701
1,500,200,50,750,702
2,464,232,82,778,702
3,437,252,129,818,702
4,414,300,171,885,702
5,386,325,196,907,702
6,400,342,222,964,702
7,378,375,232,985,702
8,403,385,245,1033,702
9,382,392,252,1026,702
10,385,418,264,1067,702
11,393,441,262,1096,702
1,500,200,50,750,703
2,460,238,83,781,703
3,433,270,136,839,703
4,405,281,174,860,703
5,412,296,196,904,703
6,414,321,214,949,703
7,391,354,210,955,703
8,398,382,236,1016,703
9,395,397,235,1027,703
10,412,394,265,1071,703
11,420,407,264,1091,703
1,500,200,50,750,704
2,427,234,99,760,704
3,422,271,132,825,704
4,398,300,153,851,704
5,392,317,182,891,704
6,397,358,208,963,704
7,390,354,241,985,704
8,389,358,257,1004,704
9,380,377,280,1037,704
10,376,396,278,1050,704
11,385,414,282,1081,704
1,500,200,50,750,705
2,447,250,94,791,705
3,429,272,127,828,705
4,397,300,149,846,705
5,400,313,189,902,705
6,423,336,205,964,705
7,414,356,219,989,705
8,409,350,255,1014,705
9,383,369,276,1028,705
10,400,361,295,1056,705
11,383,397,302,1082,705
1,500,200,50,750,706
2,467,217,104,788,706
3,448,247,135,830,706
4,432,276,167,875,706
5,417,314,179,910,706
6,406,342,205,953,706
7,413,342,223,978,706
8,403,368,243,1014,706
9,390,386,254,1030,706
10,386,408,258,1052,706
11,389,409,285,1083,706
1,500,200,50,750,707
2,450,234,115,799,707
3,412,264,149,825,707
4,394,295,176,865,707
5,410,321,194,925,707
6,391,350,210,951,707
7,419,340,234,993,707
8,394,356,258,1008,707
9,361,401,270,1032,707
10,379,423,278,1080,707
11,386,416,286,1088,707
1,500,200,50,750,708
2,461,235,98,794,708
3,436,249,136,821,708
4,403,296,173,872,708
5,387,323,199,909,708
6,404,336,225,965,708
7,415,358,234,1007,708
8,399,375,241,1015,708
9,404,382,251,1037,708
10,392,400,265,1057,708
11,394,404,279,1077,708
1,500,200,50,750,709
2,452,229,90,771,709
3,438,268,134,840,709
4,407,302,167,876,709
5,399,328,167,894,709
6,423,334,202,959,709
7,398,349,233,980,709
8,401,360,250,1011,709
9,390,384,273,1047,709
10,394,391,280,1065,709
11,419,391,276,1086,709
1,500,200,50,750,710
2,463,230,100,793,710
3,445,259,119,823,710
4,428,296,149,873,710
5,434,321,180,935,710
6,431,323,204,958,710
7,424,338,224,986,710
8,422,336,240,998,710
9,405,368,247,1020,710
10,416,401,257,1074,710
11,391,401,286,1078,710
1,500,200,50,750,711
2,456,232,103,791,711
3,449,253,135,837,711
4,412,279,181,872,711
5,375,332,207,914,711
6,381,335,213,929,711
7,376,358,236,970,711
8,399,371,258,1028,711
9,394,388,252,1034,711
10,391,413,275,1079,711
11,371,425,272,1068,711
1,500,200,50,750,712
2,457,225,102,784,712
3,430,264,124,818,712
4,436,291,153,880,712
5,431,300,176,907,712
6,427,319,211,957,712
7,400,341,238,979,712
8,396,361,254,1011,712
9,393,376,256,1025,712
10,411,399,262,1072,712
11,416,409,273,1098,712
1,500,200,50,750,713
2,448,243,95,786,713
3,418,272,136,826,713
4,393,294,168,855,713
5,409,316,180,905,713
6,408,342,208,958,713
7,386,392,211,989,713
8,388,393,229,1010,713
9,398,405,230,1033,713
10,417,382,262,1061,713
11,421,411,252,1084,713
1,500,200,50,750,714
2,456,228,106,790,714
3,432,256,142,830,714
4,424,280,168,872,714
5,404,288,198,890,714
6,407,335,217,959,714
7,404,356,219,979,714
8,397,379,228,1004,714
9,381,387,249,1017,714
10,412,407,245,1064,714
11,395,434,261,1090,714
1,500,200,50,750,715
2,440,241,96,777,715
3,447,261,128,836,715
4,423,277,159,859,715
5,396,314,183,893,715
6,393,343,201,937,715
7,387,368,220,975,715
8,401,379,259,1039,715
9,379,365,283,1027,715
10,398,379,287,1064,715
11,393,417,276,1086,715
1,500,200,50,750,716
2,447,238,105,790,716
3,414,265,141,820,716
4,391,307,167,865,716
5,408,332,193,933,716
6,409,336,221,966,716
7,387,355,235,977,716
8,378,382,241,1001,716
9,364,393,270,1027,716
10,368,412,275,1055,716
11,366,410,291,1067,716
1,500,200,50,750,717
2,456,236,108,800,717
3,427,260,143,830,717
4,410,272,169,851,717
5,424,310,188,922,717
6,411,330,205,946,717
7,415,357,221,993,717
8,410,382,232,1024,717
9,385,373,241,999,717
10,434,377,244,1055,717
11,406,385,269,1060,717
1,500,200,50,750,718
2,464,241,89,794,718
3,432,267,122,821,718
4,419,284,163,866,718
5,434,308,171,913,718
6,439,328,201,968,718
7,442,343,205,990,718
8,427,352,231,1010,718
9,411,370,256,1037,718
10,387,392,280,1059,718
11,400,399,294,1093,718
1,500,200,50,750,719
2,450,226,94,770,719
3,441,256,138,835,719
4,419,278,180,877,719
5,388,313,215,916,719
6,370,351,218,939,719
7,392,370,239,1001,719
8,380,384,237,1001,719
9,380,400,266,1046,719
10,383,400,280,1063,719
11,402,407,283,1092,719
1,500,200,50,750,720
2,446,241,103,790,720
3,403,259,150,812,720
4,400,278,187,865,720
5,384,295,213,892,720
6,386,341,219,946,720
7,394,345,227,966,720
8,390,378,255,1023,720
9,384,381,267,1032,720
10,397,373,264,1034,720
11,398,417,263,1078,720
1,500,200,50,750,721
2,457,228,95,780,721
3,425,263,133,821,721
4,417,302,160,879,721
5,408,325,189,922,721
6,376,331,226,933,721
7,394,375,217,986,721
8,398,376,242,1016,721
9,387,373,271,1031,721
10,390,391,280,1061,721
11,390,395,291,1076,721
1,500,200,50,750,722
2,457,221,104,782,722
3,434,255,138,827,722
4,420,301,158,879,722
5,404,330,185,919,722
6,420,323,216,959,722
7,410,362,223,995,722
8,395,343,260,998,722
9,397,368,253,1018,722
10,399,393,269,1061,722
11,402,405,292,1099,722
1,500,200,50,750,723
2,459,223,104,786,723
3,422,251,152,825,723
4,434,285,171,890,723
5,392,315,196,903,723
6,395,326,207,928,723
7,406,352,225,983,723
8,389,385,225,999,723
9,412,379,234,1025,723
10,422,396,236,1054,723
11,444,393,250,1087,723
1,500,200,50,750,724
2,452,249,96,797,724
3,399,291,137,827,724
4,391,318,154,863,724
5,380,332,201,913,724
6,407,354,216,977,724
7,389,348,244,981,724
8,393,359,255,1007,724
9,381,403,257,1041,724
10,396,381,279,1056,724
11,386,399,285,1070,724
1,500,200,50,750,725
2,459,240,90,789,725
3,427,267,125,819,725
4,411,288,171,870,725
5,383,339,183,905,725
6,378,372,201,951,725
7,375,369,228,972,725
8,377,391,249,1017,725
9,370,387,267,1024,725
10,403,391,273,1067,725
11,404,411,260,1075,725
1,500,200,50,750,726
2,444,243,100,787,726
3,410,285,133,828,726
4,403,310,147,860,726
5,413,317,184,914,726
6,406,344,208,958,726
7,392,365,223,980,726
8,403,356,252,1011,726
9,409,360,271,1040,726
10,408,361,294,1063,726
11,416,366,301,1083,726
1,500,200,50,750,727
2,457,226,104,787,727
3,408,244,171,823,727
4,402,260,193,855,727
5,408,304,213,925,727
6,405,342,223,970,727
7,389,334,252,975,727
8,397,374,247,1018,727
9,389,390,251,1030,727
10,375,400,266,1041,727
11,387,438,267,1092,727
1,500,200,50,750,728
2,473,224,95,792,728
3,444,243,132,819,728
4,413,306,153,872,728
5,390,320,196,906,728
6,404,345,209,958,728
7,378,341,249,968,728
8,374,358,267,999,728
9,391,365,279,1035,728
10,393,388,282,1063,728
11,400,408,270,1078,728
1,500,200,50,750,729
2,444,228,107,779,729
3,443,262,129,834,729
4,422,281,167,870,729
5,399,329,183,911,729
6,387,358,204,949,729
7,388,379,221,988,729
8,394,385,244,1023,729
9,397,380,252,1029,729
10,417,384,268,1069,729
11,415,409,262,1086,729
1,500,200,50,750,730
2,471,226,84,781,730
3,431,263,122,816,730
4,422,311,142,875,730
5,402,317,190,909,730
6,401,368,190,959,730
7,399,359,221,979,730
8,402,358,246,1006,730
9,397,383,247,1027,730
10,398,397,257,1052,730
11,396,404,262,1062,730
1,500,200,50,750,731
2,460,215,107,782,731
3,429,264,138,831,731
4,394,282,169,845,731
5,408,329,184,921,731
6,403,350,206,959,731
7,387,364,222,973,731
8,393,386,218,997,731
9,414,389,235,1038,731
10,402,419,237,1058,731
11,396,434,252,1082,731
1,500,200,50,750,732
2,473,221,94,788,732
3,452,245,129,826,732
4,428,280,173,881,732
5,423,302,188,913,732
6,431,331,203,965,732
7,421,357,197,975,732
8,388,391,234,1013,732
9,372,393,259,1024,732
10,401,400,261,1062,732
11,390,413,281,1084,732
1,500,200,50,750,733
2,456,232,97,785,733
3,454,257,133,844,733
4,423,295,146,864,733
5,417,331,189,937,733
6,418,328,220,966,733
7,413,323,254,990,733
8,419,354,243,1016,733
9,402,355,271,1028,733
10,404,380,282,1066,733
11,405,403,260,1068,733
1,500,200,50,750,734
2,456,228,89,773,734
3,451,271,123,845,734
4,425,287,161,873,734
5,407,309,194,910,734
6,415,327,212,954,734
7,409,348,230,987,734
8,405,362,244,1011,734
9,412,368,261,1041,734
10,397,398,260,1055,734
11,394,428,258,1080,734
1,500,200,50,750,735
2,452,230,104,786,735
3,428,255,142,825,735
4,411,289,154,854,735
5,416,310,195,921,735
6,408,328,220,956,735
7,407,326,238,971,735
8,393,337,256,986,735
9,403,367,259,1029,735
10,394,398,259,1051,735
11,390,425,270,1085,735
1,500,200,50,750,736
2,476,215,102,793,736
3,432,260,130,822,736
4,424,288,156,868,736
5,428,312,172,912,736
6,442,314,204,960,736
7,392,346,226,964,736
8,391,350,255,996,736
9,395,381,277,1053,736
10,397,387,273,1057,736
11,400,396,273,1069,736
1,500,200,50,750,737
2,444,229,104,777,737
3,450,241,149,840,737
4,432,284,160,876,737
5,418,294,186,898,737
6,430,321,213,964,737
7,401,340,234,975,737
8,382,372,246,1000,737
9,385,360,265,1010,737
10,414,400,269,1083,737
11,389,443,258,1090,737
1,500,200,50,750,738
2,463,229,91,783,738
3,442,256,133,831,738
4,411,286,169,866,738
5,402,321,190,913,738
6,417,318,213,948,738
7,424,324,227,975,738
8,400,339,251,990,738
9,428,332,283,1043,738
10,425,366,280,1071,738
11,403,400,286,1089,738
1,500,200,50,750,739
2,454,240,102,796,739
3,419,275,141,835,739
4,378,296,175,849,739
5,391,320,198,909,739
6,401,350,211,962,739
7,379,354,242,975,739
8,393,353,265,1011,739
9,384,366,262,1012,739
10,405,394,269,1068,739
11,400,404,282,1086,739
1,500,200,50,750,740
2,439,249,99,787,740
3,406,287,144,837,740
4,378,311,175,864,740
5,366,354,203,923,740
6,373,359,228,960,740
7,377,345,266,988,740
8,370,380,261,1011,740
9,387,386,263,1036,740
10,398,411,259,1068,740
11,396,424,271,1091,740
1,500,200,50,750,741
2,465,230,99,794,741
3,435,254,137,826,741
4,410,276,173,859,741
5,437,289,207,933,741
6,413,322,233,968,741
7,426,346,236,1008,741
8,382,343,264,989,741
9,398,357,266,1021,741
10,400,399,263,1062,741
11,392,411,273,1076,741
1,500,200,50,750,742
2,458,223,103,784,742
3,448,264,136,848,742
4,403,286,175,864,742
5,418,311,200,929,742
6,410,330,220,960,742
7,390,357,235,982,742
8,380,363,255,998,742
9,394,382,265,1041,742
10,401,391,266,1058,742
11,402,410,281,1093,742
1,500,200,50,750,743
2,448,252,100,800,743
3,418,267,143,828,743
4,390,302,176,868,743
5,389,326,206,921,743
6,394,363,212,969,743
7,374,372,225,971,743
8,385,399,220,1004,743
9,399,403,228,1030,743
10,408,401,248,1057,743
11,428,418,243,1089,743
1,500,200,50,750,744
2,481,232,85,798,744
3,432,257,132,821,744
4,411,306,153,870,744
5,415,306,186,907,744
6,412,358,205,975,744
7,390,373,228,991,744
8,394,374,245,1013,744
9,397,353,267,1017,744
10,432,371,267,1070,744
11,402,391,280,1073,744
1,500,200,50,750,745
2,458,236,102,796,745
3,447,247,138,832,745
4,432,279,156,867,745
5,417,305,182,904,745
6,419,333,201,953,745
7,388,353,225,966,745
8,413,369,252,1034,745
9,406,393,234,1033,745
10,433,394,258,1085,745
11,399,411,268,1078,745
1,500,200,50,750,746
2,467,230,90,787,746
3,434,257,125,816,746
4,407,272,178,857,746
5,390,308,200,898,746
6,402,350,216,968,746
7,398,377,212,987,746
8,384,369,238,991,746
9,380,388,271,1039,746
10,369,389,287,1045,746
11,403,389,290,1082,746
1,500,200,50,750,747
2,458,239,93,790,747
3,424,276,131,831,747
4,415,288,178,881,747
5,390,337,182,909,747
6,408,358,197,963,747
7,393,361,222,976,747
8,362,384,258,1004,747
9,362,400,254,1016,747
10,374,413,274,1061,747
11,404,403,295,1102,747
1,500,200,50,750,748
2,453,228,101,782,748
3,440,263,131,834,748
4,433,274,162,869,748
5,424,296,192,912,748
6,410,320,226,956,748
7,410,336,241,987,748
8,402,346,257,1005,748
9,389,362,279,1030,748
10,367,413,271,1051,748
11,384,434,261,1079,748
1,500,200,50,750,749
2,450,219,108,777,749
3,415,250,152,817,749
4,423,281,162,866,749
5,427,293,192,912,749
6,393,317,243,953,749
7,381,352,260,993,749
8,374,376,256,1006,749
9,391,379,269,1039,749
10,391,391,294,1076,749
11,397,413,281,1091,749
1,500,200,50,750,750
2,435,226,113,774,750
3,439,244,144,827,750
4,434,268,171,873,750
5,412,300,185,897,750
6,409,320,215,944,750
7,432,333,241,1006,750
8,413,345,248,1006,750
9,408,376,259,1043,750
10,392,401,270,1063,750
11,366,423,275,1064,750
1,500,200,50,750,751
2,454,224,101,779,751
3,462,240,122,824,751
4,425,283,158,866,751
5,413,296,190,899,751
6,426,343,198,967,751
7,399,361,228,988,751
8,401,365,232,998,751
9,407,370,246,1023,751
10,403,418,242,1063,751
11,423,414,257,1094,751
1,500,200,50,750,752
2,448,239,104,791,752
3,408,269,142,819,752
4,393,310,163,866,752
5,389,333,211,933,752
6,381,359,225,965,752
7,377,360,251,988,752
8,378,374,250,1002,752
9,358,391,257,1006,752
10,378,426,255,1059,752
11,382,439,264,1085,752
1,500,200,50,750,753
2,469,243,86,798,753
3,442,256,126,824,753
4,445,265,166,876,753
5,428,273,197,898,753
6,420,322,203,945,753
7,392,364,220,976,753
8,390,348,242,980,753
9,410,370,254,1034,753
10,400,389,262,1051,753
11,416,434,244,1094,753
1,500,200,50,750,754
2,447,242,92,781,754
3,426,272,131,829,754
4,425,280,167,872,754
5,414,310,180,904,754
6,424,338,202,964,754
7,426,343,207,976,754
8,396,358,240,994,754
9,391,373,255,1019,754
10,413,381,274,1068,754
11,365,402,301,1068,754
1,500,200,50,750,755
2,457,240,90,787,755
3,431,270,126,827,755
4,418,286,153,857,755
5,399,342,175,916,755
6,416,343,186,945,755
7,438,356,193,987,755
8,415,351,224,990,755
9,404,389,242,1035,755
10,415,388,265,1068,755
11,421,378,284,1083,755
1,500,200,50,750,756
2,468,229,91,788,756
3,438,267,127,832,756
4,419,284,159,862,756
5,401,331,197,929,756
6,383,365,208,956,756
7,399,401,211,1011,756
8,382,413,212,1007,756
9,376,416,243,1035,756
10,389,421,269,1079,756
11,371,429,283,1083,756
1,500,200,50,750,757
2,461,221,110,792,757
3,424,260,140,824,757
4,395,314,170,879,757
5,380,340,182,902,757
6,405,348,198,951,757
7,389,363,223,975,757
8,386,380,231,997,757
9,401,393,252,1046,757
10,389,395,274,1058,757
11,397,409,276,1082,757
1,500,200,50,750,758
2,462,225,102,789,758
3,420,258,131,809,758
4,417,303,151,871,758
5,417,301,190,908,758
6,422,319,204,945,758
7,426,320,234,980,758
8,392,365,240,997,758
9,385,407,243,1035,758
10,411,406,254,1071,758
11,398,423,252,1073,758
1,500,200,50,750,759
2,463,219,92,774,759
3,443,251,139,833,759
4,410,299,157,866,759
5,389,316,200,905,759
6,388,360,204,952,759
7,394,360,228,982,759
8,409,353,244,1006,759
9,410,375,245,1030,759
10,409,396,257,1062,759
11,389,400,269,1058,759
1,500,200,50,750,760
2,456,246,90,792,760
3,429,260,146,835,760
4,410,283,167,860,760
5,433,307,174,914,760
6,420,334,196,950,760
7,405,334,230,969,760
8,399,356,242,997,760
9,422,383,232,1037,760
10,404,389,250,1043,760
11,411,418,265,1094,760
1,500,200,50,750,761
2,444,231,105,780,761
3,416,270,139,825,761
4,418,271,183,872,761
5,419,291,205,915,761
6,430,312,223,965,761
7,412,322,243,977,761
8,423,339,251,1013,761
9,412,352,274,1038,761
10,400,374,286,1060,761
11,379,413,280,1072,761
1,500,200,50,750,762
2,465,221,93,779,762
3,439,247,136,822,762
4,431,274,160,865,762
5,447,292,187,926,762
6,423,352,181,956,762
7,412,368,212,992,762
8,404,392,222,1018,762
9,405,358,246,1009,762
10,394,369,257,1020,762
11,425,398,266,1089,762
1,500,200,50,750,763
2,451,229,98,778,763
3,425,258,141,824,763
4,393,313,164,870,763
5,398,331,190,919,763
6,393,346,216,955,763
7,377,374,248,999,763
8,361,378,254,993,763
9,391,385,267,1043,763
10,392,385,278,1055,763
11,378,383,306,1067,763
1,500,200,50,750,764
2,462,243,93,798,764
3,431,259,135,825,764
4,402,301,167,870,764
5,405,306,199,910,764
6,410,325,222,957,764
7,387,378,204,969,764
8,392,390,230,1012,764
9,388,399,246,1033,764
10,371,403,265,1039,764
11,385,422,266,1073,764
1,500,200,50,750,765
2,460,225,99,784,765
3,450,241,136,827,765
4,425,285,158,868,765
5,414,303,193,910,765
6,416,313,207,936,765
7,412,334,226,972,765
8,397,370,237,1004,765
9,394,379,266,1039,765
10,416,392,249,1057,765
11,407,388,285,1080,765
1,500,200,50,750,766
2,447,232,103,782,766
3,443,254,126,823,766
4,444,304,127,875,766
5,412,332,153,897,766
6,415,339,204,958,766
7,409,341,220,970,766
8,413,331,250,994,766
9,406,341,255,1002,766
10,435,357,269,1061,766
11,429,364,288,1081,766
1,500,200,50,750,767
2,448,223,114,785,767
3,454,251,140,845,767
4,418,283,164,865,767
5,409,299,206,914,767
6,392,315,228,935,767
7,404,363,234,1001,767
8,397,360,253,1010,767
9,409,366,270,1045,767
10,398,367,290,1055,767
11,407,386,291,1084,767
1,500,200,50,750,768
2,459,225,101,785,768
3,428,260,142,830,768
4,410,281,182,873,768
5,412,320,185,917,768
6,399,335,207,941,768
7,390,365,239,994,768
8,382,377,254,1013,768
9,393,363,272,1028,768
10,422,373,268,1063,768
11,412,383,274,1069,768
1,500,200,50,750,769
2,462,248,84,794,769
3,444,262,123,829,769
4,415,299,159,873,769
5,381,335,195,911,769
6,379,362,216,957,769
7,377,353,244,974,769
8,407,364,248,1019,769
9,405,393,257,1055,769
10,398,405,267,1070,769
11,382,403,295,1080,769
1,500,200,50,750,770
2,476,230,89,795,770
3,447,262,122,831,770
4,434,291,150,875,770
5,416,317,187,920,770
6,413,327,217,957,770
7,398,339,235,972,770
8,381,355,269,1005,770
9,372,379,280,1031,770
10,371,395,280,1046,770
11,401,391,307,1099,770
1,500,200,50,750,771
2,463,236,88,787,771
3,456,262,128,846,771
4,439,287,147,873,771
5,438,302,191,931,771
6,403,323,220,946,771
7,371,351,242,964,771
8,384,381,238,1003,771
9,380,376,254,1010,771
10,382,396,265,1043,771
11,427,395,266,1088,771
1,500,200,50,750,772
2,450,234,103,787,772
3,405,276,146,827,772
4,392,308,161,861,772
5,391,331,187,909,772
6,406,347,210,963,772
7,402,344,238,984,772
8,384,403,236,1023,772
9,373,408,255,1036,772
10,385,396,267,1048,772
11,388,397,286,1071,772
1,500,200,50,750,773
2,478,234,84,796,773
3,442,253,139,834,773
4,428,274,172,874,773
5,421,312,199,932,773
6,416,342,205,963,773
7,423,342,224,989,773
8,407,367,236,1010,773
9,410,379,238,1027,773
10,420,389,248,1057,773
11,419,409,268,1096,773
1,500,200,50,750,774
2,471,216,112,799,774
3,428,244,150,822,774
4,416,294,156,866,774
5,417,312,194,923,774
6,402,329,220,951,774
7,408,336,234,978,774
8,416,343,256,1015,774
9,414,357,259,1030,774
10,401,378,264,1043,774
11,414,416,252,1082,774
1,500,200,50,750,775
2,450,233,103,786,775
3,429,273,140,842,775
4,432,275,173,880,775
5,403,299,207,909,775
6,393,352,222,967,775
7,388,360,215,963,775
8,393,374,234,1001,775
9,399,363,274,1036,775
10,401,399,263,1063,775
11,430,393,257,1080,775
1,500,200,50,750,776
2,428,243,115,786,776
3,413,263,149,825,776
4,430,264,176,870,776
5,421,310,189,920,776
6,422,334,196,952,776
7,409,339,227,975,776
8,420,365,236,1021,776
9,397,362,267,1026,776
10,398,370,281,1049,776
11,410,362,303,1075,776
1,500,200,50,750,777
2,475,222,89,786,777
3,433,238,142,813,777
4,434,292,156,882,777
5,419,314,169,902,777
6,423,329,202,954,777
7,386,380,213,979,777
8,375,388,240,1003,777
9,415,398,241,1054,777
10,389,407,255,1051,777
11,405,434,265,1104,777
1,500,200,50,750,778
2,455,222,117,794,778
3,421,265,132,818,778
4,430,273,165,868,778
5,413,312,189,914,778
6,430,319,223,972,778
7,421,328,240,989,778
8,390,349,250,989,778
9,411,388,244,1043,778
10,411,372,281,1064,778
11,407,386,288,1081,778
1,500,200,50,750,779
2,453,233,99,785,779
3,448,258,120,826,779
4,426,286,158,870,779
5,417,302,192,911,779
6,387,337,218,942,779
7,394,367,237,998,779
8,344,402,251,997,779
9,375,396,254,1025,779
10,392,399,266,1057,779
11,421,419,242,1082,779
1,500,200,50,750,780
2,457,244,88,789,780
3,432,249,143,824,780
4,414,285,184,883,780
5,406,308,209,923,780
6,388,342,228,958,780
7,396,330,262,988,780
8,386,341,272,999,780
9,400,359,268,1027,780
10,407,384,273,1064,780
11,409,400,282,1091,780
1,500,200,50,750,781
2,466,247,82,795,781
3,427,300,124,851,781
4,410,307,159,876,781
5,405,322,191,918,781
6,406,339,224,969,781
7,400,375,217,992,781
8,401,365,238,1004,781
9,398,378,260,1036,781
10,397,369,276,1042,781
11,400,381,295,1076,781
1,500,200,50,750,782
2,445,246,95,786,782
3,417,268,126,811,782
4,383,296,178,857,782
5,388,320,207,915,782
6,415,361,215,991,782
7,391,337,243,971,782
8,400,347,265,1012,782
9,394,361,278,1033,782
10,383,409,269,1061,782
11,372,437,270,1079,782
1,500,200,50,750,783
2,460,231,96,787,783
3,414,250,146,810,783
4,409,294,172,875,783
5,400,323,197,920,783
6,396,357,213,966,783
7,380,374,222,976,783
8,377,396,231,1004,783
9,397,393,244,1034,783
10,395,407,249,1051,783
11,422,396,279,1097,783
1,500,200,50,750,784
2,455,228,98,781,784
3,443,268,130,841,784
4,402,282,175,859,784
5,416,309,191,916,784
6,389,351,215,955,784
7,384,368,224,976,784
8,403,371,234,1008,784
9,398,367,255,1020,784
10,402,382,260,1044,784
11,389,415,276,1080,784
1,500,200,50,750,785
2,458,230,108,796,785
3,422,257,150,829,785
4,395,280,190,865,785
5,399,315,195,909,785
6,400,342,222,964,785
7,373,359,243,975,785
8,363,411,228,1002,785
9,364,409,263,1036,785
10,343,429,284,1056,785
11,361,422,301,1084,785
1,500,200,50,750,786
2,454,222,110,786,786
3,432,255,136,823,786
4,413,287,172,872,786
5,390,304,216,910,786
6,414,332,219,965,786
7,387,355,238,980,786
8,385,362,265,1012,786
9,406,366,261,1033,786
10,423,378,259,1060,786
11,417,410,243,1070,786
1,500,200,50,750,787
2,434,263,99,796,787
3,419,265,136,820,787
4,422,280,167,869,787
5,412,314,180,906,787
6,430,331,195,956,787
7,410,366,205,981,787
8,409,378,226,1013,787
9,414,377,247,1038,787
10,408,366,260,1034,787
11,399,379,287,1065,787
1,500,200,50,750,788
2,466,237,87,790,788
3,438,258,126,822,788
4,422,296,157,875,788
5,412,297,202,911,788
6,417,330,210,957,788
7,413,343,225,981,788
8,402,368,242,1012,788
9,398,383,246,1027,788
10,420,408,239,1067,788
11,395,420,263,1078,788
1,500,200,50,750,789
2,445,222,111,778,789
3,424,256,141,821,789
4,427,281,170,878,789
5,414,297,200,911,789
6,415,319,228,962,789
7,403,337,246,986,789
8,415,343,263,1021,789
9,378,359,291,1028,789
10,382,389,291,1062,789
11,401,407,293,1101,789
1,500,200,50,750,790
2,452,233,97,782,790
3,424,248,156,828,790
4,413,290,188,891,790
5,385,310,209,904,790
6,391,351,230,972,790
7,375,352,249,976,790
8,378,365,251,994,790
9,393,387,250,1030,790
10,362,411,289,1062,790
11,370,422,297,1089,790
1,500,200,50,750,791
2,470,219,94,783,791
3,428,283,130,841,791
4,395,321,150,866,791
5,392,347,171,910,791
6,395,357,217,969,791
7,379,364,237,980,791
8,388,368,254,1010,791
9,397,356,264,1017,791
10,397,362,292,1051,791
11,441,374,281,1096,791
1,500,200,50,750,792
2,448,246,94,788,792
3,429,268,145,842,792
4,417,285,174,876,792
5,409,319,198,926,792
6,396,337,216,949,792
7,387,363,232,982,792
8,393,380,235,1008,792
9,383,370,256,1009,792
10,392,382,268,1042,792
11,384,398,282,1064,792
1,500,200,50,750,793
2,443,233,115,791,793
3,412,255,150,817,793
4,413,288,160,861,793
5,429,334,169,932,793
6,401,336,216,953,793
7,393,357,234,984,793
8,376,366,248,990,793
9,393,396,254,1043,793
10,404,385,260,1049,793
11,403,401,277,1081,793
1,500,200,50,750,794
2,464,242,80,786,794
3,439,261,120,820,794
4,416,290,160,866,794
5,397,309,188,894,794
6,428,329,213,970,794
7,423,331,230,984,794
8,387,363,253,1003,794
9,407,362,248,1017,794
10,413,381,257,1051,794
11,426,383,279,1088,794
1,500,200,50,750,795
2,453,230,90,773,795
3,434,240,145,819,795
4,408,290,172,870,795
5,400,316,197,913,795
6,404,333,206,943,795
7,422,342,223,987,795
8,405,372,245,1022,795
9,392,362,268,1022,795
10,400,391,274,1065,795
11,379,427,274,1080,795
1,500,200,50,750,796
2,472,233,88,793,796
3,427,273,128,828,796
4,410,295,162,867,796
5,398,309,202,909,796
6,389,325,231,945,796
7,401,351,235,987,796
8,405,334,275,1014,796
9,416,353,279,1048,796
10,434,371,267,1072,796
11,430,375,279,1084,796
1,500,200,50,750,797
2,446,256,85,787,797
3,427,264,135,826,797
4,419,283,170,872,797
5,413,306,202,921,797
6,387,344,224,955,797
7,390,363,231,984,797
8,379,393,236,1008,797
9,378,393,271,1042,797
10,381,373,301,1055,797
11,390,396,300,1086,797
1,500,200,50,750,798
2,465,226,101,792,798
3,440,255,135,830,798
4,414,269,173,856,798
5,429,297,184,910,798
6,433,319,212,964,798
7,433,318,230,981,798
8,413,338,243,994,798
9,413,369,249,1031,798
10,424,370,271,1065,798
11,393,406,280,1079,798
1,500,200,50,750,799
2,473,215,94,782,799
3,453,241,128,822,799
4,447,267,169,883,799
5,434,305,179,918,799
6,432,334,198,964,799
7,420,356,217,993,799
8,408,366,227,1001,799
9,389,371,256,1016,799
10,410,382,255,1047,799
11,408,417,249,1074,799
1,500,200,50,750,800
2,457,233,100,790,800
3,418,274,126,818,800
4,428,286,157,871,800
5,408,318,177,903,800
6,407,360,188,955,800
7,395,358,214,967,800
8,403,344,247,994,800
9,397,371,249,1017,800
10,386,391,284,1061,800
11,380,403,293,1076,800
1,500,200,50,750,801
2,471,230,91,792,801
3,453,252,129,834,801
4,416,275,167,858,801
5,415,319,186,920,801
6,396,340,227,963,801
7,383,349,233,965,801
8,410,367,238,1015,801
9,409,379,253,1041,801
10,390,393,266,1049,801
11,415,398,284,1097,801
1,500,200,50,750,802
2,447,240,95,782,802
3,430,252,122,804,802
4,408,277,168,853,802
5,432,291,205,928,802
6,416,318,223,957,802
7,398,322,241,961,802
8,404,346,264,1014,802
9,392,352,284,1028,802
10,407,377,279,1063,802
11,397,400,271,1068,802
1,500,200,50,750,803
2,447,216,116,779,803
3,444,253,124,821,803
4,415,290,155,860,803
5,400,302,190,892,803
6,402,338,207,947,803
7,377,360,239,976,803
8,375,386,257,1018,803
9,373,399,263,1035,803
10,376,415,279,1070,803
11,381,422,282,1085,803
1,500,200,50,750,804
2,453,228,96,777,804
3,433,239,138,810,804
4,426,268,173,867,804
5,398,300,200,898,804
6,408,321,219,948,804
7,393,354,240,987,804
8,404,377,229,1010,804
9,397,393,242,1032,804
10,389,411,238,1038,804
11,398,394,260,1052,804
1,500,200,50,750,805
2,446,239,84,769,805
3,436,249,131,816,805
4,448,273,161,882,805
5,421,308,188,917,805
6,449,292,230,971,805
7,411,330,229,970,805
8,413,353,246,1012,805
9,409,371,251,1031,805
10,430,399,243,1072,805
11,424,406,258,1088,805
1,500,200,50,750,806
2,461,226,92,779,806
3,438,248,123,809,806
4,411,303,141,855,806
5,412,351,155,918,806
6,410,349,193,952,806
7,388,356,226,970,806
8,390,370,225,985,806
9,416,379,252,1047,806
10,388,385,278,1051,806
11,436,366,290,1092,806
1,500,200,50,750,807
2,463,232,98,793,807
3,438,250,139,827,807
4,425,282,157,864,807
5,413,314,174,901,807
6,405,359,196,960,807
7,372,372,225,969,807
8,402,372,248,1022,807
9,401,363,275,1039,807
10,402,379,287,1068,807
11,409,387,275,1071,807
1,500,200,50,750,808
2,444,239,106,789,808
3,421,258,150,829,808
4,404,280,193,877,808
5,410,308,202,920,808
6,387,339,229,955,808
7,362,350,248,960,808
8,389,355,251,995,808
9,413,363,255,1031,808
10,431,359,267,1057,808
11,415,382,279,1076,808
1,500,200,50,750,809
2,468,237,97,802,809
3,421,271,131,823,809
4,408,305,153,866,809
5,388,322,183,893,809
6,381,347,210,938,809
7,397,362,226,985,809
8,390,371,241,1002,809
9,407,366,259,1032,809
10,421,374,268,1063,809
11,386,394,284,1064,809
1,500,200,50,750,810
2,444,258,91,793,810
3,417,270,139,826,810
4,415,269,170,854,810
5,414,289,196,899,810
6,417,323,211,951,810
7,389,359,213,961,810
8,393,398,223,1014,810
9,351,412,254,1017,810
10,386,406,275,1067,810
11,381,411,284,1076,810
1,500,200,50,750,811
2,465,230,95,790,811
3,433,253,143,829,811
4,439,279,171,889,811
5,409,303,187,899,811
6,415,359,193,967,811
7,391,365,219,975,811
8,413,379,221,1013,811
9,415,387,240,1042,811
10,426,364,266,1056,811
11,419,381,271,1071,811
1,500,200,50,750,812
2,466,224,92,782,812
3,451,237,137,825,812
4,406,279,167,852,812
5,429,321,183,933,812
6,399,334,223,956,812
7,399,340,247,986,812
8,368,361,259,988,812
9,383,389,263,1035,812
10,377,394,279,1050,812
11,387,381,300,1068,812
1,500,200,50,750,813
2,446,239,97,782,813
3,432,274,120,826,813
4,418,300,153,871,813
5,399,326,176,901,813
6,406,359,187,952,813
7,392,362,218,972,813
8,405,383,211,999,813
9,397,393,250,1040,813
10,392,383,283,1058,813
11,409,376,299,1084,813
1,500,200,50,750,814
2,461,232,96,789,814
3,446,238,148,832,814
4,412,288,176,876,814
5,383,343,186,912,814
6,373,358,220,951,814
7,376,377,234,987,814
8,369,379,257,1005,814
9,394,387,280,1061,814
10,379,414,264,1057,814
11,373,422,277,1072,814
1,500,200,50,750,815
2,475,238,80,793,815
3,439,253,121,813,815
4,416,291,152,859,815
5,424,303,190,917,815
6,404,346,204,954,815
7,415,348,230,993,815
8,407,355,242,1004,815
9,418,353,265,1036,815
10,415,362,284,1061,815
11,403,389,282,1074,815
1,500,200,50,750,816
2,458,234,94,786,816
3,424,266,142,832,816
4,410,285,174,869,816
5,414,298,206,918,816
6,399,326,226,951,816
7,400,344,247,991,816
8,402,361,245,1008,816
9,420,381,237,1038,816
10,407,391,250,1048,816
11,433,410,267,1110,816
1,500,200,50,750,817
2,480,221,79,780,817
3,464,245,115,824,817
4,439,276,154,869,817
5,421,311,184,916,817
6,398,339,220,957,817
7,392,373,223,988,817
8,399,390,224,1013,817
9,400,397,244,1041,817
10,388,416,258,1062,817
11,397,411,263,1071,817
1,500,200,50,750,818
2,467,232,90,789,818
3,431,262,134,827,818
4,423,260,169,852,818
5,400,312,196,908,818
6,400,332,231,963,818
7,403,349,249,1001,818
8,385,369,245,999,818
9,372,390,285,1047,818
10,396,388,277,1061,818
11,405,398,275,1078,818
1,500,200,50,750,819
2,464,228,105,797,819
3,446,250,126,822,819
4,424,283,153,860,819
5,399,340,163,902,819
6,399,367,188,954,819
7,388,375,205,968,819
8,393,372,247,1012,819
9,395,364,269,1028,819
10,409,381,274,1064,819
11,408,396,296,1100,819
1,500,200,50,750,820
2,468,232,97,797,820
3,434,259,136,829,820
4,393,309,169,871,820
5,382,342,202,926,820
6,389,348,234,971,820
7,374,369,243,986,820
8,391,366,259,1016,820
9,381,380,263,1024,820
10,372,402,275,1049,820
11,385,421,278,1084,820
1,500,200,50,750,821
2,451,233,102,786,821
3,431,266,139,836,821
4,399,293,174,866,821
5,394,311,224,929,821
6,389,352,220,961,821
7,376,374,222,972,821
8,385,374,237,996,821
9,407,389,248,1044,821
10,410,402,253,1065,821
11,434,407,243,1084,821
1,500,200,50,750,822
2,450,241,105,796,822
3,417,269,132,818,822
4,409,276,165,850,822
5,388,311,179,878,822
6,428,334,206,968,822
7,386,365,225,976,822
8,373,378,247,998,822
9,368,398,254,1020,822
10,388,415,260,1063,822
11,384,448,246,1078,822
1,500,200,50,750,823
2,447,230,102,779,823
3,446,255,137,838,823
4,431,278,157,866,823
5,412,317,176,905,823
6,413,360,189,962,823
7,395,363,227,985,823
8,367,411,235,1013,823
9,377,389,260,1026,823
10,394,384,269,1047,823
11,403,422,259,1084,823
1,500,200,50,750,824
2,463,229,98,790,824
3,428,284,137,849,824
4,383,308,171,862,824
5,359,338,206,903,824
6,388,338,233,959,824
7,375,346,256,977,824
8,395,344,273,1012,824
9,387,366,278,1031,824
10,382,401,279,1062,824
11,393,406,287,1086,824
1,500,200,50,750,825
2,477,225,90,792,825
3,442,259,126,827,825
4,430,294,152,876,825
5,406,344,174,924,825
6,392,363,206,961,825
7,391,382,226,999,825
8,370,390,236,996,825
9,378,376,264,1018,825
10,415,389,243,1047,825
11,417,414,266,1097,825
1,500,200,50,750,826
2,442,247,110,799,826
3,418,261,131,810,826
4,412,299,160,871,826
5,398,322,198,918,826
6,390,349,202,941,826
7,389,361,235,985,826
8,385,374,247,1006,826
9,363,384,275,1022,826
10,376,413,278,1067,826
11,372,429,283,1084,826
1,500,200,50,750,827
2,453,225,101,779,827
3,432,266,131,829,827
4,415,286,172,873,827
5,404,296,213,913,827
6,404,336,217,957,827
7,408,350,233,991,827
8,386,372,247,1005,827
9,379,368,278,1025,827
10,379,378,290,1047,827
11,409,402,286,1097,827
1,500,200,50,750,828
2,462,227,96,785,828
3,429,263,138,830,828
4,423,299,155,877,828
5,403,323,190,916,828
6,407,338,201,946,828
7,381,388,221,990,828
8,372,406,234,1012,828
9,371,413,244,1028,828
10,351,444,239,1034,828
11,388,442,257,1087,828
1,500,200,50,750,829
2,474,222,95,791,829
3,429,265,119,813,829
4,422,282,156,860,829
5,413,323,190,926,829
6,406,330,235,971,829
7,391,351,243,985,829
8,376,361,257,994,829
9,377,399,257,1033,829
10,382,411,270,1063,829
11,382,398,298,1078,829
1,500,200,50,750,830
2,438,229,117,784,830
3,403,262,165,830,830
4,408,276,198,882,830
5,400,302,210,912,830
6,412,325,221,958,830
7,425,335,225,985,830
8,426,346,224,996,830
9,426,365,248,1039,830
10,412,382,263,1057,830
11,409,382,276,1067,830
1,500,200,50,750,831
2,451,239,94,784,831
3,417,265,142,824,831
4,397,278,187,862,831
5,395,287,205,887,831
6,426,327,223,976,831
7,389,346,253,988,831
8,389,355,257,1001,831
9,403,377,264,1044,831
10,371,404,280,1055,831
11,378,433,295,1106,831
1,500,200,50,750,832
2,445,232,102,779,832
3,431,267,140,838,832
4,409,286,171,866,832
5,390,335,192,917,832
6,421,329,213,963,832
7,392,352,237,981,832
8,402,345,279,1026,832
9,394,352,274,1020,832
10,375,407,272,1054,832
11,388,400,286,1074,832
1,500,200,50,750,833
2,448,260,89,797,833
3,421,278,121,820,833
4,407,303,158,868,833
5,393,313,195,901,833
6,395,340,216,951,833
7,386,369,218,973,833
8,392,380,229,1001,833
9,407,385,229,1021,833
10,430,394,242,1066,833
11,453,365,259,1077,833
1,500,200,50,750,834
2,467,220,98,785,834
3,454,262,120,836,834
4,401,298,155,854,834
5,402,313,190,905,834
6,389,340,218,947,834
7,383,361,232,976,834
8,376,394,242,1012,834
9,383,409,251,1043,834
10,385,423,258,1066,834
11,394,430,262,1086,834
1,500,200,50,750,835
2,444,239,100,783,835
3,435,257,142,834,835
4,414,283,173,870,835
5,405,302,203,910,835
6,422,335,209,966,835
7,402,365,219,986,835
8,402,372,234,1008,835
9,406,383,246,1035,835
10,386,413,249,1048,835
11,398,417,278,1093,835
1,500,200,50,750,836
2,472,230,93,795,836
3,435,263,128,826,836
4,435,292,152,879,836
5,427,333,159,919,836
6,401,360,192,953,836
7,408,383,205,996,836
8,405,366,233,1004,836
9,384,387,252,1023,836
10,402,404,272,1078,836
11,406,404,283,1093,836
1,500,200,50,750,837
2,472,229,93,794,837
3,425,280,114,819,837
4,432,299,144,875,837
5,410,334,171,915,837
6,403,342,203,948,837
7,392,367,223,982,837
8,380,365,257,1002,837
9,388,385,258,1031,837
10,396,401,260,1057,837
11,414,417,264,1095,837
1,500,200,50,750,838
2,449,235,103,787,838
3,429,266,135,830,838
4,414,291,170,875,838
5,404,309,199,912,838
6,425,338,197,960,838
7,398,359,220,977,838
8,402,371,233,1006,838
9,404,373,250,1027,838
10,403,392,270,1065,838
11,392,411,283,1086,838
1,500,200,50,750,839
2,439,230,111,780,839
3,408,263,146,817,839
4,413,288,168,869,839
5,407,307,176,890,839
6,449,315,221,985,839
7,423,327,237,987,839
8,394,341,264,999,839
9,390,372,270,1032,839
10,381,386,282,1049,839
11,412,409,285,1106,839
1,500,200,50,750,840
2,448,238,97,783,840
3,425,275,134,834,840
4,396,291,167,854,840
5,378,323,207,908,840
6,377,333,223,933,840
7,407,349,234,990,840
8,382,369,257,1008,840
9,413,373,261,1047,840
10,402,400,251,1053,840
11,416,412,259,1087,840
1,500,200,50,750,841
2,456,234,104,794,841
3,421,270,142,833,841
4,418,296,164,878,841
5,421,317,182,920,841
6,410,343,196,949,841
7,417,349,219,985,841
8,411,371,232,1014,841
9,400,381,265,1046,841
10,384,416,253,1053,841
11,383,418,277,1078,841
1,500,200,50,750,842
2,466,203,115,784,842
3,457,217,156,830,842
4,445,264,160,869,842
5,427,282,194,903,842
6,443,332,210,985,842
7,397,352,233,982,842
8,399,352,241,992,842
9,398,375,231,1004,842
10,412,398,250,1060,842
11,404,414,246,1064,842
1,500,200,50,750,843
2,454,235,99,788,843
3,433,280,113,826,843
4,435,298,145,878,843
5,415,313,185,913,843
6,434,357,197,988,843
7,390,362,225,977,843
8,394,374,242,1010,843
9,388,385,271,1044,843
10,381,396,279,1056,843
11,387,408,291,1086,843
1,500,200,50,750,844
2,468,235,97,800,844
3,438,254,140,832,844
4,417,274,182,873,844
5,434,292,194,920,844
6,429,322,207,958,844
7,415,355,222,992,844
8,407,370,232,1009,844
9,421,384,237,1042,844
10,412,398,250,1060,844
11,415,419,255,1089,844
1,500,200,50,750,845
2,464,227,91,782,845
3,450,268,119,837,845
4,419,312,141,872,845
5,389,332,183,904,845
6,411,350,204,965,845
7,418,368,212,998,845
8,388,376,233,997,845
9,412,401,226,1039,845
10,410,404,234,1048,845
11,411,411,258,1080,845
1,500,200,50,750,846
2,459,230,98,787,846
3,414,255,148,817,846
4,404,288,184,876,846
5,399,313,210,922,846
6,392,352,217,961,846
7,391,380,218,989,846
8,382,390,240,1012,846
9,369,411,254,1034,846
10,376,420,277,1073,846
11,376,428,293,1097,846
1,500,200,50,750,847
2,456,232,97,785,847
3,448,251,134,833,847
4,429,270,171,870,847
5,420,281,216,917,847
6,421,315,215,951,847
7,411,330,236,977,847
8,401,345,256,1002,847
9,417,343,273,1033,847
10,399,368,277,1044,847
11,399,371,294,1064,847
1,500,200,50,750,848
2,450,238,94,782,848
3,415,274,132,821,848
4,400,279,182,861,848
5,404,310,194,908,848
6,402,318,217,937,848
7,405,361,230,996,848
8,382,383,238,1003,848
9,377,383,267,1027,848
10,385,398,280,1063,848
11,396,421,275,1092,848
1,500,200,50,750,849
2,457,219,109,785,849
3,431,249,145,825,849
4,414,280,179,873,849
5,380,322,205,907,849
6,388,328,233,949,849
7,397,350,251,998,849
8,392,368,243,1003,849
9,388,381,270,1039,849
10,382,408,276,1066,849
11,413,419,253,1085,849
1,500,200,50,750,850
2,457,232,99,788,850
3,418,267,131,816,850
4,417,303,144,864,850
5,416,306,179,901,850
6,422,350,187,959,850
7,426,368,212,1006,850
8,394,369,237,1000,850
9,410,373,258,1041,850
10,409,385,265,1059,850
11,388,388,291,1067,850
1,500,200,50,750,851
2,460,234,103,797,851
3,418,254,157,829,851
4,410,294,168,872,851
5,392,344,173,909,851
6,395,364,208,967,851
7,382,375,222,979,851
8,394,383,229,1006,851
9,406,387,233,1026,851
10,414,382,258,1054,851
11,419,419,248,1086,851
1,500,200,50,750,852
2,439,230,93,762,852
3,415,275,148,838,852
4,395,288,185,868,852
5,400,308,195,903,852
6,380,345,211,936,852
7,402,356,207,965,852
8,420,337,248,1005,852
9,424,370,246,1040,852
10,379,383,259,1021,852
11,413,411,278,1102,852
1,500,200,50,750,853
2,474,215,101,790,853
3,447,247,136,830,853
4,416,260,183,859,853
5,406,324,188,918,853
6,410,359,198,967,853
7,399,353,237,989,853
8,399,344,252,995,853
9,405,349,274,1028,853
10,406,388,272,1066,853
11,417,428,255,1100,853
1,500,200,50,750,854
2,450,229,98,777,854
3,418,273,129,820,854
4,414,294,171,879,854
5,390,324,195,909,854
6,407,321,218,946,854
7,399,349,232,980,854
8,390,375,243,1008,854
9,375,410,242,1027,854
10,388,408,266,1062,854
11,365,416,288,1069,854
1,500,200,50,750,855
2,451,229,108,788,855
3,418,250,152,820,855
4,421,268,185,874,855
5,410,303,203,916,855
6,405,336,215,956,855
7,413,327,243,983,855
8,377,359,249,985,855
9,401,379,259,1039,855
10,392,385,277,1054,855
11,376,402,294,1072,855
1,500,200,50,750,856
2,456,243,103,802,856
3,403,265,152,820,856
4,387,280,191,858,856
5,363,306,223,892,856
6,380,334,237,951,856
7,363,350,250,963,856
8,400,372,256,1028,856
9,365,388,271,1024,856
10,382,423,270,1075,856
11,376,432,272,1080,856
1,500,200,50,750,857
2,455,232,96,783,857
3,434,256,126,816,857
4,435,280,155,870,857
5,406,279,215,900,857
6,410,333,226,969,857
7,390,338,243,971,857
8,395,361,267,1023,857
9,389,382,258,1029,857
10,412,377,272,1061,857
11,418,375,289,1082,857
1,500,200,50,750,858
2,447,228,103,778,858
3,413,275,136,824,858
4,416,331,143,890,858
5,386,343,171,900,858
6,393,355,199,947,858
7,384,358,246,988,858
8,393,381,240,1014,858
9,380,393,264,1037,858
10,376,412,277,1065,858
11,366,427,285,1078,858
1,500,200,50,750,859
2,461,223,110,794,859
3,429,284,121,834,859
4,413,308,155,876,859
5,420,303,191,914,859
6,410,334,215,959,859
7,405,346,228,979,859
8,403,353,250,1006,859
9,404,374,255,1033,859
10,408,368,266,1042,859
11,426,396,261,1083,859
1,500,200,50,750,860
2,454,232,111,797,860
3,423,269,145,837,860
4,414,306,155,875,860
5,390,330,183,903,860
6,391,373,188,952,860
7,404,366,217,987,860
8,397,370,235,1002,860
9,397,394,242,1033,860
10,402,416,246,1064,860
11,406,427,258,1091,860
1,500,200,50,750,861
2,444,250,90,784,861
3,421,271,130,822,861
4,427,289,153,869,861
5,423,324,171,918,861
6,401,338,222,961,861
7,383,370,226,979,861
8,390,386,250,1026,861
9,365,399,259,1023,861
10,397,388,286,1071,861
11,400,406,278,1084,861
1,500,200,50,750,862
2,445,244,92,781,862
3,421,284,130,835,862
4,403,294,179,876,862
5,403,319,194,916,862
6,403,334,213,950,862
7,403,362,236,1001,862
8,369,377,253,999,862
9,357,393,261,1011,862
10,353,415,285,1053,862
11,363,418,301,1082,862
1,500,200,50,750,863
2,468,224,97,789,863
3,435,257,130,822,863
4,432,271,170,873,863
5,419,314,193,926,863
6,400,332,221,953,863
7,374,382,215,971,863
8,408,383,239,1030,863
9,380,396,261,1037,863
10,357,398,288,1043,863
11,374,397,316,1087,863
1,500,200,50,750,864
2,462,245,91,798,864
3,432,260,138,830,864
4,407,297,169,873,864
5,411,297,204,912,864
6,417,326,212,955,864
7,396,347,237,980,864
8,400,368,242,1010,864
9,399,382,257,1038,864
10,385,384,279,1048,864
11,388,441,265,1094,864
1,500,200,50,750,865
2,449,236,103,788,865
3,427,262,146,835,865
4,408,273,178,859,865
5,416,313,189,918,865
6,397,324,230,951,865
7,387,344,232,963,865
8,368,376,257,1001,865
9,362,380,269,1011,865
10,383,409,271,1063,865
11,387,438,255,1080,865
1,500,200,50,750,866
2,457,223,105,785,866
3,435,262,143,840,866
4,422,281,164,867,866
5,429,323,188,940,866
6,397,350,201,948,866
7,426,346,222,994,866
8,396,355,234,985,866
9,422,386,238,1046,866
10,408,386,268,1062,866
11,410,411,278,1099,866
1,500,200,50,750,867
2,473,219,97,789,867
3,430,282,121,833,867
4,405,290,153,848,867
5,415,322,177,914,867
6,415,355,195,965,867
7,403,356,222,981,867
8,400,382,226,1008,867
9,374,397,263,1034,867
10,388,408,267,1063,867
11,397,414,266,1077,867
1,500,200,50,750,868
2,447,243,94,784,868
3,394,281,154,829,868
4,392,310,180,882,868
5,395,318,211,924,868
6,383,335,238,956,868
7,358,369,239,966,868
8,384,368,257,1009,868
9,399,390,263,1052,868
10,400,393,271,1064,868
11,418,402,274,1094,868
1,500,200,50,750,869
2,468,219,103,790,869
3,421,264,144,829,869
4,389,295,175,859,869
5,415,317,189,921,869
6,421,331,216,968,869
7,398,337,252,987,869
8,371,382,259,1012,869
9,376,411,238,1025,869
10,386,402,272,1060,869
11,390,418,258,1066,869
1,500,200,50,750,870
2,459,244,106,809,870
3,417,277,143,837,870
4,401,292,174,867,870
5,396,322,208,926,870
6,386,339,224,949,870
7,375,355,245,975,870
8,376,383,247,1006,870
9,378,408,246,1032,870
10,390,392,279,1061,870
11,392,391,281,1064,870
1,500,200,50,750,871
2,465,239,98,802,871
3,420,272,132,824,871
4,405,305,166,876,871
5,410,318,186,914,871
6,397,320,223,940,871
7,430,346,227,1003,871
8,412,351,241,1004,871
9,434,362,243,1039,871
10,432,370,238,1040,871
11,466,377,249,1092,871
1,500,200,50,750,872
2,465,219,99,783,872
3,438,255,139,832,872
4,412,281,168,861,872
5,416,312,177,905,872
6,412,337,211,960,872
7,410,365,229,1004,872
8,370,382,250,1002,872
9,368,405,251,1024,872
10,382,401,269,1052,872
11,403,420,265,1088,872
1,500,200,50,750,873
2,451,236,100,787,873
3,420,256,140,816,873
4,419,266,176,861,873
5,401,294,192,887,873
6,421,336,210,967,873
7,414,343,231,988,873
8,379,399,233,1011,873
9,381,376,261,1018,873
10,419,395,241,1055,873
11,423,418,253,1094,873
1,500,200,50,750,874
2,440,247,98,785,874
3,413,270,133,816,874
4,410,289,181,880,874
5,394,322,195,911,874
6,378,330,222,930,874
7,386,351,230,967,874
8,386,349,254,989,874
9,406,380,258,1044,874
10,376,413,268,1057,874
11,403,417,282,1102,874
1,500,200,50,750,875
2,464,225,97,786,875
3,443,255,133,831,875
4,426,289,171,886,875
5,422,294,196,912,875
6,391,336,214,941,875
7,411,352,229,992,875
8,402,352,263,1017,875
9,399,379,250,1028,875
10,401,376,271,1048,875
11,439,379,267,1085,875
1,500,200,50,750,876
2,466,220,105,791,876
3,442,232,154,828,876
4,400,282,178,860,876
5,407,293,206,906,876
6,430,315,231,976,876
7,410,334,244,988,876
8,416,348,242,1006,876
9,419,374,248,1041,876
10,404,395,262,1061,876
11,409,405,271,1085,876
1,500,200,50,750,877
2,468,243,89,800,877
3,437,267,119,823,877
4,422,283,171,876,877
5,402,309,206,917,877
6,416,310,231,957,877
7,394,344,233,971,877
8,393,362,248,1003,877
9,403,372,253,1028,877
10,429,383,256,1068,877
11,415,396,254,1065,877
1,500,200,50,750,878
2,461,205,102,768,878
3,446,256,138,840,878
4,414,286,156,856,878
5,406,333,167,906,878
6,404,335,209,948,878
7,410,358,230,998,878
8,382,387,236,1005,878
9,393,357,279,1029,878
10,406,373,276,1055,878
11,403,392,287,1082,878
1,500,200,50,750,879
2,447,230,100,777,879
3,431,264,134,829,879
4,386,298,174,858,879
5,376,315,194,885,879
6,392,369,210,971,879
7,367,399,214,980,879
8,376,404,236,1016,879
9,381,416,245,1042,879
10,383,401,256,1040,879
11,402,405,268,1075,879
1,500,200,50,750,880
2,468,232,102,802,880
3,441,260,125,826,880
4,409,285,158,852,880
5,418,325,182,925,880
6,399,343,207,949,880
7,402,339,248,989,880
8,394,350,248,992,880
9,432,355,267,1054,880
10,389,404,270,1063,880
11,381,397,295,1073,880
1,500,200,50,750,881
2,459,221,86,766,881
3,432,266,134,832,881
4,403,295,163,861,881
5,414,319,193,926,881
6,391,333,227,951,881
7,422,344,235,1001,881
8,415,349,249,1013,881
9,404,392,240,1036,881
10,398,434,243,1075,881
11,392,413,268,1073,881
1,500,200,50,750,882
2,462,234,94,790,882
3,435,276,115,826,882
4,416,286,158,860,882
5,416,308,191,915,882
6,402,342,219,963,882
7,398,369,218,985,882
8,407,364,238,1009,882
9,397,353,269,1019,882
10,424,374,257,1055,882
11,405,411,263,1079,882
1,500,200,50,750,883
2,459,230,109,798,883
3,435,252,138,825,883
4,412,282,178,872,883
5,413,296,198,907,883
6,396,358,204,958,883
7,388,360,229,977,883
8,372,375,248,995,883
9,388,362,271,1021,883
10,387,410,273,1070,883
11,382,430,247,1059,883
1,500,200,50,750,884
2,477,228,95,800,884
3,434,273,128,835,884
4,410,297,167,874,884
5,382,324,184,890,884
6,406,369,206,981,884
7,382,396,205,983,884
8,384,385,240,1009,884
9,391,365,278,1034,884
10,403,395,270,1068,884
11,386,408,280,1074,884
1,500,200,50,750,885
2,458,230,101,789,885
3,444,258,121,823,885
4,431,286,153,870,885
5,433,304,185,922,885
6,417,345,198,960,885
7,409,348,224,981,885
8,390,357,247,994,885
9,420,369,243,1032,885
10,385,410,262,1057,885
11,417,426,272,1115,885
1,500,200,50,750,886
2,458,224,103,785,886
3,452,251,124,827,886
4,423,279,174,876,886
5,406,333,172,911,886
6,404,327,209,940,886
7,397,342,230,969,886
8,395,375,233,1003,886
9,393,387,254,1034,886
10,393,374,291,1058,886
11,415,379,283,1077,886
1,500,200,50,750,887
2,467,229,98,794,887
3,422,270,127,819,887
4,414,303,169,886,887
5,376,312,213,901,887
6,409,319,240,968,887
7,392,339,248,979,887
8,409,347,252,1008,887
9,395,354,277,1026,887
10,404,372,280,1056,887
11,407,412,281,1100,887
1,500,200,50,750,888
2,453,224,103,780,888
3,423,259,147,829,888
4,412,286,167,865,888
5,395,337,194,926,888
6,402,334,221,957,888
7,392,358,230,980,888
8,360,402,236,998,888
9,379,403,250,1032,888
10,392,402,254,1048,888
11,380,431,269,1080,888
1,500,200,50,750,889
2,469,228,92,789,889
3,426,276,132,834,889
4,403,290,176,869,889
5,391,326,200,917,889
6,387,347,225,959,889
7,375,355,242,972,889
8,360,363,250,973,889
9,390,391,247,1028,889
10,400,385,264,1049,889
11,405,422,267,1094,889
1,500,200,50,750,890
2,441,258,86,785,890
3,416,274,135,825,890
4,407,296,165,868,890
5,409,301,180,890,890
6,420,347,196,963,890
7,410,352,221,983,890
8,397,371,239,1007,890
9,397,369,236,1002,890
10,406,392,235,1033,890
11,442,404,256,1102,890
1,500,200,50,750,891
2,459,213,117,789,891
3,439,249,133,821,891
4,424,276,157,857,891
5,412,320,168,900,891
6,427,334,205,966,891
7,411,347,222,980,891
8,399,346,251,996,891
9,397,355,285,1037,891
10,390,360,301,1051,891
11,390,395,285,1070,891
1,500,200,50,750,892
2,457,226,103,786,892
3,418,261,131,810,892
4,412,310,157,879,892
5,390,333,190,913,892
6,391,352,210,953,892
7,395,361,228,984,892
8,404,369,251,1024,892
9,372,385,258,1015,892
10,399,389,274,1062,892
11,398,409,296,1103,892
1,500,200,50,750,893
2,461,230,105,796,893
3,425,277,137,839,893
4,403,300,174,877,893
5,402,312,199,913,893
6,405,326,224,955,893
7,390,354,219,963,893
8,392,365,237,994,893
9,400,385,253,1038,893
10,385,407,251,1043,893
11,383,409,275,1067,893
1,500,200,50,750,894
2,463,237,97,797,894
3,434,268,131,833,894
4,416,288,173,877,894
5,403,304,202,909,894
6,400,314,227,941,894
7,418,325,245,988,894
8,402,349,252,1003,894
9,392,388,253,1033,894
10,377,404,280,1061,894
11,399,431,269,1099,894
1,500,200,50,750,895
2,460,219,113,792,895
3,432,251,149,832,895
4,401,273,193,867,895
5,402,294,215,911,895
6,400,335,227,962,895
7,399,343,250,992,895
8,382,357,257,996,895
9,385,373,264,1022,895
10,390,415,266,1071,895
11,400,438,258,1096,895
1,500,200,50,750,896
2,452,238,94,784,896
3,411,295,128,834,896
4,396,306,170,872,896
5,390,332,190,912,896
6,392,362,200,954,896
7,390,370,207,967,896
8,361,378,233,972,896
9,394,405,254,1053,896
10,359,417,267,1043,896
11,380,400,293,1073,896
1,500,200,50,750,897
2,443,239,92,774,897
3,457,232,146,835,897
4,440,266,159,865,897
5,451,290,185,926,897
6,426,320,203,949,897
7,428,347,216,991,897
8,421,345,254,1020,897
9,394,368,272,1034,897
10,401,398,270,1069,897
11,393,408,286,1087,897
1,500,200,50,750,898
2,457,211,119,787,898
3,415,248,161,824,898
4,412,261,188,861,898
5,419,284,210,913,898
6,427,316,212,955,898
7,410,340,221,971,898
8,412,376,231,1019,898
9,439,369,230,1038,898
10,420,384,242,1046,898
11,418,397,268,1083,898
1,500,200,50,750,899
2,457,230,98,785,899
3,429,266,135,830,899
4,411,296,166,873,899
5,401,330,187,918,899
6,403,339,222,964,899
7,389,344,243,976,899
8,393,361,250,1004,899
9,385,405,256,1046,899
10,379,410,268,1057,899
11,395,418,269,1082,899
1,500,200,50,750,900
2,448,241,90,779,900
3,457,258,125,840,900
4,426,281,157,864,900
5,421,317,176,914,900
6,423,322,203,948,900
7,413,363,205,981,900
8,386,380,214,980,900
9,406,382,230,1018,900
10,437,384,254,1075,900
11,427,394,269,1090,900
1,500,200,50,750,901
2,480,222,94,796,901
3,434,251,137,822,901
4,413,278,184,875,901
5,395,324,193,912,901
6,402,338,224,964,901
7,366,361,234,961,901
8,413,367,259,1039,901
9,393,351,280,1024,901
10,401,369,289,1059,901
11,426,412,292,1130,901
1,500,200,50,750,902
2,461,222,97,780,902
3,437,245,138,820,902
4,403,281,169,853,902
5,393,314,188,895,902
6,396,354,206,956,902
7,368,394,220,982,902
8,342,427,221,990,902
9,365,434,234,1033,902
10,361,425,252,1038,902
11,393,435,258,1086,902
1,500,200,50,750,903
2,454,254,83,791,903
3,421,280,116,817,903
4,386,310,162,858,903
5,414,337,181,932,903
6,392,353,210,955,903
7,399,367,209,975,903
8,391,385,236,1012,903
9,399,384,254,1037,903
10,386,388,271,1045,903
11,399,416,278,1093,903
1,500,200,50,750,904
2,440,237,110,787,904
3,430,264,143,837,904
4,406,294,171,871,904
5,417,302,196,915,904
6,427,336,213,976,904
7,402,358,227,987,904
8,395,368,248,1011,904
9,403,349,282,1034,904
10,392,370,283,1045,904
11,380,383,298,1061,904
1,500,200,50,750,905
2,451,235,99,785,905
3,436,264,129,829,905
4,433,278,166,877,905
5,412,292,201,905,905
6,396,344,222,962,905
7,401,351,234,986,905
8,401,369,239,1009,905
9,399,361,272,1032,905
10,428,372,267,1067,905
11,414,392,275,1081,905
1,500,200,50,750,906
2,437,246,91,774,906
3,416,265,133,814,906
4,415,286,170,871,906
5,417,301,206,924,906
6,414,329,232,975,906
7,396,343,247,986,906
8,406,351,256,1013,906
9,382,350,282,1014,906
10,403,374,277,1054,906
11,407,378,293,1078,906
1,500,200,50,750,907
2,466,234,103,803,907
3,426,245,145,816,907
4,406,275,174,855,907
5,401,290,204,895,907
6,430,320,212,962,907
7,409,358,222,989,907
8,395,393,223,1011,907
9,391,403,250,1044,907
10,395,388,280,1063,907
11,387,398,291,1076,907
1,500,200,50,750,908
2,460,215,112,787,908
3,436,244,145,825,908
4,441,293,148,882,908
5,418,308,181,907,908
6,407,333,181,921,908
7,405,348,213,966,908
8,416,358,226,1000,908
9,405,369,258,1032,908
10,431,353,271,1055,908
11,417,385,270,1072,908
1,500,200,50,750,909
2,453,237,99,789,909
3,413,263,144,820,909
4,415,295,165,875,909
5,401,309,202,912,909
6,413,341,199,953,909
7,388,358,238,984,909
8,384,374,247,1005,909
9,384,378,261,1023,909
10,394,402,267,1063,909
11,403,412,263,1078,909
1,500,200,50,750,910
2,451,231,91,773,910
3,425,259,129,813,910
4,406,303,164,873,910
5,400,347,177,924,910
6,391,353,209,953,910
7,374,366,238,978,910
8,367,371,264,1002,910
9,375,379,277,1031,910
10,375,386,279,1040,910
11,404,423,275,1102,910
1,500,200,50,750,911
2,455,237,95,787,911
3,423,252,141,816,911
4,415,291,162,868,911
5,404,308,185,897,911
6,403,346,205,954,911
7,391,362,225,978,911
8,380,371,256,1007,911
9,392,356,271,1019,911
10,383,389,273,1045,911
11,392,420,268,1080,911
1,500,200,50,750,912
2,476,211,107,794,912
3,453,256,125,834,912
4,425,285,149,859,912
5,422,314,184,920,912
6,407,354,206,967,912
7,398,354,228,980,912
8,395,358,242,995,912
9,412,351,271,1034,912
10,401,370,283,1054,912
11,385,404,284,1073,912
1,500,200,50,750,913
2,450,258,84,792,913
3,430,271,128,829,913
4,417,278,185,880,913
5,397,305,205,907,913
6,403,336,217,956,913
7,394,355,235,984,913
8,388,380,248,1016,913
9,369,396,269,1034,913
10,393,409,275,1077,913
11,397,408,278,1083,913
1,500,200,50,750,914
2,459,229,107,795,914
3,436,257,135,828,914
4,411,300,168,879,914
5,418,337,152,907,914
6,402,333,201,936,914
7,443,341,200,984,914
8,440,375,212,1027,914
9,399,403,227,1029,914
10,421,413,247,1081,914
11,407,418,261,1086,914
1,500,200,50,750,915
2,466,220,110,796,915
3,443,244,135,822,915
4,429,281,162,872,915
5,420,330,178,928,915
6,406,334,212,952,915
7,387,355,233,975,915
8,394,376,245,1015,915
9,388,387,270,1045,915
10,400,398,256,1054,915
11,395,400,278,1073,915
1,500,200,50,750,916
2,452,239,102,793,916
3,448,255,134,837,916
4,424,276,164,864,916
5,419,301,184,904,916
6,427,321,214,962,916
7,394,360,220,974,916
8,412,366,233,1011,916
9,414,395,239,1048,916
10,400,401,259,1060,916
11,375,439,261,1075,916
1,500,200,50,750,917
2,454,231,108,793,917
3,414,268,146,828,917
4,396,285,179,860,917
5,399,320,191,910,917
6,412,343,214,969,917
7,400,362,237,999,917
8,403,360,252,1015,917
9,393,351,275,1019,917
10,395,383,288,1066,917
11,394,392,294,1080,917
1,500,200,50,750,918
2,472,232,105,809,918
3,435,249,144,828,918
4,420,264,166,850,918
5,401,315,182,898,918
6,406,346,220,972,918
7,372,355,247,974,918
8,402,369,258,1029,918
9,361,389,281,1031,918
10,391,395,280,1066,918
11,385,414,281,1080,918
1,500,200,50,750,919
2,466,241,97,804,919
3,418,282,134,834,919
4,398,299,176,873,919
5,380,307,209,896,919
6,377,342,237,956,919
7,381,344,258,983,919
8,380,354,269,1003,919
9,373,339,298,1010,919
10,388,370,292,1050,919
11,403,387,297,1087,919
1,500,200,50,750,920
2,461,236,96,793,920
3,417,264,139,820,920
4,418,282,172,872,920
5,391,309,203,903,920
6,415,320,244,979,920
7,395,362,240,997,920
8,380,375,255,1010,920
9,401,383,249,1033,920
10,394,406,256,1056,920
11,401,400,291,1092,920
1,500,200,50,750,921
2,456,225,106,787,921
3,429,255,137,821,921
4,425,298,160,883,921
5,397,317,190,904,921
6,374,346,217,937,921
7,353,372,236,961,921
8,369,380,253,1002,921
9,394,381,268,1043,921
10,379,378,275,1032,921
11,411,411,281,1103,921
1,500,200,50,750,922
2,452,231,108,791,922
3,419,267,140,826,922
4,415,281,174,870,922
5,419,300,209,928,922
6,399,307,234,940,922
7,416,328,228,972,922
8,424,354,245,1023,922
9,395,361,266,1022,922
10,400,388,270,1058,922
11,406,415,261,1082,922
1,500,200,50,750,923
2,456,234,93,783,923
3,426,264,134,824,923
4,416,278,167,861,923
5,426,276,194,896,923
6,412,348,195,955,923
7,390,369,219,978,923
8,382,402,224,1008,923
9,384,416,226,1026,923
10,397,387,260,1044,923
11,397,413,266,1076,923
1,500,200,50,750,924
2,457,237,92,786,924
3,428,257,136,821,924
4,424,282,177,883,924
5,411,326,173,910,924
6,442,324,206,972,924
7,414,350,226,990,924
8,406,371,251,1028,924
9,394,370,263,1027,924
10,374,404,261,1039,924
11,371,404,279,1054,924
1,500,200,50,750,925
2,447,234,88,769,925
3,436,255,122,813,925
4,443,280,162,885,925
5,438,309,168,915,925
6,434,341,195,970,925
7,392,353,231,976,925
8,388,365,239,992,925
9,378,383,257,1018,925
10,377,421,273,1071,925
11,359,431,287,1077,925
1,500,200,50,750,926
2,459,232,99,790,926
3,432,248,146,826,926
4,415,270,175,860,926
5,383,303,204,890,926
6,382,328,228,938,926
7,382,349,234,965,926
8,404,386,237,1027,926
9,392,389,251,1032,926
10,389,413,254,1056,926
11,386,433,276,1095,926
1,500,200,50,750,927
2,446,235,96,777,927
3,408,278,136,822,927
4,395,318,163,876,927
5,394,330,196,920,927
6,385,356,218,959,927
7,392,357,230,979,927
8,381,376,242,999,927
9,389,363,268,1020,927
10,387,402,270,1059,927
11,384,414,275,1073,927
1,500,200,50,750,928
2,460,220,106,786,928
3,406,264,145,815,928
4,392,302,165,859,928
5,386,315,212,913,928
6,388,351,216,955,928
7,388,351,249,988,928
8,383,361,260,1004,928
9,390,388,255,1033,928
10,422,389,266,1077,928
11,422,385,277,1084,928
1,500,200,50,750,929
2,444,244,99,787,929
3,408,270,141,819,929
4,390,301,173,864,929
5,390,305,208,903,929
6,399,340,214,953,929
7,386,358,248,992,929
8,379,378,252,1009,929
9,351,413,269,1033,929
10,356,412,288,1056,929
11,363,417,304,1084,929
1,500,200,50,750,930
2,471,249,91,811,930
3,425,272,126,823,930
4,403,304,167,874,930
5,379,327,197,903,930
6,403,351,214,968,930
7,404,355,228,987,930
8,369,382,246,997,930
9,384,384,245,1013,930
10,397,398,256,1051,930
11,408,399,271,1078,930
1,500,200,50,750,931
2,455,218,115,788,931
3,433,257,148,838,931
4,395,300,176,871,931
5,385,319,214,918,931
6,381,359,221,961,931
7,376,356,238,970,931
8,395,380,230,1005,931
9,402,401,248,1051,931
10,405,402,260,1067,931
11,404,418,265,1087,931
1,500,200,50,750,932
2,456,232,92,780,932
3,451,263,112,826,932
4,431,314,134,879,932
5,438,329,156,923,932
6,443,333,193,969,932
7,441,344,210,995,932
8,403,359,245,1007,932
9,416,356,257,1029,932
10,418,375,268,1061,932
11,432,368,276,1076,932
1,500,200,50,750,933
2,452,235,98,785,933
3,415,258,152,825,933
4,422,295,152,869,933
5,429,301,182,912,933
6,426,332,195,953,933
7,421,350,192,963,933
8,409,374,232,1015,933
9,405,391,237,1033,933
10,373,398,280,1051,933
11,380,436,281,1097,933
1,500,200,50,750,934
2,448,239,98,785,934
3,421,272,120,813,934
4,411,279,168,858,934
5,420,313,180,913,934
6,444,317,205,966,934
7,402,339,240,981,934
8,392,362,251,1005,934
9,381,375,271,1027,934
10,385,402,278,1065,934
11,384,411,290,1085,934
1,500,200,50,750,935
2,450,233,98,781,935
3,435,255,152,842,935
4,392,298,165,855,935
5,385,323,199,907,935
6,393,355,210,958,935
7,378,371,214,963,935
8,413,382,229,1024,935
9,404,396,245,1045,935
10,405,401,260,1066,935
11,383,403,279,1065,935
1,500,200,50,750,936
2,443,242,101,786,936
3,446,260,142,848,936
4,419,268,182,869,936
5,434,274,208,916,936
6,408,317,210,935,936
7,416,362,229,1007,936
8,391,376,245,1012,936
9,406,360,269,1035,936
10,407,378,268,1053,936
11,436,387,274,1097,936
1,500,200,50,750,937
2,457,233,87,777,937
3,423,275,126,824,937
4,396,305,167,868,937
5,381,340,180,901,937
6,401,372,194,967,937
7,401,371,219,991,937
8,398,361,246,1005,937
9,380,390,245,1015,937
10,410,415,245,1070,937
11,401,407,273,1081,937
1,500,200,50,750,938
2,456,236,91,783,938
3,419,274,130,823,938
4,426,288,170,884,938
5,435,282,203,920,938
6,424,308,232,964,938
7,410,329,247,986,938
8,392,338,268,998,938
9,410,361,272,1043,938
10,382,388,277,1047,938
11,397,431,250,1078,938
1,500,200,50,750,939
2,463,237,100,800,939
3,454,256,134,844,939
4,422,271,178,871,939
5,394,329,180,903,939
6,398,359,196,953,939
7,397,350,217,964,939
8,399,369,242,1010,939
9,390,379,255,1024,939
10,395,389,274,1058,939
11,392,417,273,1082,939
1,500,200,50,750,940
2,459,240,96,795,940
3,430,251,137,818,940
4,422,270,162,854,940
5,428,281,198,907,940
6,449,303,218,970,940
7,401,323,248,972,940
8,390,337,276,1003,940
9,368,361,286,1015,940
10,400,365,286,1051,940
11,392,396,280,1068,940
1,500,200,50,750,941
2,456,219,101,776,941
3,456,244,143,843,941
4,425,287,159,871,941
5,398,329,176,903,941
6,391,342,220,953,941
7,398,331,238,967,941
8,432,329,264,1025,941
9,411,352,263,1026,941
10,427,377,265,1069,941
11,411,405,275,1091,941
1,500,200,50,750,942
2,440,248,102,790,942
3,414,257,147,818,942
4,414,285,169,868,942
5,393,312,191,896,942
6,402,325,222,949,942
7,374,372,225,971,942
8,364,382,244,990,942
9,375,377,270,1022,942
10,397,378,281,1056,942
11,402,389,291,1082,942
1,500,200,50,750,943
2,472,232,83,787,943
3,449,254,122,825,943
4,412,297,151,860,943
5,411,337,163,911,943
6,409,335,211,955,943
7,409,350,221,980,943
8,392,373,235,1000,943
9,385,404,236,1025,943
10,401,394,253,1048,943
11,415,411,260,1086,943
1,500,200,50,750,944
2,448,244,103,795,944
3,442,250,134,826,944
4,416,267,181,864,944
5,423,302,191,916,944
6,415,323,210,948,944
7,407,341,232,980,944
8,403,354,252,1009,944
9,402,362,271,1035,944
10,396,392,277,1065,944
11,383,408,292,1083,944
1,500,200,50,750,945
2,448,234,108,790,945
3,406,276,142,824,945
4,419,283,176,878,945
5,413,293,190,896,945
6,419,320,215,954,945
7,406,350,227,983,945
8,384,372,248,1004,945
9,406,376,246,1028,945
10,424,378,255,1057,945
11,434,397,254,1085,945
1,500,200,50,750,946
2,481,212,94,787,946
3,448,238,138,824,946
4,443,274,164,881,946
5,415,322,187,924,946
6,406,342,208,956,946
7,401,365,226,992,946
8,399,384,231,1014,946
9,390,409,247,1046,946
10,390,402,254,1046,946
11,397,426,261,1084,946
1,500,200,50,750,947
2,457,238,84,779,947
3,432,279,122,833,947
4,395,311,156,862,947
5,404,308,197,909,947
6,400,329,217,946,947
7,409,340,237,986,947
8,413,348,255,1016,947
9,405,356,258,1019,947
10,412,392,262,1066,947
11,399,395,278,1072,947
1,500,200,50,750,948
2,451,229,103,783,948
3,412,268,138,818,948
4,419,298,165,882,948
5,415,319,184,918,948
6,414,331,217,962,948
7,416,323,245,984,948
8,395,363,254,1012,948
9,392,363,260,1015,948
10,430,375,263,1068,948
11,437,384,260,1081,948
1,500,200,50,750,949
2,472,222,95,789,949
3,425,275,121,821,949
4,415,299,146,860,949
5,401,328,174,903,949
6,390,364,210,964,949
7,392,354,245,991,949
8,361,377,258,996,949
9,376,368,290,1034,949
10,389,362,297,1048,949
11,391,390,300,1081,949
1,500,200,50,750,950
2,448,250,87,785,950
3,420,266,137,823,950
4,402,297,160,859,950
5,399,323,190,912,950
6,377,370,208,955,950
7,365,375,237,977,950
8,381,381,236,998,950
9,401,390,243,1034,950
10,421,383,262,1066,950
11,391,413,273,1077,950
1,500,200,50,750,951
2,442,225,108,775,951
3,424,266,133,823,951
4,413,301,164,878,951
5,393,315,190,898,951
6,395,356,219,970,951
7,386,355,232,973,951
8,386,374,248,1008,951
9,395,388,247,1030,951
10,407,381,264,1052,951
11,415,392,271,1078,951
1,500,200,50,750,952
2,459,246,88,793,952
3,427,269,122,818,952
4,416,282,160,858,952
5,404,294,201,899,952
6,409,327,217,953,952
7,393,354,238,985,952
8,386,383,233,1002,952
9,392,393,249,1034,952
10,412,404,263,1079,952
11,417,406,268,1091,952
1,500,200,50,750,953
2,479,212,100,791,953
3,474,221,139,834,953
4,445,246,169,860,953
5,439,289,187,915,953
6,424,341,187,952,953
7,420,342,226,988,953
8,402,358,225,985,953
9,417,381,236,1034,953
10,400,396,256,1052,953
11,415,384,278,1077,953
1,500,200,50,750,954
2,450,243,84,777,954
3,436,267,133,836,954
4,418,283,168,869,954
5,425,325,166,916,954
6,427,329,209,965,954
7,423,348,216,987,954
8,398,386,222,1006,954
9,390,395,239,1024,954
10,386,412,259,1057,954
11,396,418,278,1092,954
1,500,200,50,750,955
2,438,234,109,781,955
3,433,275,128,836,955
4,434,288,150,872,955
5,403,323,177,903,955
6,408,361,187,956,955
7,404,356,221,981,955
8,391,379,244,1014,955
9,377,402,258,1037,955
10,398,409,272,1079,955
11,393,408,303,1104,955
1,500,200,50,750,956
2,440,238,110,788,956
3,418,272,140,830,956
4,406,306,177,889,956
5,407,311,184,902,956
6,408,339,216,963,956
7,395,341,250,986,956
8,386,347,255,988,956
9,393,372,269,1034,956
10,374,388,286,1048,956
11,373,420,279,1072,956
1,500,200,50,750,957
2,473,219,107,799,957
3,424,276,131,831,957
4,414,312,146,872,957
5,406,342,165,913,957
6,421,357,192,970,957
7,387,367,215,969,957
8,394,382,239,1015,957
9,407,385,251,1043,957
10,396,406,263,1065,957
11,383,426,268,1077,957
1,500,200,50,750,958
2,465,236,89,790,958
3,426,258,134,818,958
4,410,307,158,875,958
5,415,325,178,918,958
6,414,344,203,961,958
7,412,354,217,983,958
8,405,382,226,1013,958
9,417,359,248,1024,958
10,432,368,253,1053,958
11,448,391,239,1078,958
1,500,200,50,750,959
2,469,245,84,798,959
3,433,274,127,834,959
4,410,302,160,872,959
5,397,342,201,940,959
6,381,350,214,945,959
7,376,383,229,988,959
8,374,395,249,1018,959
9,372,403,261,1036,959
10,391,399,279,1069,959
11,388,401,299,1088,959
1,500,200,50,750,960
2,451,243,101,795,960
3,432,260,135,827,960
4,425,299,148,872,960
5,437,307,182,926,960
6,429,324,191,944,960
7,430,333,212,975,960
8,447,360,205,1012,960
9,421,390,218,1029,960
10,408,385,264,1057,960
11,408,414,272,1094,960
1,500,200,50,750,961
2,454,227,109,790,961
3,428,250,145,823,961
4,406,281,173,860,961
5,391,335,188,914,961
6,412,363,190,965,961
7,379,368,224,971,961
8,380,386,261,1027,961
9,383,418,251,1052,961
10,386,418,260,1064,961
11,382,429,280,1091,961
1,500,200,50,750,962
2,457,233,101,791,962
3,427,257,148,832,962
4,392,296,175,863,962
5,375,332,192,899,962
6,366,364,223,953,962
7,359,393,230,982,962
8,359,380,267,1006,962
9,369,395,264,1028,962
10,369,414,266,1049,962
11,375,402,303,1080,962
1,500,200,50,750,963
2,445,248,104,797,963
3,405,282,141,828,963
4,416,277,180,873,963
5,406,314,187,907,963
6,413,356,197,966,963
7,430,362,213,1005,963
8,407,356,244,1007,963
9,388,380,254,1022,963
10,397,391,294,1082,963
11,367,402,307,1076,963
1,500,200,50,750,964
2,449,241,83,773,964
3,446,260,122,828,964
4,428,268,167,863,964
5,431,313,167,911,964
6,445,319,189,953,964
7,417,347,214,978,964
8,433,363,230,1026,964
9,442,369,243,1054,964
10,410,391,255,1056,964
11,420,388,276,1084,964
1,500,200,50,750,965
2,472,233,83,788,965
3,455,244,132,831,965
4,421,285,159,865,965
5,407,319,191,917,965
6,380,340,216,936,965
7,393,373,217,983,965
8,369,392,244,1005,965
9,381,381,256,1018,965
10,395,396,261,1052,965
11,395,403,261,1059,965
1,500,200,50,750,966
2,462,224,101,787,966
3,427,266,140,833,966
4,391,301,175,867,966
5,409,320,198,927,966
6,395,352,210,957,966
7,396,371,228,995,966
8,390,380,233,1003,966
9,380,393,249,1022,966
10,402,393,269,1064,966
11,428,409,269,1106,966
1,500,200,50,750,967
2,462,236,96,794,967
3,413,254,152,819,967
4,413,278,179,870,967
5,405,300,202,907,967
6,424,345,202,971,967
7,419,336,233,988,967
8,409,374,235,1018,967
9,389,381,249,1019,967
10,403,415,247,1065,967
11,414,408,268,1090,967
1,500,200,50,750,968
2,455,230,91,776,968
3,430,270,120,820,968
4,411,312,151,874,968
5,411,334,170,915,968
6,407,351,189,947,968
7,413,365,211,989,968
8,404,374,226,1004,968
9,416,381,243,1040,968
10,400,378,279,1057,968
11,417,407,261,1085,968
1,500,200,50,750,969
2,453,219,114,786,969
3,414,250,146,810,969
4,428,291,148,867,969
5,416,309,179,904,969
6,423,342,194,959,969
7,390,365,221,976,969
8,391,363,253,1007,969
9,394,382,259,1035,969
10,403,383,271,1057,969
11,399,408,270,1077,969
1,500,200,50,750,970
2,472,232,90,794,970
3,441,273,131,845,970
4,409,299,161,869,970
5,412,311,175,898,970
6,430,335,200,965,970
7,424,330,221,975,970
8,412,346,235,993,970
9,412,368,250,1030,970
10,423,399,258,1080,970
11,398,400,284,1082,970
1,500,200,50,750,971
2,468,210,113,791,971
3,409,261,154,824,971
4,384,300,176,860,971
5,368,343,187,898,971
6,388,372,203,963,971
7,381,367,238,986,971
8,364,387,246,997,971
9,374,421,252,1047,971
10,367,402,295,1064,971
11,385,417,285,1087,971
1,500,200,50,750,972
2,442,242,116,800,972
3,423,257,145,825,972
4,393,307,162,862,972
5,381,317,195,893,972
6,378,360,212,950,972
7,366,391,221,978,972
8,398,366,239,1003,972
9,393,374,259,1026,972
10,407,394,257,1058,972
11,404,413,283,1100,972
1,500,200,50,750,973
2,461,232,94,787,973
3,438,269,126,833,973
4,426,291,148,865,973
5,413,321,185,919,973
6,382,343,219,944,973
7,376,374,229,979,973
8,379,380,262,1021,973
9,371,390,257,1018,973
10,386,414,252,1052,973
11,398,439,257,1094,973
1,500,200,50,750,974
2,471,213,110,794,974
3,438,251,137,826,974
4,410,263,178,851,974
5,414,292,211,917,974
6,409,328,218,955,974
7,401,351,218,970,974
8,381,364,246,991,974
9,412,394,244,1050,974
10,402,393,252,1047,974
11,415,406,256,1077,974
1,500,200,50,750,975
2,457,253,91,801,975
3,414,274,129,817,975
4,387,306,167,860,975
5,393,342,183,918,975
6,399,337,241,977,975
7,381,360,249,990,975
8,365,400,248,1013,975
9,364,396,261,1021,975
10,372,372,284,1028,975
11,388,398,291,1077,975
1,500,200,50,750,976
2,460,211,108,779,976
3,423,255,136,814,976
4,433,290,155,878,976
5,423,311,176,910,976
6,416,335,215,966,976
7,410,353,219,982,976
8,411,391,229,1031,976
9,392,400,247,1039,976
10,380,416,249,1045,976
11,411,407,280,1098,976
1,500,200,50,750,977
2,462,224,92,778,977
3,431,253,134,818,977
4,413,286,160,859,977
5,405,318,184,907,977
6,408,345,201,954,977
7,427,347,205,979,977
8,416,355,227,998,977
9,426,374,235,1035,977
10,427,375,252,1054,977
11,406,420,257,1083,977
1,500,200,50,750,978
2,474,228,90,792,978
3,449,250,132,831,978
4,419,279,173,871,978
5,428,314,186,928,978
6,413,333,212,958,978
7,398,359,223,980,978
8,376,392,241,1009,978
9,373,408,255,1036,978
10,369,416,268,1053,978
11,385,413,286,1084,978
1,500,200,50,750,979
2,463,223,97,783,979
3,439,263,142,844,979
4,381,310,163,854,979
5,397,333,186,916,979
6,397,360,212,969,979
7,399,361,216,976,979
8,418,372,211,1001,979
9,404,399,227,1030,979
10,403,401,243,1047,979
11,411,412,253,1076,979
1,500,200,50,750,980
2,447,220,108,775,980
3,406,273,161,840,980
4,384,296,183,863,980
5,385,320,207,912,980
6,386,347,234,967,980
7,381,358,242,981,980
8,399,370,255,1024,980
9,390,368,268,1026,980
10,378,383,285,1046,980
11,390,382,298,1070,980
1,500,200,50,750,981
2,442,244,102,788,981
3,396,277,141,814,981
4,391,294,179,864,981
5,400,313,205,918,981
6,375,359,219,953,981
7,372,367,245,984,981
8,380,374,245,999,981
9,387,392,261,1040,981
10,401,392,275,1068,981
11,400,405,281,1086,981
1,500,200,50,750,982
2,437,233,111,781,982
3,412,261,140,813,982
4,407,307,146,860,982
5,395,352,163,910,982
6,425,362,180,967,982
7,394,388,210,992,982
8,413,384,229,1026,982
9,383,389,260,1032,982
10,417,394,270,1081,982
11,404,413,259,1076,982
1,500,200,50,750,983
2,477,218,104,799,983
3,427,263,125,815,983
4,418,284,173,875,983
5,413,297,198,908,983
6,417,345,214,976,983
7,402,337,239,978,983
8,389,350,263,1002,983
9,393,349,271,1013,983
10,396,397,286,1079,983
11,377,422,273,1072,983
1,500,200,50,750,984
2,479,214,100,793,984
3,458,246,129,833,984
4,424,291,156,871,984
5,418,329,180,927,984
6,414,357,198,969,984
7,396,371,205,972,984
8,400,377,227,1004,984
9,398,402,230,1030,984
10,409,410,242,1061,984
11,409,404,270,1083,984
1,500,200,50,750,985
2,454,241,94,789,985
3,427,244,148,819,985
4,408,297,163,868,985
5,410,314,181,905,985
6,398,334,216,948,985
7,398,350,227,975,985
8,393,359,250,1002,985
9,396,363,271,1030,985
10,391,389,275,1055,985
11,362,432,275,1069,985
1,500,200,50,750,986
2,451,227,111,789,986
3,426,251,148,825,986
4,414,281,172,867,986
5,410,304,198,912,986
6,422,325,222,969,986
7,392,358,231,981,986
8,395,374,238,1007,986
9,392,381,256,1029,986
10,377,402,274,1053,986
11,393,422,265,1080,986
1,500,200,50,750,987
2,447,242,101,790,987
3,417,259,150,826,987
4,405,294,174,873,987
5,408,308,197,913,987
6,420,332,213,965,987
7,407,354,229,990,987
8,415,369,230,1014,987
9,392,409,229,1030,987
10,393,411,260,1064,987
11,394,405,280,1079,987
1,500,200,50,750,988
2,448,240,96,784,988
3,451,261,124,836,988
4,437,279,165,881,988
5,415,340,158,913,988
6,420,350,193,963,988
7,391,381,210,982,988
8,383,390,230,1003,988
9,376,390,253,1019,988
10,372,404,267,1043,988
11,391,402,284,1077,988
1,500,200,50,750,989
2,448,240,88,776,989
3,438,249,136,823,989
4,425,274,174,873,989
5,411,307,187,905,989
6,414,336,206,956,989
7,390,367,214,971,989
8,394,375,237,1006,989
9,401,379,250,1030,989
10,395,384,279,1058,989
11,385,390,302,1077,989
1,500,200,50,750,990
2,453,230,100,783,990
3,419,259,138,816,990
4,426,287,170,883,990
5,422,306,181,909,990
6,423,319,209,951,990
7,403,359,215,977,990
8,413,365,239,1017,990
9,404,376,253,1033,990
10,373,397,279,1049,990
11,388,397,286,1071,990
1,500,200,50,750,991
2,445,238,105,788,991
3,431,256,131,818,991
4,424,296,151,871,991
5,436,311,174,921,991
6,405,339,191,935,991
7,409,355,214,978,991
8,411,364,235,1010,991
9,386,374,259,1019,991
10,400,394,256,1050,991
11,387,397,273,1057,991
1,500,200,50,750,992
2,460,239,85,784,992
3,422,284,119,825,992
4,393,315,149,857,992
5,404,307,182,893,992
6,412,356,199,967,992
7,400,335,241,976,992
8,382,370,248,1000,992
9,398,384,262,1044,992
10,393,383,285,1061,992
11,381,405,288,1074,992
1,500,200,50,750,993
2,482,223,98,803,993
3,432,257,137,826,993
4,417,278,178,873,993
5,423,313,200,936,993
6,407,337,214,958,993
7,394,345,235,974,993
8,387,378,247,1012,993
9,383,385,258,1026,993
10,378,403,275,1056,993
11,366,423,291,1080,993
1,500,200,50,750,994
2,462,248,90,800,994
3,443,256,132,831,994
4,423,291,159,873,994
5,428,293,191,912,994
6,432,329,209,970,994
7,422,323,228,973,994
8,432,345,236,1013,994
9,396,387,246,1029,994
10,399,409,238,1046,994
11,414,417,253,1084,994
1,500,200,50,750,995
2,450,239,98,787,995
3,419,253,135,807,995
4,420,268,177,865,995
5,426,307,192,925,995
6,416,337,207,960,995
7,396,362,217,975,995
8,375,370,253,998,995
9,392,391,251,1034,995
10,402,375,284,1061,995
11,398,409,283,1090,995
1,500,200,50,750,996
2,454,236,96,786,996
3,452,248,133,833,996
4,428,288,160,876,996
5,395,319,193,907,996
6,415,335,212,962,996
7,403,339,243,985,996
8,405,349,244,998,996
9,386,393,266,1045,996
10,380,402,271,1053,996
11,381,422,278,1081,996
1,500,200,50,750,997
2,463,226,92,781,997
3,434,265,120,819,997
4,435,267,180,882,997
5,424,308,189,921,997
6,424,337,206,967,997
7,402,349,225,976,997
8,402,367,236,1005,997
9,409,365,251,1025,997
10,413,356,257,1026,997
11,444,372,266,1082,997
1,500,200,50,750,998
2,445,236,105,786,998
3,428,253,149,830,998
4,397,287,180,864,998
5,408,329,177,914,998
6,407,350,203,960,998
7,385,366,229,980,998
8,396,377,234,1007,998
9,383,383,256,1022,998
10,397,403,270,1070,998
11,379,416,291,1086,998
1,500,200,50,750,999
2,479,204,112,795,999
3,436,239,137,812,999
4,432,274,159,865,999
5,439,291,189,919,999
6,437,312,212,961,999
7,427,344,221,992,999
8,402,369,239,1010,999
9,376,404,258,1038,999
10,389,396,279,1064,999
11,393,414,284,1091,999
1,500,200,50,750,1000
2,448,235,104,787,1000
3,412,264,150,826,1000
4,401,288,186,875,1000
5,402,305,197,904,1000
6,398,361,208,967,1000
7,401,372,210,983,1000
8,386,403,226,1015,1000
9,383,392,253,1028,1000
10,391,407,272,1070,1000
11,378,421,293,1092,1000
1,500,200,50,750,1001
2,464,237,87,788,1001
3,434,264,136,834,1001
4,431,295,156,882,1001
5,419,304,187,910,1001
6,428,321,213,962,1001
7,396,340,228,964,1001
8,385,372,249,1006,1001
9,382,381,260,1023,1001
10,383,379,269,1031,1001
11,416,391,286,1093,1001
1,500,200,50,750,1002
2,458,223,105,786,1002
3,422,253,130,805,1002
4,407,289,172,868,1002
5,398,332,179,909,1002
6,382,352,210,944,1002
7,394,391,224,1009,1002
8,360,408,243,1011,1002
9,366,416,245,1027,1002
10,378,450,246,1074,1002
11,382,448,256,1086,1002
1,500,200,50,750,1003
2,459,217,103,779,1003
3,435,258,130,823,1003
4,426,290,153,869,1003
5,435,309,165,909,1003
6,422,342,193,957,1003
7,406,373,201,980,1003
8,415,381,226,1022,1003
9,394,387,240,1021,1003
10,400,404,249,1053,1003
11,396,420,268,1084,1003
1,500,200,50,750,1004
2,456,226,104,786,1004
3,415,278,143,836,1004
4,390,295,178,863,1004
5,389,328,188,905,1004
6,377,343,219,939,1004
7,378,379,228,985,1004
8,385,389,246,1020,1004
9,359,399,262,1020,1004
10,382,417,267,1066,1004
11,395,414,284,1093,1004
1,500,200,50,750,1005
2,478,242,70,790,1005
3,431,258,119,808,1005
4,420,292,150,862,1005
5,411,311,181,903,1005
6,449,337,193,979,1005
7,419,371,201,991,1005
8,420,365,232,1017,1005
9,426,374,242,1042,1005
10,424,385,252,1061,1005
11,442,407,256,1105,1005
1,500,200,50,750,1006
2,452,221,111,784,1006
3,428,245,143,816,1006
4,414,271,186,871,1006
5,422,281,206,909,1006
6,438,299,225,962,1006
7,438,327,231,996,1006
8,430,332,247,1009,1006
9,412,340,270,1022,1006
10,413,362,277,1052,1006
11,389,413,293,1095,1006
1,500,200,50,750,1007
2,443,240,95,778,1007
3,429,270,126,825,1007
4,423,298,150,871,1007
5,416,299,195,910,1007
6,415,332,223,970,1007
7,381,353,233,967,1007
8,409,356,247,1012,1007
9,391,367,258,1016,1007
10,379,379,277,1035,1007
11,413,407,284,1104,1007
1,500,200,50,750,1008
2,477,242,82,801,1008
3,441,267,136,844,1008
4,416,294,171,881,1008
5,407,312,184,903,1008
6,419,330,207,956,1008
7,424,333,220,977,1008
8,407,370,229,1006,1008
9,403,391,230,1024,1008
10,407,366,274,1047,1008
11,412,407,293,1112,1008
1,500,200,50,750,1009
2,450,241,96,787,1009
3,444,263,135,842,1009
4,419,287,168,874,1009
5,430,305,197,932,1009
6,421,329,209,959,1009
7,381,353,220,954,1009
8,369,372,251,992,1009
9,382,394,261,1037,1009
10,382,413,279,1074,1009
11,386,410,295,1091,1009
1,500,200,50,750,1010
2,466,226,99,791,1010
3,422,262,142,826,1010
4,397,292,182,871,1010
5,383,317,202,902,1010
6,406,343,214,963,1010
7,385,369,231,985,1010
8,409,393,216,1018,1010
9,399,414,226,1039,1010
10,383,408,255,1046,1010
11,384,415,271,1070,1010
1,500,200,50,750,1011
2,463,224,105,792,1011
3,432,249,149,830,1011
4,428,277,165,870,1011
5,426,294,202,922,1011
6,419,335,206,960,1011
7,413,349,236,998,1011
8,396,370,255,1021,1011
9,398,378,255,1031,1011
10,386,387,280,1053,1011
11,412,400,268,1080,1011
1,500,200,50,750,1012
2,433,231,119,783,1012
3,399,273,142,814,1012
4,399,290,171,860,1012
5,409,310,196,915,1012
6,422,317,209,948,1012
7,402,358,221,981,1012
8,405,368,236,1009,1012
9,401,396,242,1039,1012
10,402,404,253,1059,1012
11,416,406,275,1097,1012
1,500,200,50,750,1013
2,455,242,98,795,1013
3,403,267,155,825,1013
4,369,296,189,854,1013
5,402,315,194,911,1013
6,382,354,214,950,1013
7,370,383,208,961,1013
8,375,394,245,1014,1013
9,365,419,257,1041,1013
10,372,427,269,1068,1013
11,384,434,273,1091,1013
1,500,200,50,750,1014
2,450,211,111,772,1014
3,440,248,139,827,1014
4,425,263,179,867,1014
5,430,279,198,907,1014
6,439,316,207,962,1014
7,414,347,224,985,1014
8,417,335,242,994,1014
9,412,367,263,1042,1014
10,409,395,265,1069,1014
11,399,407,266,1072,1014
1,500,200,50,750,1015
2,460,246,89,795,1015
3,415,272,134,821,1015
4,398,275,178,851,1015
5,411,318,196,925,1015
6,390,353,214,957,1015
7,385,365,234,984,1015
8,385,370,255,1010,1015
9,389,413,224,1026,1015
10,385,417,248,1050,1015
11,413,404,261,1078,1015
1,500,200,50,750,1016
2,448,256,102,806,1016
3,415,279,132,826,1016
4,402,309,157,868,1016
5,400,339,177,916,1016
6,387,354,208,949,1016
7,379,363,228,970,1016
8,374,388,254,1016,1016
9,370,381,268,1019,1016
10,366,402,270,1038,1016
11,388,418,287,1093,1016
1,500,200,50,750,1017
2,453,239,100,792,1017
3,423,264,139,826,1017
4,409,282,176,867,1017
5,410,306,186,902,1017
6,398,330,199,927,1017
7,376,371,215,962,1017
8,386,402,215,1003,1017
9,378,420,234,1032,1017
10,387,420,251,1058,1017
11,390,435,271,1096,1017
1,500,200,50,750,1018
2,451,241,95,787,1018
3,435,264,131,830,1018
4,413,292,169,874,1018
5,390,305,210,905,1018
6,404,331,226,961,1018
7,397,349,232,978,1018
8,375,389,243,1007,1018
9,412,371,278,1061,1018
10,391,389,276,1056,1018
11,383,423,295,1101,1018
1,500,200,50,750,1019
2,452,230,107,789,1019
3,424,260,149,833,1019
4,400,282,183,865,1019
5,391,302,219,912,1019
6,386,343,237,966,1019
7,393,337,244,974,1019
8,412,365,248,1025,1019
9,402,396,247,1045,1019
10,400,410,257,1067,1019
11,376,415,272,1063,1019
1,500,200,50,750,1020
2,467,213,109,789,1020
3,454,237,135,826,1020
4,433,268,166,867,1020
5,426,302,197,925,1020
6,404,324,227,955,1020
7,384,358,231,973,1020
8,400,370,235,1005,1020
9,413,393,227,1033,1020
10,414,400,256,1070,1020
11,413,401,263,1077,1020
1,500,200,50,750,1021
2,440,227,107,774,1021
3,414,254,159,827,1021
4,403,286,181,870,1021
5,390,310,208,908,1021
6,404,331,230,965,1021
7,393,335,242,970,1021
8,392,335,273,1000,1021
9,387,366,264,1017,1021
10,382,392,281,1055,1021
11,401,412,275,1088,1021
1,500,200,50,750,1022
2,462,233,92,787,1022
3,449,251,139,839,1022
4,418,293,172,883,1022
5,413,310,191,914,1022
6,396,342,218,956,1022
7,394,349,238,981,1022
8,389,356,266,1011,1022
9,385,372,267,1024,1022
10,397,393,263,1053,1022
11,404,405,278,1087,1022
1,500,200,50,750,1023
2,470,234,91,795,1023
3,449,266,119,834,1023
4,428,284,163,875,1023
5,403,332,173,908,1023
6,419,328,214,961,1023
7,393,364,225,982,1023
8,391,383,233,1007,1023
9,377,409,241,1027,1023
10,389,429,251,1069,1023
11,381,434,266,1081,1023
1,500,200,50,750,1024
2,470,232,102,804,1024
3,424,255,142,821,1024
4,407,285,165,857,1024
5,401,300,190,891,1024
6,392,364,208,964,1024
7,385,353,241,979,1024
8,384,370,247,1001,1024
9,403,376,255,1034,1024
10,419,403,250,1072,1024
11,415,399,264,1078,1024
1,500,200,50,750,1025
2,464,242,86,792,1025
3,425,268,138,831,1025
4,424,294,154,872,1025
5,419,296,191,906,1025
6,448,332,198,978,1025
7,428,343,208,979,1025
8,415,349,233,997,1025
9,417,359,259,1035,1025
10,427,385,251,1063,1025
11,424,409,255,1088,1025
1,500,200,50,750,1026
2,450,218,111,779,1026
3,430,247,150,827,1026
4,416,303,164,883,1026
5,388,307,217,912,1026
6,381,331,229,941,1026
7,385,366,225,976,1026
8,367,379,243,989,1026
9,385,396,254,1035,1026
10,414,396,264,1074,1026
11,407,395,273,1075,1026
1,500,200,50,750,1027
2,455,227,98,780,1027
3,446,257,119,822,1027
4,417,280,172,869,1027
5,408,296,209,913,1027
6,417,325,229,971,1027
7,402,357,227,986,1027
8,386,372,250,1008,1027
9,388,385,257,1030,1027
10,396,405,253,1054,1027
11,404,410,282,1096,1027
1,500,200,50,750,1028
2,468,215,102,785,1028
3,444,253,141,838,1028
4,442,258,163,863,1028
5,427,289,192,908,1028
6,430,321,203,954,1028
7,421,345,217,983,1028
8,417,357,242,1016,1028
9,410,363,262,1035,1028
10,400,409,237,1046,1028
11,407,423,263,1093,1028
1,500,200,50,750,1029
2,443,239,99,781,1029
3,412,267,141,820,1029
4,403,291,175,869,1029
5,408,333,193,934,1029
6,409,347,198,954,1029
7,400,375,213,988,1029
8,403,380,228,1011,1029
9,397,382,254,1033,1029
10,396,404,256,1056,1029
11,391,404,271,1066,1029
1,500,200,50,750,1030
2,465,233,82,780,1030
3,450,255,120,825,1030
4,434,274,153,861,1030
5,437,302,187,926,1030
6,429,316,211,956,1030
7,416,345,215,976,1030
8,393,363,237,993,1030
9,400,374,248,1022,1030
10,418,367,281,1066,1030
11,393,387,288,1068,1030
1,500,200,50,750,1031
2,449,227,108,784,1031
3,429,243,142,814,1031
4,384,294,161,839,1031
5,374,338,197,909,1031
6,379,345,223,947,1031
7,355,372,238,965,1031
8,369,379,249,997,1031
9,376,380,278,1034,1031
10,379,414,273,1066,1031
11,371,400,300,1071,1031
1,500,200,50,750,1032
2,474,226,84,784,1032
3,461,261,125,847,1032
4,446,270,160,876,1032
5,417,307,190,914,1032
6,398,321,224,943,1032
7,398,317,248,963,1032
8,389,359,266,1014,1032
9,392,385,254,1031,1032
10,390,391,267,1048,1032
11,382,435,262,1079,1032
1,500,200,50,750,1033
2,461,238,90,789,1033
3,455,239,126,820,1033
4,440,264,161,865,1033
5,435,286,177,898,1033
6,422,331,201,954,1033
7,389,359,237,985,1033
8,394,373,234,1001,1033
9,396,376,247,1019,1033
10,407,381,269,1057,1033
11,413,363,294,1070,1033
1,500,200,50,750,1034
2,475,225,94,794,1034
3,452,240,132,824,1034
4,444,270,148,862,1034
5,440,305,177,922,1034
6,437,314,203,954,1034
7,417,333,232,982,1034
8,398,364,244,1006,1034
9,387,387,268,1042,1034
10,385,404,254,1043,1034
11,412,408,266,1086,1034
1,500,200,50,750,1035
2,443,242,98,783,1035
3,426,259,145,830,1035
4,399,283,170,852,1035
5,426,293,201,920,1035
6,419,325,207,951,1035
7,418,338,212,968,1035
8,426,348,237,1011,1035
9,425,358,259,1042,1035
10,401,387,273,1061,1035
11,416,411,258,1085,1035
1,500,200,50,750,1036
2,462,214,93,769,1036
3,450,267,124,841,1036
4,434,288,151,873,1036
5,436,293,179,908,1036
6,423,334,198,955,1036
7,409,349,223,981,1036
8,386,368,227,981,1036
9,405,393,234,1032,1036
10,409,417,247,1073,1036
11,405,415,260,1080,1036
1,500,200,50,750,1037
2,466,225,98,789,1037
3,427,245,148,820,1037
4,415,277,174,866,1037
5,410,313,193,916,1037
6,421,354,191,966,1037
7,410,362,208,980,1037
8,405,376,229,1010,1037
9,389,402,235,1026,1037
10,411,402,255,1068,1037
11,400,422,266,1088,1037
1,500,200,50,750,1038
2,463,244,78,785,1038
3,415,266,128,809,1038
4,425,286,158,869,1038
5,425,324,171,920,1038
6,411,347,204,962,1038
7,395,348,235,978,1038
8,400,373,230,1003,1038
9,412,386,248,1046,1038
10,410,402,261,1073,1038
11,407,389,284,1080,1038
1,500,200,50,750,1039
2,436,248,94,778,1039
3,415,253,146,814,1039
4,399,280,177,856,1039
5,406,298,208,912,1039
6,420,322,224,966,1039
7,401,327,257,985,1039
8,415,347,251,1013,1039
9,406,362,260,1028,1039
10,406,400,267,1073,1039
11,412,396,283,1091,1039
1,500,200,50,750,1040
2,470,233,90,793,1040
3,421,263,122,806,1040
4,417,300,154,871,1040
5,434,300,184,918,1040
6,428,325,212,965,1040
7,383,358,232,973,1040
8,376,370,251,997,1040
9,370,388,268,1026,1040
10,392,408,264,1064,1040
11,407,399,289,1095,1040
1,500,200,50,750,1041
2,458,228,98,784,1041
3,409,267,141,817,1041
4,404,297,173,874,1041
5,388,325,201,914,1041
6,432,353,197,982,1041
7,426,344,212,982,1041
8,412,369,222,1003,1041
9,412,385,233,1030,1041
10,383,414,261,1058,1041
11,386,430,260,1076,1041
1,500,200,50,750,1042
2,469,217,106,792,1042
3,444,243,133,820,1042
4,427,268,170,865,1042
5,438,308,177,923,1042
6,425,323,203,951,1042
7,432,345,222,999,1042
8,410,369,226,1005,1042
9,400,381,242,1023,1042
10,421,392,245,1058,1042
11,397,416,270,1083,1042
1,500,200,50,750,1043
2,477,209,101,787,1043
3,424,249,142,815,1043
4,411,284,183,878,1043
5,388,324,200,912,1043
6,402,364,200,966,1043
7,398,366,222,986,1043
8,386,385,232,1003,1043
9,380,383,260,1023,1043
10,407,396,249,1052,1043
11,410,434,243,1087,1043
1,500,200,50,750,1044
2,483,221,94,798,1044
3,446,259,116,821,1044
4,447,287,138,872,1044
5,447,285,175,907,1044
6,454,313,185,952,1044
7,432,308,227,967,1044
8,409,336,256,1001,1044
9,412,344,274,1030,1044
10,423,360,267,1050,1044
11,436,372,276,1084,1044
1,500,200,50,750,1045
2,441,244,91,776,1045
3,439,266,130,835,1045
4,421,290,167,878,1045
5,384,327,191,902,1045
6,400,339,223,962,1045
7,395,368,236,999,1045
8,384,382,252,1018,1045
9,379,399,253,1031,1045
10,390,396,275,1061,1045
11,402,400,278,1080,1045
1,500,200,50,750,1046
2,449,236,104,789,1046
3,421,265,144,830,1046
4,405,305,165,875,1046
5,390,324,194,908,1046
6,398,341,215,954,1046
7,386,349,239,974,1046
8,400,362,253,1015,1046
9,407,375,247,1029,1046
10,388,412,242,1042,1046
11,416,420,265,1101,1046
1,500,200,50,750,1047
2,476,228,78,782,1047
3,453,245,116,814,1047
4,454,254,145,853,1047
5,455,280,182,917,1047
6,444,303,211,958,1047
7,402,339,231,972,1047
8,392,346,267,1005,1047
9,393,367,275,1035,1047
10,382,378,270,1030,1047
11,386,414,264,1064,1047
1,500,200,50,750,1048
2,471,216,98,785,1048
3,424,262,130,816,1048
4,394,297,168,859,1048
5,397,308,201,906,1048
6,413,339,219,971,1048
7,426,338,227,991,1048
8,413,360,237,1010,1048
9,404,364,258,1026,1048
10,384,383,262,1029,1048
11,403,406,279,1088,1048
1,500,200,50,750,1049
2,451,245,98,794,1049
3,435,266,128,829,1049
4,412,288,164,864,1049
5,409,326,185,920,1049
6,428,366,181,975,1049
7,379,377,216,972,1049
8,394,358,256,1008,1049
9,394,365,261,1020,1049
10,396,400,275,1071,1049
11,400,421,266,1087,1049
1,500,200,50,750,1050
2,450,235,108,793,1050
3,395,267,150,812,1050
4,404,294,185,883,1050
5,385,324,207,916,1050
6,367,349,237,953,1050
7,401,342,246,989,1050
8,407,359,250,1016,1050
9,411,342,284,1037,1050
10,411,358,281,1050,1050
11,431,381,293,1105,1050
1,500,200,50,750,1051
2,450,238,101,789,1051
3,404,277,137,818,1051
4,404,295,171,870,1051
5,389,308,210,907,1051
6,400,327,232,959,1051
7,413,347,227,987,1051
8,405,364,243,1012,1051
9,405,372,254,1031,1051
10,403,420,242,1065,1051
11,403,423,259,1085,1051
1,500,200,50,750,1052
2,458,247,86,791,1052
3,431,256,132,819,1052
4,402,282,180,864,1052
5,413,315,205,933,1052
6,401,322,231,954,1052
7,398,334,240,972,1052
8,379,370,245,994,1052
9,385,378,273,1036,1052
10,386,391,263,1040,1052
11,399,404,277,1080,1052
1,500,200,50,750,1053
2,472,241,95,808,1053
3,425,265,134,824,1053
4,391,277,178,846,1053
5,391,331,192,914,1053
6,417,338,208,963,1053
7,410,363,211,984,1053
8,376,369,253,998,1053
9,372,401,259,1032,1053
10,363,435,261,1059,1053
11,383,417,280,1080,1053
1,500,200,50,750,1054
2,439,243,100,782,1054
3,421,283,121,825,1054
4,418,313,151,882,1054
5,412,333,177,922,1054
6,400,329,222,951,1054
7,374,361,239,974,1054
8,350,387,269,1006,1054
9,358,387,284,1029,1054
10,354,403,286,1043,1054
11,378,417,302,1097,1054
1,500,200,50,750,1055
2,467,225,93,785,1055
3,453,261,128,842,1055
4,414,282,168,864,1055
5,417,330,169,916,1055
6,392,332,219,943,1055
7,379,337,251,967,1055
8,389,363,262,1014,1055
9,397,353,270,1020,1055
10,435,390,254,1079,1055
11,407,412,258,1077,1055
1,500,200,50,750,1056
2,457,248,81,786,1056
3,441,279,122,842,1056
4,432,275,157,864,1056
5,407,315,173,895,1056
6,413,333,215,961,1056
7,386,346,250,982,1056
8,403,352,256,1011,1056
9,397,381,258,1036,1056
10,387,397,277,1061,1056
11,399,392,289,1080,1056
1,500,200,50,750,1057
2,459,223,97,779,1057
3,441,261,122,824,1057
4,426,290,151,867,1057
5,420,308,182,910,1057
6,433,348,203,984,1057
7,396,356,234,986,1057
8,399,356,245,1000,1057
9,398,371,246,1015,1057
10,403,386,268,1057,1057
11,416,382,284,1082,1057
1,500,200,50,750,1058
2,458,237,95,790,1058
3,411,271,140,822,1058
4,430,286,175,891,1058
5,397,303,204,904,1058
6,383,353,228,964,1058
7,361,380,229,970,1058
8,391,372,248,1011,1058
9,394,369,265,1028,1058
10,405,380,271,1056,1058
11,411,411,265,1087,1058
1,500,200,50,750,1059
2,463,231,102,796,1059
3,445,245,148,838,1059
4,423,280,171,874,1059
5,436,310,191,937,1059
6,419,340,197,956,1059
7,411,365,203,979,1059
8,405,352,247,1004,1059
9,402,371,254,1027,1059
10,412,371,263,1046,1059
11,429,398,267,1094,1059
1,500,200,50,750,1060
2,459,233,101,793,1060
3,428,251,145,824,1060
4,421,292,165,878,1060
5,405,317,181,903,1060
6,410,343,211,964,1060
7,409,355,214,978,1060
8,415,368,224,1007,1060
9,403,362,242,1007,1060
10,412,395,255,1062,1060
11,442,394,262,1098,1060
1,500,200,50,750,1061
2,458,214,115,787,1061
3,415,270,142,827,1061
4,394,296,171,861,1061
5,401,329,184,914,1061
6,410,364,202,976,1061
7,375,400,207,982,1061
8,394,390,244,1028,1061
9,364,398,261,1023,1061
10,385,406,271,1062,1061
11,392,398,301,1091,1061
1,500,200,50,750,1062
2,438,235,102,775,1062
3,422,277,143,842,1062
4,411,292,168,871,1062
5,401,313,186,900,1062
6,419,346,199,964,1062
7,416,362,209,987,1062
8,395,381,226,1002,1062
9,398,399,243,1040,1062
10,403,410,252,1065,1062
11,389,411,279,1079,1062
1,500,200,50,750,1063
2,461,248,77,786,1063
3,460,266,124,850,1063
4,426,285,157,868,1063
5,421,317,172,910,1063
6,408,343,202,953,1063
7,396,363,222,981,1063
8,401,392,222,1015,1063
9,403,391,253,1047,1063
10,411,384,260,1055,1063
11,412,420,249,1081,1063
1,500,200,50,750,1064
2,457,228,100,785,1064
3,425,268,135,828,1064
4,406,273,177,856,1064
5,375,302,210,887,1064
6,413,330,224,967,1064
7,395,332,254,981,1064
8,387,372,237,996,1064
9,396,392,244,1032,1064
10,403,395,254,1052,1064
11,410,393,281,1084,1064
1,500,200,50,750,1065
2,481,226,78,785,1065
3,457,269,119,845,1065
4,415,287,168,870,1065
5,400,324,198,922,1065
6,400,364,204,968,1065
7,394,383,214,991,1065
8,393,384,239,1016,1065
9,380,389,255,1024,1065
10,413,403,257,1073,1065
11,407,386,283,1076,1065
1,500,200,50,750,1066
2,456,216,105,777,1066
3,443,239,144,826,1066
4,421,266,173,860,1066
5,416,320,189,925,1066
6,397,353,205,955,1066
7,410,376,204,990,1066
8,415,361,238,1014,1066
9,393,379,249,1021,1066
10,404,389,263,1056,1066
11,407,418,263,1088,1066
1,500,200,50,750,1067
2,445,251,85,781,1067
3,423,280,121,824,1067
4,418,296,154,868,1067
5,415,329,162,906,1067
6,406,340,190,936,1067
7,415,355,220,990,1067
8,385,373,222,980,1067
9,392,406,230,1028,1067
10,414,412,258,1084,1067
11,387,400,292,1079,1067
1,500,200,50,750,1068
2,454,226,90,770,1068
3,441,271,127,839,1068
4,406,290,175,871,1068
5,392,315,213,920,1068
6,398,325,239,962,1068
7,379,346,247,972,1068
8,387,356,256,999,1068
9,396,381,246,1023,1068
10,381,385,262,1028,1068
11,392,409,269,1070,1068
1,500,200,50,750,1069
2,474,233,87,794,1069
3,435,266,115,816,1069
4,422,315,139,876,1069
5,404,304,187,895,1069
6,413,346,214,973,1069
7,375,369,240,984,1069
8,373,383,250,1006,1069
9,361,392,282,1035,1069
10,354,402,281,1037,1069
11,377,413,294,1084,1069
1,500,200,50,750,1070
2,458,228,109,795,1070
3,437,236,152,825,1070
4,423,256,173,852,1070
5,417,287,199,903,1070
6,394,344,225,963,1070
7,396,357,225,978,1070
8,384,368,251,1003,1070
9,399,385,258,1042,1070
10,370,393,282,1045,1070
11,380,417,283,1080,1070
1,500,200,50,750,1071
2,439,244,107,790,1071
3,406,262,158,826,1071
4,415,306,156,877,1071
5,402,304,203,909,1071
6,395,356,202,953,1071
7,400,372,213,985,1071
8,409,361,241,1011,1071
9,403,373,248,1024,1071
10,403,385,271,1059,1071
11,428,394,278,1100,1071
1,500,200,50,750,1072
2,440,245,91,776,1072
3,417,258,141,816,1072
4,427,275,166,868,1072
5,447,283,197,927,1072
6,439,308,217,964,1072
7,423,325,227,975,1072
8,414,360,230,1004,1072
9,411,385,240,1036,1072
10,391,397,272,1060,1072
11,389,412,285,1086,1072
1,500,200,50,750,1073
2,457,239,84,780,1073
3,413,262,135,810,1073
4,412,297,155,864,1073
5,425,314,175,914,1073
6,423,332,196,951,1073
7,431,338,204,973,1073
8,414,370,218,1002,1073
9,418,389,228,1035,1073
10,406,405,235,1046,1073
11,378,405,278,1061,1073
1,500,200,50,750,1074
2,452,228,109,789,1074
3,444,232,142,818,1074
4,428,260,181,869,1074
5,429,292,188,909,1074
6,432,313,225,970,1074
7,404,344,237,985,1074
8,417,364,241,1022,1074
9,401,402,218,1021,1074
10,425,398,240,1063,1074
11,432,411,245,1088,1074
1,500,200,50,750,1075
2,459,234,99,792,1075
3,416,260,148,824,1075
4,402,283,183,868,1075
5,393,325,199,917,1075
6,411,326,227,964,1075
7,396,354,227,977,1075
8,381,376,244,1001,1075
9,384,379,274,1037,1075
10,393,386,285,1064,1075
11,393,383,298,1074,1075
1,500,200,50,750,1076
2,451,242,91,784,1076
3,424,285,121,830,1076
4,395,282,166,843,1076
5,416,306,206,928,1076
6,401,333,219,953,1076
7,400,352,238,990,1076
8,398,356,253,1007,1076
9,401,362,255,1018,1076
10,414,386,269,1069,1076
11,412,392,273,1077,1076
1,500,200,50,750,1077
2,466,230,97,793,1077
3,422,266,128,816,1077
4,398,291,172,861,1077
5,418,317,180,915,1077
6,421,344,192,957,1077
7,416,351,228,995,1077
8,408,392,229,1029,1077
9,406,388,239,1033,1077
10,429,380,267,1076,1077
11,414,408,266,1088,1077
1,500,200,50,750,1078
2,481,230,88,799,1078
3,436,256,126,818,1078
4,421,304,163,888,1078
5,415,309,183,907,1078
6,423,351,195,969,1078
7,410,348,205,963,1078
8,423,358,235,1016,1078
9,410,374,248,1032,1078
10,386,394,261,1041,1078
11,396,418,286,1100,1078
1,500,200,50,750,1079
2,458,234,92,784,1079
3,429,273,135,837,1079
4,405,304,163,872,1079
5,386,335,195,916,1079
6,374,332,241,947,1079
7,381,350,241,972,1079
8,387,371,251,1009,1079
9,413,367,249,1029,1079
10,438,375,263,1076,1079
11,416,388,286,1090,1079
1,500,200,50,750,1080
2,457,236,100,793,1080
3,409,269,142,820,1080
4,408,288,183,879,1080
5,393,299,200,892,1080
6,393,354,220,967,1080
7,382,362,244,988,1080
8,370,387,244,1001,1080
9,362,402,255,1019,1080
10,373,443,259,1075,1080
11,371,431,280,1082,1080
1,500,200,50,750,1081
2,460,242,86,788,1081
3,441,281,112,834,1081
4,388,315,149,852,1081
5,412,339,181,932,1081
6,406,347,204,957,1081
7,398,373,208,979,1081
8,384,381,234,999,1081
9,391,393,246,1030,1081
10,403,399,249,1051,1081
11,398,395,282,1075,1081
1,500,200,50,750,1082
2,468,220,92,780,1082
3,447,248,134,829,1082
4,432,263,166,861,1082
5,441,304,185,930,1082
6,425,334,209,968,1082
7,413,360,215,988,1082
8,412,366,221,999,1082
9,434,381,233,1048,1082
10,437,380,241,1058,1082
11,455,373,258,1086,1082
1,500,200,50,750,1083
2,458,221,96,775,1083
3,413,248,146,807,1083
4,398,288,166,852,1083
5,386,326,195,907,1083
6,405,362,206,973,1083
7,400,362,224,986,1083
8,378,380,237,995,1083
9,399,381,249,1029,1083
10,403,409,243,1055,1083
11,429,396,281,1106,1083
1,500,200,50,750,1084
2,458,219,100,777,1084
3,448,238,144,830,1084
4,409,295,161,865,1084
5,414,318,176,908,1084
6,396,365,202,963,1084
7,377,365,232,974,1084
8,380,366,260,1006,1084
9,395,398,260,1053,1084
10,395,403,267,1065,1084
11,378,397,297,1072,1084
1,500,200,50,750,1085
2,443,249,100,792,1085
3,414,273,142,829,1085
4,402,303,161,866,1085
5,393,330,194,917,1085
6,366,365,224,955,1085
7,359,365,246,970,1085
8,372,349,276,997,1085
9,411,387,248,1046,1085
10,398,382,277,1057,1085
11,392,406,276,1074,1085
1,500,200,50,750,1086
2,439,245,100,784,1086
3,403,262,160,825,1086
4,391,311,171,873,1086
5,401,303,213,917,1086
6,414,322,226,962,1086
7,394,354,238,986,1086
8,408,378,225,1011,1086
9,409,380,239,1028,1086
10,394,397,242,1033,1086
11,405,409,260,1074,1086
1,500,200,50,750,1087
2,453,249,91,793,1087
3,426,271,138,835,1087
4,420,297,147,864,1087
5,422,322,178,922,1087
6,408,352,207,967,1087
7,399,347,229,975,1087
8,403,355,244,1002,1087
9,430,362,240,1032,1087
10,433,371,250,1054,1087
11,420,396,254,1070,1087
1,500,200,50,750,1088
2,446,229,108,783,1088
3,399,274,137,810,1088
4,399,308,162,869,1088
5,393,316,194,903,1088
6,390,340,213,943,1088
7,403,374,209,986,1088
8,381,383,236,1000,1088
9,392,402,239,1033,1088
10,418,382,260,1060,1088
11,414,391,282,1087,1088
1,500,200,50,750,1089
2,472,238,88,798,1089
3,436,257,133,826,1089
4,395,297,168,860,1089
5,388,337,203,928,1089
6,387,353,215,955,1089
7,384,364,232,980,1089
8,364,377,255,996,1089
9,379,383,275,1037,1089
10,372,392,287,1051,1089
11,381,413,281,1075,1089
1,500,200,50,750,1090
2,463,212,96,771,1090
3,434,249,131,814,1090
4,424,296,154,874,1090
5,396,317,181,894,1090
6,413,337,212,962,1090
7,411,336,234,981,1090
8,402,350,256,1008,1090
9,408,384,254,1046,1090
10,408,367,286,1061,1090
11,408,400,268,1076,1090
1,500,200,50,750,1091
2,466,227,94,787,1091
3,437,264,124,825,1091
4,417,288,163,868,1091
5,401,322,202,925,1091
6,404,342,233,979,1091
7,380,365,244,989,1091
8,369,387,248,1004,1091
9,373,393,263,1029,1091
10,364,392,297,1053,1091
11,373,416,292,1081,1091
1,500,200,50,750,1092
2,457,235,94,786,1092
3,416,274,125,815,1092
4,413,292,151,856,1092
5,443,307,182,932,1092
6,419,334,198,951,1092
7,431,333,229,993,1092
8,410,365,236,1011,1092
9,420,369,239,1028,1092
10,430,384,240,1054,1092
11,419,394,267,1080,1092
1,500,200,50,750,1093
2,477,219,89,785,1093
3,447,253,132,832,1093
4,426,271,166,863,1093
5,429,299,186,914,1093
6,436,323,200,959,1093
7,413,335,238,986,1093
8,412,353,238,1003,1093
9,410,356,262,1028,1093
10,407,377,282,1066,1093
11,401,383,294,1078,1093
1,500,200,50,750,1094
2,445,237,99,781,1094
3,433,255,138,826,1094
4,427,293,157,877,1094
5,406,314,182,902,1094
6,395,364,203,962,1094
7,401,378,213,992,1094
8,383,382,237,1002,1094
9,360,407,257,1024,1094
10,367,418,274,1059,1094
11,364,426,299,1089,1094
1,500,200,50,750,1095
2,454,241,94,789,1095
3,429,262,143,834,1095
4,389,308,158,855,1095
5,395,361,170,926,1095
6,389,368,203,960,1095
7,384,366,214,964,1095
8,397,365,249,1011,1095
9,379,387,258,1024,1095
10,409,395,266,1070,1095
11,394,411,285,1090,1095
1,500,200,50,750,1096
2,454,229,104,787,1096
3,433,259,134,826,1096
4,414,274,172,860,1096
5,428,297,187,912,1096
6,425,342,196,963,1096
7,419,341,223,983,1096
8,416,371,224,1011,1096
9,396,386,245,1027,1096
10,403,401,259,1063,1096
11,439,379,290,1108,1096
1,500,200,50,750,1097
2,453,240,106,799,1097
3,431,260,133,824,1097
4,422,286,148,856,1097
5,430,299,189,918,1097
6,427,310,220,957,1097
7,417,339,227,983,1097
8,385,361,252,998,1097
9,406,385,260,1051,1097
10,397,399,268,1064,1097
11,383,406,284,1073,1097
1,500,200,50,750,1098
2,449,232,107,788,1098
3,429,243,149,821,1098
4,406,264,186,856,1098
5,385,301,216,902,1098
6,381,327,244,952,1098
7,389,339,228,956,1098
8,400,358,243,1001,1098
9,403,386,252,1041,1098
10,405,411,262,1078,1098
11,416,405,271,1092,1098
1,500,200,50,750,1099
2,458,220,109,787,1099
3,426,272,132,830,1099
4,402,307,160,869,1099
5,389,329,182,900,1099
6,393,362,217,972,1099
7,384,375,231,990,1099
8,366,389,246,1001,1099
9,376,403,257,1036,1099
10,392,410,263,1065,1099
11,373,431,269,1073,1099
1,500,200,50,750,1100
2,468,226,107,801,1100
3,446,246,141,833,1100
4,444,261,161,866,1100
5,446,298,180,924,1100
6,429,319,194,942,1100
7,406,352,231,989,1100
8,392,372,237,1001,1100
9,391,387,261,1039,1100
10,400,392,258,1050,1100
11,395,425,253,1073,1100
1,500,200,50,750,1101
2,472,226,93,791,1101
3,457,233,140,830,1101
4,454,269,160,883,1101
5,432,307,175,914,1101
6,421,326,210,957,1101
7,416,336,227,979,1101
8,419,372,214,1005,1101
9,413,373,239,1025,1101
10,406,400,250,1056,1101
11,421,412,252,1085,1101
1,500,200,50,750,1102
2,460,226,100,786,1102
3,455,265,129,849,1102
4,432,275,152,859,1102
5,419,319,184,922,1102
6,406,326,211,943,1102
7,433,333,221,987,1102
8,448,335,233,1016,1102
9,444,350,238,1032,1102
10,426,390,249,1065,1102
11,429,412,252,1093,1102
1,500,200,50,750,1103
2,476,226,86,788,1103
3,432,270,131,833,1103
4,418,281,168,867,1103
5,431,316,186,933,1103
6,411,356,189,956,1103
7,386,375,216,977,1103
8,376,385,232,993,1103
9,410,381,238,1029,1103
10,421,384,267,1072,1103
11,426,398,268,1092,1103
1,500,200,50,750,1104
2,492,225,83,800,1104
3,440,269,111,820,1104
4,399,308,144,851,1104
5,422,317,175,914,1104
6,410,340,212,962,1104
7,396,366,230,992,1104
8,395,387,232,1014,1104
9,384,385,257,1026,1104
10,404,393,257,1054,1104
11,394,398,297,1089,1104
1,500,200,50,750,1105
2,470,221,104,795,1105
3,456,242,136,834,1105
4,445,268,150,863,1105
5,433,300,187,920,1105
6,413,324,209,946,1105
7,396,343,236,975,1105
8,396,368,236,1000,1105
9,395,382,244,1021,1105
10,396,397,258,1051,1105
11,413,394,271,1078,1105
1,500,200,50,750,1106
2,462,237,88,787,1106
3,443,261,117,821,1106
4,427,291,165,883,1106
5,417,295,196,908,1106
6,421,316,211,948,1106
7,404,341,230,975,1106
8,383,356,245,984,1106
9,407,352,275,1034,1106
10,413,369,282,1064,1106
11,412,409,269,1090,1106
1,500,200,50,750,1107
2,442,242,100,784,1107
3,410,282,146,838,1107
4,394,295,186,875,1107
5,388,333,192,913,1107
6,381,349,206,936,1107
7,380,361,229,970,1107
8,394,384,238,1016,1107
9,378,394,266,1038,1107
10,397,382,270,1049,1107
11,406,418,255,1079,1107
1,500,200,50,750,1108
2,463,231,91,785,1108
3,439,238,146,823,1108
4,409,284,163,856,1108
5,397,311,187,895,1108
6,401,313,216,930,1108
7,404,327,231,962,1108
8,409,350,244,1003,1108
9,406,390,243,1039,1108
10,412,384,259,1055,1108
11,422,405,253,1080,1108
1,500,200,50,750,1109
2,458,221,101,780,1109
3,448,241,133,822,1109
4,440,278,146,864,1109
5,427,316,169,912,1109
6,428,345,183,956,1109
7,437,368,199,1004,1109
8,426,367,211,1004,1109
9,416,398,224,1038,1109
10,412,410,237,1059,1109
11,414,419,260,1093,1109
1,500,200,50,750,1110
2,452,231,106,789,1110
3,419,275,141,835,1110
4,394,300,168,862,1110
5,388,325,190,903,1110
6,389,358,199,946,1110
7,374,380,228,982,1110
8,374,381,248,1003,1110
9,377,376,282,1035,1110
10,376,382,291,1049,1110
11,371,405,308,1084,1110
1,500,200,50,750,1111
2,441,241,97,779,1111
3,420,244,143,807,1111
4,409,300,162,871,1111
5,417,324,186,927,1111
6,416,336,219,971,1111
7,418,340,233,991,1111
8,423,335,250,1008,1111
9,396,350,272,1018,1111
10,392,395,277,1064,1111
11,383,395,302,1080,1111
1,500,200,50,750,1112
2,468,221,98,787,1112
3,444,255,135,834,1112
4,418,273,163,854,1112
5,417,307,201,925,1112
6,409,310,224,943,1112
7,413,340,235,988,1112
8,410,347,252,1009,1112
9,416,356,255,1027,1112
10,392,394,269,1055,1112
11,403,386,282,1071,1112
1,500,200,50,750,1113
2,455,241,91,787,1113
3,427,269,134,830,1113
4,412,279,172,863,1113
5,430,313,190,933,1113
6,407,361,204,972,1113
7,394,353,229,976,1113
8,403,365,240,1008,1113
9,397,370,266,1033,1113
10,406,391,275,1072,1113
11,394,409,284,1087,1113
1,500,200,50,750,1114
2,460,226,98,784,1114
3,423,258,129,810,1114
4,423,272,166,861,1114
5,448,309,181,938,1114
6,422,320,204,946,1114
7,400,358,223,981,1114
8,387,378,239,1004,1114
9,379,375,259,1013,1114
10,403,385,282,1070,1114
11,405,406,281,1092,1114
1,500,200,50,750,1115
2,454,245,86,785,1115
3,413,267,130,810,1115
4,409,272,182,863,1115
5,400,297,210,907,1115
6,388,341,220,949,1115
7,401,356,240,997,1115
8,403,373,249,1025,1115
9,399,364,260,1023,1115
10,400,397,253,1050,1115
11,400,433,250,1083,1115
1,500,200,50,750,1116
2,453,244,99,796,1116
3,434,263,129,826,1116
4,404,296,161,861,1116
5,389,319,194,902,1116
6,404,321,212,937,1116
7,404,341,230,975,1116
8,417,345,255,1017,1116
9,392,384,258,1034,1116
10,392,374,288,1054,1116
11,384,402,279,1065,1116
1,500,200,50,750,1117
2,438,243,99,780,1117
3,411,286,131,828,1117
4,408,311,166,885,1117
5,380,329,198,907,1117
6,391,340,224,955,1117
7,397,354,239,990,1117
8,416,356,252,1024,1117
9,412,366,236,1014,1117
10,427,370,259,1056,1117
11,429,386,280,1095,1117
1,500,200,50,750,1118
2,468,217,112,797,1118
3,451,248,134,833,1118
4,421,272,165,858,1118
5,422,305,195,922,1118
6,400,339,195,934,1118
7,438,346,214,998,1118
8,420,351,232,1003,1118
9,432,371,240,1043,1118
10,437,362,276,1075,1118
11,428,390,284,1102,1118
1,500,200,50,750,1119
2,464,231,89,784,1119
3,449,255,122,826,1119
4,441,277,157,875,1119
5,437,304,180,921,1119
6,422,323,205,950,1119
7,449,330,206,985,1119
8,445,360,214,1019,1119
9,411,382,240,1033,1119
10,422,379,253,1054,1119
11,411,380,287,1078,1119
1,500,200,50,750,1120
2,458,235,91,784,1120
3,442,274,120,836,1120
4,430,280,154,864,1120
5,426,308,162,896,1120
6,435,307,197,939,1120
7,422,341,219,982,1120
8,385,384,235,1004,1120
9,386,379,266,1031,1120
10,403,368,273,1044,1120
11,400,379,296,1075,1120
1,500,200,50,750,1121
2,483,235,87,805,1121
3,450,246,131,827,1121
4,432,267,166,865,1121
5,429,294,178,901,1121
6,430,322,195,947,1121
7,421,344,221,986,1121
8,377,378,237,992,1121
9,372,415,243,1030,1121
10,400,404,259,1063,1121
11,396,404,270,1070,1121
1,500,200,50,750,1122
2,453,223,99,775,1122
3,423,253,134,810,1122
4,422,291,161,874,1122
5,409,325,187,921,1122
6,394,350,212,956,1122
7,403,345,217,965,1122
8,409,373,236,1018,1122
9,393,395,247,1035,1122
10,398,408,265,1071,1122
11,385,406,285,1076,1122
1,500,200,50,750,1123
2,437,237,104,778,1123
3,417,263,159,839,1123
4,408,286,171,865,1123
5,416,297,183,896,1123
6,421,327,220,968,1123
7,412,344,219,975,1123
8,415,357,236,1008,1123
9,411,371,244,1026,1123
10,389,393,264,1046,1123
11,405,410,285,1100,1123
1,500,200,50,750,1124
2,443,249,88,780,1124
3,434,284,126,844,1124
4,415,304,148,867,1124
5,402,317,190,909,1124
6,399,333,207,939,1124
7,399,336,248,983,1124
8,393,372,254,1019,1124
9,392,368,271,1031,1124
10,399,405,253,1057,1124
11,410,413,263,1086,1124
1,500,200,50,750,1125
2,475,234,90,799,1125
3,444,270,107,821,1125
4,423,307,138,868,1125
5,397,329,173,899,1125
6,414,347,202,963,1125
7,385,366,217,968,1125
8,397,361,241,999,1125
9,422,358,266,1046,1125
10,426,373,256,1055,1125
11,403,390,279,1072,1125
1,500,200,50,750,1126
2,468,221,97,786,1126
3,435,268,136,839,1126
4,430,288,147,865,1126
5,418,325,168,911,1126
6,418,350,181,949,1126
7,416,347,229,992,1126
8,394,364,256,1014,1126
9,383,380,259,1022,1126
10,421,370,274,1065,1126
11,403,390,292,1085,1126
1,500,200,50,750,1127
2,454,236,99,789,1127
3,432,252,140,824,1127
4,412,301,163,876,1127
5,424,304,203,931,1127
6,413,332,218,963,1127
7,403,359,228,990,1127
8,396,361,250,1007,1127
9,393,373,279,1045,1127
10,401,394,278,1073,1127
11,391,431,278,1100,1127
1,500,200,50,750,1128
2,458,224,95,777,1128
3,429,244,139,812,1128
4,413,270,163,846,1128
5,436,286,203,925,1128
6,432,339,202,973,1128
7,411,361,216,988,1128
8,424,367,239,1030,1128
9,399,366,273,1038,1128
10,393,387,275,1055,1128
11,380,412,296,1088,1128
1,500,200,50,750,1129
2,452,227,113,792,1129
3,433,262,149,844,1129
4,397,275,191,863,1129
5,398,302,208,908,1129
6,397,336,213,946,1129
7,388,357,252,997,1129
8,381,370,255,1006,1129
9,386,390,267,1043,1129
10,391,388,272,1051,1129
11,391,407,288,1086,1129
1,500,200,50,750,1130
2,461,228,100,789,1130
3,443,262,131,836,1130
4,417,273,171,861,1130
5,403,311,182,896,1130
6,412,325,204,941,1130
7,428,359,204,991,1130
8,409,349,231,989,1130
9,409,391,243,1043,1130
10,410,405,249,1064,1130
11,407,428,245,1080,1130
1,500,200,50,750,1131
2,465,219,102,786,1131
3,481,239,127,847,1131
4,451,254,152,857,1131
5,438,284,170,892,1131
6,447,308,201,956,1131
7,420,339,220,979,1131
8,427,351,220,998,1131
9,408,385,223,1016,1131
10,413,398,224,1035,1131
11,428,393,247,1068,1131
1,500,200,50,750,1132
2,479,226,101,806,1132
3,425,256,144,825,1132
4,401,275,184,860,1132
5,416,320,193,929,1132
6,420,353,203,976,1132
7,413,376,197,986,1132
8,379,392,231,1002,1132
9,387,386,255,1028,1132
10,389,398,266,1053,1132
11,390,421,285,1096,1132
1,500,200,50,750,1133
2,451,238,90,779,1133
3,422,271,135,828,1133
4,386,285,194,865,1133
5,370,320,214,904,1133
6,380,354,243,977,1133
7,378,339,255,972,1133
8,386,360,268,1014,1133
9,390,349,290,1029,1133
10,380,367,292,1039,1133
11,388,383,287,1058,1133
1,500,200,50,750,1134
2,467,234,99,800,1134
3,435,253,124,812,1134
4,427,291,160,878,1134
5,411,302,189,902,1134
6,417,310,221,948,1134
7,422,341,212,975,1134
8,415,348,244,1007,1134
9,404,374,250,1028,1134
10,399,381,260,1040,1134
11,404,410,274,1088,1134
1,500,200,50,750,1135
2,454,242,87,783,1135
3,428,266,120,814,1135
4,414,316,144,874,1135
5,399,325,187,911,1135
6,407,336,212,955,1135
7,405,341,237,983,1135
8,424,343,229,996,1135
9,421,367,250,1038,1135
10,421,372,267,1060,1135
11,418,384,278,1080,1135
1,500,200,50,750,1136
2,461,224,93,778,1136
3,437,248,128,813,1136
4,422,285,148,855,1136
5,429,319,177,925,1136
6,419,345,190,954,1136
7,412,352,214,978,1136
8,403,370,229,1002,1136
9,406,388,245,1039,1136
10,411,367,267,1045,1136
11,423,397,275,1095,1136
1,500,200,50,750,1137
2,447,235,92,774,1137
3,430,265,133,828,1137
4,400,305,170,875,1137
5,396,322,197,915,1137
6,393,327,226,946,1137
7,387,355,234,976,1137
8,374,388,251,1013,1137
9,366,387,272,1025,1137
10,385,396,279,1060,1137
11,398,422,275,1095,1137
1,500,200,50,750,1138
2,442,245,102,789,1138
3,409,266,141,816,1138
4,374,315,169,858,1138
5,400,342,186,928,1138
6,392,354,207,953,1138
7,370,383,227,980,1138
8,414,381,237,1032,1138
9,395,392,246,1033,1138
10,400,408,250,1058,1138
11,406,440,245,1091,1138
1,500,200,50,750,1139
2,478,231,90,799,1139
3,447,253,130,830,1139
4,437,262,166,865,1139
5,445,296,180,921,1139
6,439,342,187,968,1139
7,414,366,195,975,1139
8,414,384,203,1001,1139
9,405,393,224,1022,1139
10,411,381,276,1068,1139
11,399,398,284,1081,1139
1,500,200,50,750,1140
2,456,230,97,783,1140
3,424,250,148,822,1140
4,391,289,179,859,1140
5,386,310,200,896,1140
6,415,345,196,956,1140
7,424,358,204,986,1140
8,399,371,231,1001,1140
9,398,393,246,1037,1140
10,385,414,268,1067,1140
11,393,426,267,1086,1140
1,500,200,50,750,1141
2,451,215,114,780,1141
3,433,253,134,820,1141
4,428,280,163,871,1141
5,411,305,202,918,1141
6,418,320,231,969,1141
7,399,348,249,996,1141
8,397,378,245,1020,1141
9,385,386,258,1029,1141
10,382,389,285,1056,1141
11,377,424,287,1088,1141
1,500,200,50,750,1142
2,463,234,99,796,1142
3,444,239,136,819,1142
4,436,264,171,871,1142
5,413,325,175,913,1142
6,422,342,203,967,1142
7,388,363,225,976,1142
8,379,396,231,1006,1142
9,374,394,252,1020,1142
10,391,418,250,1059,1142
11,381,411,286,1078,1142
1,500,200,50,750,1143
2,464,239,87,790,1143
3,461,257,122,840,1143
4,442,265,149,856,1143
5,433,289,188,910,1143
6,417,320,204,941,1143
7,395,363,213,971,1143
8,374,365,250,989,1143
9,370,378,265,1013,1143
10,399,377,278,1054,1143
11,403,392,281,1076,1143
1,500,200,50,750,1144
2,459,235,89,783,1144
3,429,271,128,828,1144
4,419,291,162,872,1144
5,379,299,210,888,1144
6,390,338,210,938,1144
7,383,348,251,982,1144
8,369,399,221,989,1144
9,396,419,217,1032,1144
10,395,407,247,1049,1144
11,399,425,245,1069,1144
1,500,200,50,750,1145
2,454,240,108,802,1145
3,425,261,134,820,1145
4,397,284,171,852,1145
5,438,309,174,921,1145
6,434,356,179,969,1145
7,404,350,213,967,1145
8,407,362,231,1000,1145
9,397,386,239,1022,1145
10,409,400,253,1062,1145
11,410,410,264,1084,1145
1,500,200,50,750,1146
2,467,222,107,796,1146
3,441,253,131,825,1146
4,429,286,158,873,1146
5,403,315,190,908,1146
6,397,347,210,954,1146
7,382,365,221,968,1146
8,403,355,261,1019,1146
9,405,359,264,1028,1146
10,396,395,260,1051,1146
11,423,386,290,1099,1146
1,500,200,50,750,1147
2,445,234,112,791,1147
3,431,260,152,843,1147
4,414,271,176,861,1147
5,414,304,196,914,1147
6,426,315,223,964,1147
7,425,352,216,993,1147
8,420,362,228,1010,1147
9,402,393,248,1043,1147
10,394,388,259,1041,1147
11,407,392,276,1075,1147
1,500,200,50,750,1148
2,468,240,100,808,1148
3,428,253,153,834,1148
4,402,283,171,856,1148
5,411,313,184,908,1148
6,394,345,205,944,1148
7,407,361,223,991,1148
8,402,368,236,1006,1148
9,391,378,269,1038,1148
10,392,400,263,1055,1148
11,395,388,296,1079,1148
1,500,200,50,750,1149
2,441,239,105,785,1149
3,428,275,134,837,1149
4,425,278,176,879,1149
5,423,301,187,911,1149
6,423,325,208,956,1149
7,418,349,214,981,1149
8,418,373,229,1020,1149
9,406,388,225,1019,1149
10,423,388,246,1057,1149
11,414,399,277,1090,1149
1,500,200,50,750,1150
2,443,238,94,775,1150
3,428,273,144,845,1150
4,402,294,178,874,1150
5,389,337,203,929,1150
6,404,342,222,968,1150
7,382,365,228,975,1150
8,400,379,236,1015,1150
9,378,399,253,1030,1150
10,392,391,274,1057,1150
11,399,402,282,1083,1150
1,500,200,50,750,1151
2,478,207,100,785,1151
3,445,252,121,818,1151
4,442,259,165,866,1151
5,426,269,207,902,1151
6,447,316,204,967,1151
7,435,348,201,984,1151
8,404,370,223,997,1151
9,404,387,240,1031,1151
10,407,399,245,1051,1151
11,423,410,254,1087,1151
1,500,200,50,750,1152
2,462,226,103,791,1152
3,434,258,139,831,1152
4,400,293,165,858,1152
5,408,308,187,903,1152
6,412,337,188,937,1152
7,414,351,219,984,1152
8,389,368,227,984,1152
9,417,371,238,1026,1152
10,419,384,257,1060,1152
11,409,397,276,1082,1152
1,500,200,50,750,1153
2,452,229,106,787,1153
3,437,256,136,829,1153
4,432,271,166,869,1153
5,412,307,198,917,1153
6,397,342,219,958,1153
7,357,371,238,966,1153
8,347,406,249,1002,1153
9,361,431,233,1025,1153
10,357,421,268,1046,1153
11,379,436,266,1081,1153
1,500,200,50,750,1154
2,455,228,101,784,1154
3,434,259,134,827,1154
4,423,282,174,879,1154
5,405,312,194,911,1154
6,405,345,218,968,1154
7,382,354,243,979,1154
8,366,373,253,992,1154
9,357,400,262,1019,1154
10,361,410,274,1045,1154
11,380,422,272,1074,1154
1,500,200,50,750,1155
2,465,241,94,800,1155
3,422,273,133,828,1155
4,401,290,173,864,1155
5,377,321,201,899,1155
6,387,352,212,951,1155
7,386,344,238,968,1155
8,381,385,236,1002,1155
9,372,402,250,1024,1155
10,358,416,268,1042,1155
11,392,410,284,1086,1155
1,500,200,50,750,1156
2,473,242,90,805,1156
3,429,257,137,823,1156
4,433,265,175,873,1156
5,408,302,192,902,1156
6,414,326,215,955,1156
7,391,348,223,962,1156
8,413,368,229,1010,1156
9,408,380,252,1040,1156
10,413,366,281,1060,1156
11,435,403,283,1121,1156
1,500,200,50,750,1157
2,445,257,87,789,1157
3,404,273,147,824,1157
4,382,319,164,865,1157
5,380,351,173,904,1157
6,408,345,189,942,1157
7,404,354,219,977,1157
8,402,371,241,1014,1157
9,388,378,264,1030,1157
10,389,396,273,1058,1157
11,402,403,283,1088,1157
1,500,200,50,750,1158
2,449,228,101,778,1158
3,416,255,141,812,1158
4,421,275,167,863,1158
5,389,306,206,901,1158
6,380,344,211,935,1158
7,393,368,224,985,1158
8,399,359,253,1011,1158
9,371,395,258,1024,1158
10,390,408,260,1058,1158
11,410,404,264,1078,1158
1,500,200,50,750,1159
2,453,230,97,780,1159
3,443,258,132,833,1159
4,418,274,174,866,1159
5,422,317,184,923,1159
6,423,342,215,980,1159
7,396,358,233,987,1159
8,384,368,248,1000,1159
9,401,372,270,1043,1159
10,390,388,270,1048,1159
11,404,395,302,1101,1159
1,500,200,50,750,1160
2,460,253,89,802,1160
3,440,267,122,829,1160
4,426,290,164,880,1160
5,412,302,201,915,1160
6,383,348,217,948,1160
7,389,344,241,974,1160
8,403,350,261,1014,1160
9,395,356,285,1036,1160
10,390,380,279,1049,1160
11,403,402,270,1075,1160
1,500,200,50,750,1161
2,444,243,97,784,1161
3,415,277,131,823,1161
4,415,277,179,871,1161
5,429,287,198,914,1161
6,426,303,205,934,1161
7,425,361,197,983,1161
8,430,335,231,996,1161
9,407,386,231,1024,1161
10,417,396,256,1069,1161
11,393,428,241,1062,1161
1,500,200,50,750,1162
2,454,234,98,786,1162
3,422,270,137,829,1162
4,416,305,160,881,1162
5,400,334,188,922,1162
6,388,354,222,964,1162
7,387,366,233,986,1162
8,406,373,232,1011,1162
9,385,403,243,1031,1162
10,417,414,228,1059,1162
11,400,433,253,1086,1162
1,500,200,50,750,1163
2,456,228,93,777,1163
3,427,275,139,841,1163
4,402,306,149,857,1163
5,414,335,177,926,1163
6,402,332,209,943,1163
7,416,355,223,994,1163
8,386,373,240,999,1163
9,384,400,240,1024,1163
10,385,395,270,1050,1163
11,397,395,283,1075,1163
1,500,200,50,750,1164
2,454,236,90,780,1164
3,427,281,125,833,1164
4,404,319,146,869,1164
5,411,318,181,910,1164
6,404,340,207,951,1164
7,413,342,230,985,1164
8,383,377,238,998,1164
9,371,381,262,1014,1164
10,390,397,271,1058,1164
11,395,417,275,1087,1164
1,500,200,50,750,1165
2,456,224,99,779,1165
3,427,257,140,824,1165
4,414,293,174,881,1165
5,407,317,195,919,1165
6,415,324,215,954,1165
7,409,357,222,988,1165
8,395,349,260,1004,1165
9,411,379,241,1031,1165
10,397,408,259,1064,1165
11,414,409,269,1092,1165
1,500,200,50,750,1166
2,462,231,95,788,1166
3,460,265,127,852,1166
4,426,271,157,854,1166
5,411,322,177,910,1166
6,406,363,185,954,1166
7,391,382,209,982,1166
8,396,390,222,1008,1166
9,396,387,254,1037,1166
10,408,371,279,1058,1166
11,408,400,274,1082,1166
1,500,200,50,750,1167
2,458,233,97,788,1167
3,445,254,121,820,1167
4,426,287,159,872,1167
5,428,292,188,908,1167
6,449,313,221,983,1167
7,413,343,217,973,1167
8,420,351,235,1006,1167
9,431,376,231,1038,1167
10,404,402,259,1065,1167
11,422,394,270,1086,1167
1,500,200,50,750,1168
2,456,245,89,790,1168
3,423,271,135,829,1168
4,405,296,161,862,1168
5,391,320,197,908,1168
6,406,344,203,953,1168
7,389,365,219,973,1168
8,394,380,234,1008,1168
9,404,389,243,1036,1168
10,422,388,239,1049,1168
11,416,427,248,1091,1168
1,500,200,50,750,1169
2,463,219,103,785,1169
3,444,234,151,829,1169
4,433,280,165,878,1169
5,419,288,194,901,1169
6,419,324,215,958,1169
7,413,347,231,991,1169
8,399,343,245,987,1169
9,423,345,260,1028,1169
10,413,372,266,1051,1169
11,434,393,258,1085,1169
1,500,200,50,750,1170
2,448,251,98,797,1170
3,388,277,149,814,1170
4,395,301,161,857,1170
5,394,327,185,906,1170
6,429,337,213,979,1170
7,412,359,212,983,1170
8,391,400,215,1006,1170
9,388,402,242,1032,1170
10,388,391,269,1048,1170
11,402,397,278,1077,1170
1,500,200,50,750,1171
2,456,239,99,794,1171
3,424,263,137,824,1171
4,381,292,186,859,1171
5,380,330,207,917,1171
6,388,348,229,965,1171
7,366,378,230,974,1171
8,371,401,243,1015,1171
9,357,404,254,1015,1171
10,340,404,288,1032,1171
11,380,436,280,1096,1171
1,500,200,50,750,1172
2,442,234,107,783,1172
3,421,270,138,829,1172
4,405,298,173,876,1172
5,388,311,207,906,1172
6,373,337,239,949,1172
7,374,353,255,982,1172
8,376,380,250,1006,1172
9,357,400,256,1013,1172
10,372,385,291,1048,1172
11,388,416,291,1095,1172
1,500,200,50,750,1173
2,460,211,115,786,1173
3,445,243,145,833,1173
4,412,287,169,868,1173
5,406,311,201,918,1173
6,388,345,219,952,1173
7,393,343,244,980,1173
8,403,366,243,1012,1173
9,392,386,267,1045,1173
10,368,405,275,1048,1173
11,375,407,302,1084,1173
1,500,200,50,750,1174
2,454,255,81,790,1174
3,431,279,122,832,1174
4,428,295,157,880,1174
5,415,301,192,908,1174
6,422,323,218,963,1174
7,400,354,221,975,1174
8,398,371,246,1015,1174
9,397,375,252,1024,1174
10,419,398,251,1068,1174
11,418,416,254,1088,1174
1,500,200,50,750,1175
2,456,235,96,787,1175
3,428,258,126,812,1175
4,431,284,161,876,1175
5,426,301,181,908,1175
6,419,332,193,944,1175
7,414,351,220,985,1175
8,399,378,233,1010,1175
9,416,393,253,1062,1175
10,393,403,258,1054,1175
11,415,411,251,1077,1175
1,500,200,50,750,1176
2,453,242,85,780,1176
3,411,276,139,826,1176
4,408,265,196,869,1176
5,395,331,188,914,1176
6,387,351,206,944,1176
7,409,379,214,1002,1176
8,386,387,234,1007,1176
9,369,432,231,1032,1176
10,380,410,262,1052,1176
11,405,400,277,1082,1176
1,500,200,50,750,1177
2,423,255,95,773,1177
3,409,288,129,826,1177
4,406,295,169,870,1177
5,394,324,191,909,1177
6,383,340,219,942,1177
7,395,364,223,982,1177
8,378,376,249,1003,1177
9,379,399,248,1026,1177
10,394,396,269,1059,1177
11,386,413,270,1069,1177
1,500,200,50,750,1178
2,444,225,103,772,1178
3,435,256,147,838,1178
4,417,277,166,860,1178
5,412,305,192,909,1178
6,393,310,234,937,1178
7,391,340,255,986,1178
8,375,358,254,987,1178
9,366,367,279,1012,1178
10,396,356,281,1033,1178
11,398,416,278,1092,1178
1,500,200,50,750,1179
2,452,238,107,797,1179
3,417,266,140,823,1179
4,410,281,177,868,1179
5,381,319,213,913,1179
6,403,340,222,965,1179
7,399,357,231,987,1179
8,372,374,257,1003,1179
9,375,402,249,1026,1179
10,400,410,254,1064,1179
11,426,405,262,1093,1179
1,500,200,50,750,1180
2,466,234,86,786,1180
3,446,256,128,830,1180
4,441,283,156,880,1180
5,420,310,173,903,1180
6,409,331,199,939,1180
7,420,338,229,987,1180
8,402,336,252,990,1180
9,403,379,264,1046,1180
10,378,419,257,1054,1180
11,387,446,264,1097,1180
1,500,200,50,750,1181
2,463,229,102,794,1181
3,417,266,139,822,1181
4,414,294,172,880,1181
5,416,304,191,911,1181
6,424,313,207,944,1181
7,417,340,222,979,1181
8,426,357,224,1007,1181
9,428,369,226,1023,1181
10,448,386,240,1074,1181
11,432,399,256,1087,1181
1,500,200,50,750,1182
2,465,239,90,794,1182
3,432,267,131,830,1182
4,414,282,190,886,1182
5,394,291,220,905,1182
6,388,333,224,945,1182
7,392,346,236,974,1182
8,405,375,232,1012,1182
9,397,398,244,1039,1182
10,398,406,249,1053,1182
11,417,430,263,1110,1182
1,500,200,50,750,1183
2,455,235,88,778,1183
3,439,260,140,839,1183
4,407,289,166,862,1183
5,390,312,203,905,1183
6,379,339,238,956,1183
7,373,362,259,994,1183
8,373,383,250,1006,1183
9,385,394,272,1051,1183
10,384,412,261,1057,1183
11,399,404,267,1070,1183
1,500,200,50,750,1184
2,464,225,89,778,1184
3,454,246,122,822,1184
4,454,272,154,880,1184
5,431,296,187,914,1184
6,410,323,219,952,1184
7,401,359,215,975,1184
8,407,359,242,1008,1184
9,386,388,249,1023,1184
10,404,404,248,1056,1184
11,416,419,249,1084,1184
1,500,200,50,750,1185
2,448,257,76,781,1185
3,447,277,100,824,1185
4,423,289,147,859,1185
5,441,296,195,932,1185
6,420,320,217,957,1185
7,406,347,226,979,1185
8,409,367,230,1006,1185
9,424,361,251,1036,1185
10,419,392,233,1044,1185
11,411,427,255,1093,1185
1,500,200,50,750,1186
2,469,243,88,800,1186
3,456,255,126,837,1186
4,434,283,157,874,1186
5,431,299,176,906,1186
6,427,330,200,957,1186
7,439,339,211,989,1186
8,416,358,239,1013,1186
9,418,387,235,1040,1186
10,412,407,245,1064,1186
11,399,419,274,1092,1186
1,500,200,50,750,1187
2,456,245,88,789,1187
3,450,244,123,817,1187
4,432,273,176,881,1187
5,414,294,201,909,1187
6,412,320,229,961,1187
7,408,328,257,993,1187
8,409,346,250,1005,1187
9,410,369,246,1025,1187
10,415,391,259,1065,1187
11,439,391,278,1108,1187
1,500,200,50,750,1188
2,448,230,108,786,1188
3,423,261,140,824,1188
4,418,281,172,871,1188
5,419,297,190,906,1188
6,420,315,224,959,1188
7,410,341,234,985,1188
8,394,356,253,1003,1188
9,395,375,263,1033,1188
10,394,413,266,1073,1188
11,388,431,251,1070,1188
1,500,200,50,750,1189
2,431,248,102,781,1189
3,402,254,147,803,1189
4,410,278,174,862,1189
5,408,307,205,920,1189
6,399,339,213,951,1189
7,405,343,238,986,1189
8,405,368,241,1014,1189
9,399,381,244,1024,1189
10,396,401,254,1051,1189
11,398,413,257,1068,1189
1,500,200,50,750,1190
2,458,249,85,792,1190
3,428,277,115,820,1190
4,412,306,145,863,1190
5,398,335,184,917,1190
6,403,369,188,960,1190
7,403,363,197,963,1190
8,395,372,242,1009,1190
9,402,376,248,1026,1190
10,413,387,277,1077,1190
11,403,400,278,1081,1190
1,500,200,50,750,1191
2,468,230,93,791,1191
3,479,243,123,845,1191
4,450,271,156,877,1191
5,423,277,203,903,1191
6,425,313,208,946,1191
7,429,341,225,995,1191
8,404,370,231,1005,1191
9,411,399,233,1043,1191
10,398,382,270,1050,1191
11,399,393,270,1062,1191
1,500,200,50,750,1192
2,464,216,101,781,1192
3,444,244,147,835,1192
4,415,278,179,872,1192
5,417,311,183,911,1192
6,417,333,205,955,1192
7,402,349,226,977,1192
8,410,360,251,1021,1192
9,418,353,256,1027,1192
10,407,354,278,1039,1192
11,400,379,277,1056,1192
1,500,200,50,750,1193
2,458,236,95,789,1193
3,416,263,145,824,1193
4,437,283,162,882,1193
5,439,277,183,899,1193
6,425,301,213,939,1193
7,410,346,232,988,1193
8,389,380,235,1004,1193
9,385,387,256,1028,1193
10,391,401,261,1053,1193
11,404,419,250,1073,1193
1,500,200,50,750,1194
2,450,235,99,784,1194
3,409,280,127,816,1194
4,425,288,158,871,1194
5,418,318,172,908,1194
6,413,346,186,945,1194
7,417,350,205,972,1194
8,416,346,241,1003,1194
9,406,392,241,1039,1194
10,410,389,241,1040,1194
11,404,399,270,1073,1194
1,500,200,50,750,1195
2,445,223,102,770,1195
3,432,264,131,827,1195
4,405,281,165,851,1195
5,403,328,188,919,1195
6,410,348,200,958,1195
7,402,357,214,973,1195
8,396,360,249,1005,1195
9,398,377,253,1028,1195
10,382,379,269,1030,1195
11,415,413,272,1100,1195
1,500,200,50,750,1196
2,453,248,85,786,1196
3,432,275,123,830,1196
4,418,291,145,854,1196
5,408,325,167,900,1196
6,402,354,193,949,1196
7,409,362,211,982,1196
8,402,378,225,1005,1196
9,420,377,240,1037,1196
10,406,383,271,1060,1196
11,396,391,285,1072,1196
1,500,200,50,750,1197
2,452,236,93,781,1197
3,424,294,124,842,1197
4,409,289,176,874,1197
5,387,322,196,905,1197
6,385,361,205,951,1197
7,404,373,213,990,1197
8,399,385,237,1021,1197
9,408,396,240,1044,1197
10,404,389,259,1052,1197
11,396,388,302,1086,1197
1,500,200,50,750,1198
2,465,233,97,795,1198
3,426,267,131,824,1198
4,433,292,149,874,1198
5,415,319,185,919,1198
6,410,328,210,948,1198
7,419,340,225,984,1198
8,408,366,229,1003,1198
9,409,380,252,1041,1198
10,401,389,266,1056,1198
11,412,387,278,1077,1198
1,500,200,50,750,1199
2,458,224,90,772,1199
3,422,254,144,820,1199
4,419,309,153,881,1199
5,407,329,186,922,1199
6,419,332,193,944,1199
7,391,335,232,958,1199
8,402,376,225,1003,1199
9,417,373,239,1029,1199
10,416,393,264,1073,1199
11,404,403,278,1085,1199
1,500,200,50,750,1200
2,469,228,93,790,1200
3,439,245,141,825,1200
4,417,271,174,862,1200
5,406,312,195,913,1200
6,389,349,205,943,1200
7,387,387,209,983,1200
8,389,384,227,1000,1200
9,389,374,257,1020,1200
10,410,387,263,1060,1200
11,417,418,259,1094,1200
1,500,200,50,750,1201
2,446,258,87,791,1201
3,429,274,120,823,1201
4,412,303,159,874,1201
5,411,302,207,920,1201
6,396,348,220,964,1201
7,401,345,242,988,1201
8,373,388,242,1003,1201
9,370,414,231,1015,1201
10,370,416,278,1064,1201
11,385,403,297,1085,1201
1,500,200,50,750,1202
2,472,228,76,776,1202
3,439,250,139,828,1202
4,419,279,167,865,1202
5,416,304,197,917,1202
6,406,336,205,947,1202
7,407,349,227,983,1202
8,399,356,248,1003,1202
9,403,378,237,1018,1202
10,400,391,257,1048,1202
11,424,406,244,1074,1202
1,500,200,50,750,1203
2,459,219,98,776,1203
3,445,259,123,827,1203
4,430,293,148,871,1203
5,438,319,172,929,1203
6,406,353,193,952,1203
7,400,371,216,987,1203
8,385,381,241,1007,1203
9,361,390,263,1014,1203
10,396,395,273,1064,1203
11,388,409,284,1081,1203
1,500,200,50,750,1204
2,439,259,91,789,1204
3,398,301,131,830,1204
4,394,304,165,863,1204
5,374,317,206,897,1204
6,385,336,243,964,1204
7,386,357,243,986,1204
8,391,378,244,1013,1204
9,393,377,266,1036,1204
10,386,397,269,1052,1204
11,382,393,302,1077,1204
1,500,200,50,750,1205
2,459,222,88,769,1205
3,451,260,117,828,1205
4,427,267,165,859,1205
5,430,293,187,910,1205
6,422,323,224,969,1205
7,427,333,224,984,1205
8,432,333,248,1013,1205
9,406,385,242,1033,1205
10,413,394,264,1071,1205
11,397,394,285,1076,1205
1,500,200,50,750,1206
2,464,214,106,784,1206
3,431,263,138,832,1206
4,418,289,163,870,1206
5,405,321,185,911,1206
6,402,337,220,959,1206
7,384,341,249,974,1206
8,395,349,264,1008,1206
9,382,375,268,1025,1206
10,394,382,275,1051,1206
11,397,401,291,1089,1206
1,500,200,50,750,1207
2,455,231,103,789,1207
3,410,270,140,820,1207
4,415,294,170,879,1207
5,381,324,205,910,1207
6,377,349,223,949,1207
7,375,351,262,988,1207
8,361,376,263,1000,1207
9,361,386,275,1022,1207
10,371,409,259,1039,1207
11,401,430,259,1090,1207
1,500,200,50,750,1208
2,452,246,95,793,1208
3,429,273,130,832,1208
4,402,288,168,858,1208
5,401,307,203,911,1208
6,391,339,223,953,1208
7,396,349,239,984,1208
8,389,371,239,999,1208
9,388,359,259,1006,1208
10,410,393,268,1071,1208
11,419,397,269,1085,1208
1,500,200,50,750,1209
2,440,234,112,786,1209
3,424,263,144,831,1209
4,415,283,165,863,1209
5,408,309,180,897,1209
6,427,336,221,984,1209
7,402,332,246,980,1209
8,430,321,259,1010,1209
9,411,354,268,1033,1209
10,403,387,267,1057,1209
11,406,416,260,1082,1209
1,500,200,50,750,1210
2,455,230,104,789,1210
3,430,255,133,818,1210
4,416,282,165,863,1210
5,441,315,176,932,1210
6,425,328,207,960,1210
7,408,345,230,983,1210
8,388,377,229,994,1210
9,365,399,270,1034,1210
10,348,404,286,1038,1210
11,388,395,312,1095,1210
1,500,200,50,750,1211
2,462,228,102,792,1211
3,446,257,127,830,1211
4,434,284,158,876,1211
5,423,302,188,913,1211
6,424,327,211,962,1211
7,400,335,231,966,1211
8,433,358,233,1024,1211
9,430,375,230,1035,1211
10,416,367,258,1041,1211
11,407,407,270,1084,1211
1,500,200,50,750,1212
2,473,230,105,808,1212
3,432,257,141,830,1212
4,408,275,178,861,1212
5,422,307,197,926,1212
6,419,322,204,945,1212
7,401,355,222,978,1212
8,406,369,236,1011,1212
9,384,396,248,1028,1212
10,395,411,251,1057,1212
11,401,422,265,1088,1212
1,500,200,50,750,1213
2,466,236,95,797,1213
3,428,267,134,829,1213
4,410,286,169,865,1213
5,394,307,208,909,1213
6,393,344,215,952,1213
7,397,345,247,989,1213
8,416,363,246,1025,1213
9,386,388,263,1037,1213
10,403,391,260,1054,1213
11,421,411,266,1098,1213
1,500,200,50,750,1214
2,459,248,86,793,1214
3,427,268,127,822,1214
4,422,290,144,856,1214
5,409,328,172,909,1214
6,402,368,186,956,1214
7,379,372,207,958,1214
8,375,402,228,1005,1214
9,375,398,248,1021,1214
10,371,423,245,1039,1214
11,388,430,270,1088,1214
1,500,200,50,750,1215
2,460,220,98,778,1215
3,432,238,150,820,1215
4,408,261,183,852,1215
5,425,321,191,937,1215
6,416,336,209,961,1215
7,393,359,238,990,1215
8,375,371,269,1015,1215
9,390,376,267,1033,1215
10,385,394,272,1051,1215
11,394,409,277,1080,1215
1,500,200,50,750,1216
2,470,229,102,801,1216
3,430,243,146,819,1216
4,427,268,178,873,1216
5,412,302,203,917,1216
6,385,346,226,957,1216
7,392,357,237,986,1216
8,375,378,255,1008,1216
9,369,380,283,1032,1216
10,377,406,278,1061,1216
11,387,402,286,1075,1216
1,500,200,50,750,1217
2,449,232,117,798,1217
3,406,261,152,819,1217
4,394,290,174,858,1217
5,394,328,188,910,1217
6,387,351,215,953,1217
7,392,356,242,990,1217
8,393,361,252,1006,1217
9,383,384,270,1037,1217
10,391,384,273,1048,1217
11,402,416,267,1085,1217
1,500,200,50,750,1218
2,474,217,106,797,1218
3,452,236,137,825,1218
4,436,280,164,880,1218
5,424,314,175,913,1218
6,405,347,205,957,1218
7,391,378,230,999,1218
8,377,380,261,1018,1218
9,367,396,257,1020,1218
10,383,381,297,1061,1218
11,391,400,298,1089,1218
1,500,200,50,750,1219
2,461,240,104,805,1219
3,436,250,141,827,1219
4,417,279,167,863,1219
5,418,290,210,918,1219
6,421,317,212,950,1219
7,416,332,241,989,1219
8,406,339,264,1009,1219
9,395,365,259,1019,1219
10,394,396,269,1059,1219
11,397,420,263,1080,1219
1,500,200,50,750,1220
2,464,216,113,793,1220
3,436,239,146,821,1220
4,422,263,169,854,1220
5,415,297,200,912,1220
6,406,326,218,950,1220
7,390,359,210,959,1220
8,390,369,218,977,1220
9,385,383,239,1007,1220
10,417,411,254,1082,1220
11,402,412,261,1075,1220
1,500,200,50,750,1221
2,466,229,95,790,1221
3,427,272,129,828,1221
4,431,283,163,877,1221
5,416,273,218,907,1221
6,392,318,240,950,1221
7,389,352,253,994,1221
8,378,383,245,1006,1221
9,355,398,257,1010,1221
10,354,435,259,1048,1221
11,395,408,277,1080,1221
1,500,200,50,750,1222
2,456,242,97,795,1222
3,411,267,141,819,1222
4,406,301,167,874,1222
5,403,307,207,917,1222
6,375,334,234,943,1222
7,400,357,234,991,1222
8,388,376,240,1004,1222
9,390,399,242,1031,1222
10,386,402,261,1049,1222
11,408,396,283,1087,1222
1,500,200,50,750,1223
2,470,241,80,791,1223
3,460,268,110,838,1223
4,453,269,151,873,1223
5,452,271,185,908,1223
6,441,313,205,959,1223
7,428,334,221,983,1223
8,429,357,224,1010,1223
9,419,373,233,1025,1223
10,417,405,251,1073,1223
11,410,410,249,1069,1223
1,500,200,50,750,1224
2,446,260,88,794,1224
3,415,283,125,823,1224
4,404,315,162,881,1224
5,381,323,197,901,1224
6,391,334,235,960,1224
7,379,363,237,979,1224
8,392,379,248,1019,1224
9,395,406,239,1040,1224
10,396,422,245,1063,1224
11,379,426,274,1079,1224
1,500,200,50,750,1225
2,443,237,102,782,1225
3,416,273,141,830,1225
4,404,288,177,869,1225
5,392,320,200,912,1225
6,391,367,206,964,1225
7,356,374,251,981,1225
8,380,363,261,1004,1225
9,375,380,259,1014,1225
10,394,377,272,1043,1225
11,429,396,278,1103,1225
1,500,200,50,750,1226
2,461,244,98,803,1226
3,422,270,128,820,1226
4,408,296,164,868,1226
5,416,315,198,929,1226
6,407,323,233,963,1226
7,415,339,233,987,1226
8,369,382,252,1003,1226
9,383,375,266,1024,1226
10,389,390,280,1059,1226
11,400,411,273,1084,1226
1,500,200,50,750,1227
2,462,226,114,802,1227
3,424,253,150,827,1227
4,399,283,185,867,1227
5,404,317,202,923,1227
6,397,336,226,959,1227
7,380,345,241,966,1227
8,402,359,259,1020,1227
9,403,387,245,1035,1227
10,401,400,261,1062,1227
11,404,414,278,1096,1227
1,500,200,50,750,1228
2,468,203,108,779,1228
3,440,223,147,810,1228
4,432,257,178,867,1228
5,424,305,193,922,1228
6,412,328,210,950,1228
7,396,339,241,976,1228
8,392,394,220,1006,1228
9,375,395,254,1024,1228
10,350,417,250,1017,1228
11,387,408,285,1080,1228
1,500,200,50,750,1229
2,441,233,102,776,1229
3,407,270,149,826,1229
4,414,294,153,861,1229
5,425,316,180,921,1229
6,414,348,189,951,1229
7,409,369,208,986,1229
8,394,364,238,996,1229
9,385,400,230,1015,1229
10,406,392,255,1053,1229
11,419,374,295,1088,1229
1,500,200,50,750,1230
2,461,231,94,786,1230
3,428,274,135,837,1230
4,407,288,181,876,1230
5,406,308,201,915,1230
6,416,343,197,956,1230
7,388,366,218,972,1230
8,376,378,241,995,1230
9,399,383,254,1036,1230
10,420,371,269,1060,1230
11,417,392,282,1091,1230
1,500,200,50,750,1231
2,481,227,88,796,1231
3,447,247,122,816,1231
4,459,268,148,875,1231
5,435,288,180,903,1231
6,419,332,194,945,1231
7,421,360,207,988,1231
8,428,357,221,1006,1231
9,421,386,229,1036,1231
10,389,417,249,1055,1231
11,391,434,255,1080,1231
1,500,200,50,750,1232
2,463,220,107,790,1232
3,424,258,149,831,1232
4,403,284,185,872,1232
5,395,299,205,899,1232
6,404,318,217,939,1232
7,410,326,242,978,1232
8,403,358,249,1010,1232
9,398,376,256,1030,1232
10,399,400,255,1054,1232
11,397,404,276,1077,1232
1,500,200,50,750,1233
2,449,239,86,774,1233
3,436,261,132,829,1233
4,402,309,152,863,1233
5,399,325,170,894,1233
6,425,356,196,977,1233
7,410,373,211,994,1233
8,407,390,207,1004,1233
9,396,403,246,1045,1233
10,369,416,255,1040,1233
11,363,429,272,1064,1233
1,500,200,50,750,1234
2,452,242,94,788,1234
3,427,261,149,837,1234
4,421,278,160,859,1234
5,425,311,185,921,1234
6,411,331,209,951,1234
7,415,336,224,975,1234
8,412,376,226,1014,1234
9,404,382,252,1038,1234
10,396,384,285,1065,1234
11,398,417,268,1083,1234
1,500,200,50,750,1235
2,464,241,86,791,1235
3,423,280,137,840,1235
4,406,298,163,867,1235
5,382,339,189,910,1235
6,377,346,225,948,1235
7,381,356,238,975,1235
8,367,384,257,1008,1235
9,380,410,250,1040,1235
10,347,401,303,1051,1235
11,377,430,292,1099,1235
1,500,200,50,750,1236
2,436,250,93,779,1236
3,389,286,146,821,1236
4,392,311,173,876,1236
5,388,310,198,896,1236
6,400,315,223,938,1236
7,411,355,235,1001,1236
8,397,357,245,999,1236
9,428,373,247,1048,1236
10,419,394,251,1064,1236
11,427,387,276,1090,1236
1,500,200,50,750,1237
2,460,222,102,784,1237
3,429,271,125,825,1237
4,403,305,154,862,1237
5,409,311,181,901,1237
6,423,323,201,947,1237
7,439,316,243,998,1237
8,418,369,227,1014,1237
9,395,389,236,1020,1237
10,375,414,256,1045,1237
11,401,421,268,1090,1237
1,500,200,50,750,1238
2,439,261,100,800,1238
3,403,285,136,824,1238
4,402,300,161,863,1238
5,410,326,181,917,1238
6,395,344,213,952,1238
7,398,364,225,987,1238
8,415,365,240,1020,1238
9,391,357,261,1009,1238
10,408,366,291,1065,1238
11,382,389,301,1072,1238
1,500,200,50,750,1239
2,473,224,99,796,1239
3,447,257,126,830,1239
4,405,317,147,869,1239
5,410,339,177,926,1239
6,406,343,211,960,1239
7,392,383,205,980,1239
8,391,382,236,1009,1239
9,398,372,260,1030,1239
10,391,387,277,1055,1239
11,394,417,278,1089,1239
1,500,200,50,750,1240
2,453,226,110,789,1240
3,412,262,147,821,1240
4,399,311,165,875,1240
5,396,328,187,911,1240
6,402,322,230,954,1240
7,387,368,233,988,1240
8,383,394,234,1011,1240
9,386,401,239,1026,1240
10,402,398,249,1049,1240
11,394,432,256,1082,1240
1,500,200,50,750,1241
2,458,245,88,791,1241
3,442,260,131,833,1241
4,403,297,168,868,1241
5,415,321,199,935,1241
6,401,337,216,954,1241
7,385,362,226,973,1241
8,391,374,249,1014,1241
9,394,367,250,1011,1241
10,409,396,268,1073,1241
11,391,415,274,1080,1241
1,500,200,50,750,1242
2,461,212,103,776,1242
3,444,252,138,834,1242
4,408,277,169,854,1242
5,412,297,192,901,1242
6,404,349,210,963,1242
7,393,376,209,978,1242
8,402,399,216,1017,1242
9,390,410,232,1032,1242
10,376,410,262,1048,1242
11,388,420,267,1075,1242
1,500,200,50,750,1243
2,466,216,104,786,1243
3,440,262,139,841,1243
4,394,289,171,854,1243
5,391,323,193,907,1243
6,388,332,237,957,1243
7,377,330,268,975,1243
8,361,359,282,1002,1243
9,376,401,267,1044,1243
10,382,423,265,1070,1243
11,377,454,262,1093,1243
1,500,200,50,750,1244
2,474,229,102,805,1244
3,444,269,117,830,1244
4,433,279,159,871,1244
5,427,297,183,907,1244
6,418,331,218,967,1244
7,387,353,239,979,1244
8,360,366,252,978,1244
9,378,394,254,1026,1244
10,401,422,246,1069,1244
11,388,409,282,1079,1244
1,500,200,50,750,1245
2,470,226,102,798,1245
3,421,239,160,820,1245
4,437,277,181,895,1245
5,424,293,200,917,1245
6,436,320,204,960,1245
7,426,333,225,984,1245
8,404,355,240,999,1245
9,390,392,225,1007,1245
10,398,408,244,1050,1245
11,412,413,259,1084,1245
1,500,200,50,750,1246
2,479,217,89,785,1246
3,438,235,128,801,1246
4,420,287,158,865,1246
5,406,322,188,916,1246
6,427,314,218,959,1246
7,384,353,239,976,1246
8,395,382,230,1007,1246
9,403,385,242,1030,1246
10,403,396,258,1057,1246
11,409,415,267,1091,1246
1,500,200,50,750,1247
2,446,244,97,787,1247
3,417,262,154,833,1247
4,418,302,157,877,1247
5,396,323,174,893,1247
6,412,326,221,959,1247
7,415,337,234,986,1247
8,392,378,246,1016,1247
9,378,387,255,1020,1247
10,385,384,290,1059,1247
11,391,391,284,1066,1247
1,500,200,50,750,1248
2,446,233,110,789,1248
3,396,281,148,825,1248
4,382,316,171,869,1248
5,382,339,187,908,1248
6,372,359,220,951,1248
7,374,366,240,980,1248
8,371,385,248,1004,1248
9,372,375,258,1005,1248
10,418,385,259,1062,1248
11,402,416,266,1084,1248
1,500,200,50,750,1249
2,477,215,88,780,1249
3,442,249,126,817,1249
4,424,277,169,870,1249
5,411,317,183,911,1249
6,401,346,212,959,1249
7,380,360,236,976,1249
8,395,384,241,1020,1249
9,387,385,255,1027,1249
10,400,381,282,1063,1249
11,412,400,266,1078,1249
1,500,200,50,750,1250
2,473,235,95,803,1250
3,437,260,127,824,1250
4,414,271,175,860,1250
5,400,298,211,909,1250
6,410,334,225,969,1250
7,393,345,246,984,1250
8,404,348,270,1022,1250
9,387,358,276,1021,1250
10,394,371,295,1060,1250
11,398,398,288,1084,1250
1,500,200,50,750,1251
2,459,235,102,796,1251
3,436,257,137,830,1251
4,411,278,185,874,1251
5,404,318,203,925,1251
6,393,342,225,960,1251
7,385,343,251,979,1251
8,373,366,283,1022,1251
9,390,370,279,1039,1251
10,400,386,280,1066,1251
11,406,397,279,1082,1251
1,500,200,50,750,1252
2,456,237,102,795,1252
3,440,266,126,832,1252
4,421,288,168,877,1252
5,422,298,202,922,1252
6,406,338,216,960,1252
7,400,355,227,982,1252
8,400,384,239,1023,1252
9,385,369,270,1024,1252
10,375,369,282,1026,1252
11,388,399,282,1069,1252
1,500,200,50,750,1253
2,451,226,108,785,1253
3,420,268,141,829,1253
4,409,278,173,860,1253
5,405,317,178,900,1253
6,408,336,207,951,1253
7,429,330,216,975,1253
8,412,384,217,1013,1253
9,412,385,241,1038,1253
10,419,399,252,1070,1253
11,422,384,282,1088,1253
1,500,200,50,750,1254
2,446,250,93,789,1254
3,428,263,145,836,1254
4,408,288,166,862,1254
5,410,309,194,913,1254
6,398,353,209,960,1254
7,399,382,242,1023,1254
8,359,389,262,1010,1254
9,370,402,258,1030,1254
10,397,396,272,1065,1254
11,403,421,276,1100,1254
1,500,200,50,750,1255
2,452,246,89,787,1255
3,424,281,122,827,1255
4,406,309,162,877,1255
5,400,337,184,921,1255
6,427,333,202,962,1255
7,414,355,223,992,1255
8,395,373,239,1007,1255
9,420,364,261,1045,1255
10,393,391,283,1067,1255
11,395,410,290,1095,1255
1,500,200,50,750,1256
2,458,225,92,775,1256
3,436,274,134,844,1256
4,405,284,188,877,1256
5,414,314,184,912,1256
6,428,338,207,973,1256
7,391,342,250,983,1256
8,384,357,254,995,1256
9,400,381,248,1029,1256
10,402,379,278,1059,1256
11,400,413,282,1095,1256
1,500,200,50,750,1257
2,448,228,104,780,1257
3,424,267,123,814,1257
4,419,301,163,883,1257
5,399,312,194,905,1257
6,408,332,221,961,1257
7,383,357,231,971,1257
8,370,385,248,1003,1257
9,377,361,286,1024,1257
10,388,381,288,1057,1257
11,376,389,291,1056,1257
1,500,200,50,750,1258
2,452,234,98,784,1258
3,444,250,132,826,1258
4,417,286,169,872,1258
5,400,301,195,896,1258
6,407,343,221,971,1258
7,370,360,235,965,1258
8,388,376,249,1013,1258
9,402,395,251,1048,1258
10,401,412,260,1073,1258
11,414,416,257,1087,1258
1,500,200,50,750,1259
2,449,241,95,785,1259
3,414,293,125,832,1259
4,391,330,154,875,1259
5,374,348,180,902,1259
6,404,357,207,968,1259
7,386,355,233,974,1259
8,391,350,257,998,1259
9,395,399,253,1047,1259
10,388,385,271,1044,1259
11,414,406,275,1095,1259
1,500,200,50,750,1260
2,459,217,104,780,1260
3,448,250,144,842,1260
4,424,256,187,867,1260
5,413,284,209,906,1260
6,418,329,212,959,1260
7,406,317,249,972,1260
8,392,366,239,997,1260
9,403,392,241,1036,1260
10,418,410,242,1070,1260
11,400,415,259,1074,1260
1,500,200,50,750,1261
2,449,232,105,786,1261
3,438,266,136,840,1261
4,422,289,170,881,1261
5,417,310,190,917,1261
6,423,334,192,949,1261
7,409,351,218,978,1261
8,394,364,224,982,1261
9,399,389,253,1041,1261
10,386,428,245,1059,1261
11,392,432,257,1081,1261
1,500,200,50,750,1262
2,463,211,106,780,1262
3,436,244,131,811,1262
4,440,284,155,879,1262
5,410,317,181,908,1262
6,417,338,202,957,1262
7,430,339,216,985,1262
8,403,355,239,997,1262
9,388,378,254,1020,1262
10,372,410,267,1049,1262
11,370,451,275,1096,1262
1,500,200,50,750,1263
2,446,229,96,771,1263
3,417,268,140,825,1263
4,409,280,172,861,1263
5,420,310,177,907,1263
6,418,328,202,948,1263
7,413,367,210,990,1263
8,386,380,238,1004,1263
9,392,384,255,1031,1263
10,395,399,281,1075,1263
11,400,390,301,1091,1263
1,500,200,50,750,1264
2,457,233,110,800,1264
3,427,255,139,821,1264
4,405,289,169,863,1264
5,377,318,193,888,1264
6,407,329,232,968,1264
7,408,329,241,978,1264
8,419,342,255,1016,1264
9,402,377,240,1019,1264
10,415,381,254,1050,1264
11,424,394,275,1093,1264
1,500,200,50,750,1265
2,447,234,103,784,1265
3,421,271,137,829,1265
4,415,286,167,868,1265
5,421,301,188,910,1265
6,408,339,200,947,1265
7,387,357,236,980,1265
8,395,361,254,1010,1265
9,389,359,286,1034,1265
10,396,375,290,1061,1265
11,380,422,267,1069,1265
1,500,200,50,750,1266
2,443,239,95,777,1266
3,420,273,134,827,1266
4,414,291,163,868,1266
5,403,311,192,906,1266
6,390,350,208,948,1266
7,403,345,226,974,1266
8,393,332,259,984,1266
9,406,379,263,1048,1266
10,408,370,268,1046,1266
11,405,411,276,1092,1266
1,500,200,50,750,1267
2,448,227,99,774,1267
3,421,280,123,824,1267
4,401,299,167,867,1267
5,415,305,194,914,1267
6,406,332,206,944,1267
7,418,350,216,984,1267
8,401,357,245,1003,1267
9,403,374,253,1030,1267
10,410,410,253,1073,1267
11,407,427,245,1079,1267
1,500,200,50,750,1268
2,455,229,106,790,1268
3,437,248,151,836,1268
4,451,272,158,881,1268
5,435,296,187,918,1268
6,424,327,211,962,1268
7,414,363,217,994,1268
8,396,398,223,1017,1268
9,375,393,248,1016,1268
10,391,390,265,1046,1268
11,397,414,278,1089,1268
1,500,200,50,750,1269
2,466,223,91,780,1269
3,434,266,129,829,1269
4,404,290,164,858,1269
5,409,325,187,921,1269
6,399,321,210,930,1269
7,408,337,240,985,1269
8,393,365,247,1005,1269
9,391,386,257,1034,1269
10,389,400,275,1064,1269
11,396,400,299,1095,1269
1,500,200,50,750,1270
2,475,226,90,791,1270
3,449,255,131,835,1270
4,424,297,163,884,1270
5,390,327,193,910,1270
6,414,334,217,965,1270
7,417,380,213,1010,1270
8,393,389,231,1013,1270
9,386,374,262,1022,1270
10,393,360,290,1043,1270
11,403,384,301,1088,1270
1,500,200,50,750,1271
2,471,232,93,796,1271
3,444,249,133,826,1271
4,414,298,154,866,1271
5,447,311,173,931,1271
6,438,340,192,970,1271
7,403,364,198,965,1271
8,409,372,240,1021,1271
9,416,386,235,1037,1271
10,427,399,235,1061,1271
11,438,397,243,1078,1271
1,500,200,50,750,1272
2,459,233,91,783,1272
3,439,253,126,818,1272
4,413,270,171,854,1272
5,409,303,185,897,1272
6,413,337,208,958,1272
7,392,346,246,984,1272
8,381,353,260,994,1272
9,401,379,254,1034,1272
10,402,391,265,1058,1272
11,392,411,274,1077,1272
1,500,200,50,750,1273
2,470,219,99,788,1273
3,437,252,132,821,1273
4,440,277,161,878,1273
5,415,323,166,904,1273
6,413,349,196,958,1273
7,392,352,222,966,1273
8,380,390,231,1001,1273
9,391,384,248,1023,1273
10,404,419,245,1068,1273
11,402,425,256,1083,1273
1,500,200,50,750,1274
2,473,216,97,786,1274
3,455,231,134,820,1274
4,429,264,172,865,1274
5,414,273,200,887,1274
6,428,315,209,952,1274
7,413,331,242,986,1274
8,385,389,231,1005,1274
9,404,382,251,1037,1274
10,381,411,262,1054,1274
11,395,421,262,1078,1274
1,500,200,50,750,1275
2,468,229,95,792,1275
3,440,263,141,844,1275
4,404,295,176,875,1275
5,405,320,185,910,1275
6,404,351,214,969,1275
7,390,357,226,973,1275
8,380,386,233,999,1275
9,375,389,266,1030,1275
10,382,392,272,1046,1275
11,397,425,263,1085,1275
1,500,200,50,750,1276
2,464,243,95,802,1276
3,442,259,129,830,1276
4,432,266,170,868,1276
5,415,288,200,903,1276
6,413,301,209,923,1276
7,400,359,210,969,1276
8,396,384,228,1008,1276
9,397,387,256,1040,1276
10,411,410,256,1077,1276
11,391,402,288,1081,1276
1,500,200,50,750,1277
2,458,229,102,789,1277
3,446,254,124,824,1277
4,421,290,149,860,1277
5,405,305,192,902,1277
6,429,302,215,946,1277
7,434,312,238,984,1277
8,425,346,238,1009,1277
9,430,341,261,1032,1277
10,422,378,243,1043,1277
11,389,427,260,1076,1277
1,500,200,50,750,1278
2,465,240,84,789,1278
3,430,268,122,820,1278
4,411,290,158,859,1278
5,417,309,189,915,1278
6,415,326,209,950,1278
7,404,335,231,970,1278
8,405,360,237,1002,1278
9,415,363,255,1033,1278
10,417,397,255,1069,1278
11,409,415,259,1083,1278
1,500,200,50,750,1279
2,461,223,102,786,1279
3,438,251,142,831,1279
4,425,274,162,861,1279
5,421,280,198,899,1279
6,434,319,209,962,1279
7,414,328,240,982,1279
8,417,337,248,1002,1279
9,404,352,254,1010,1279
10,422,386,267,1075,1279
11,420,390,272,1082,1279
1,500,200,50,750,1280
2,452,222,92,766,1280
3,440,270,125,835,1280
4,430,277,153,860,1280
5,425,316,172,913,1280
6,420,326,211,957,1280
7,409,349,221,979,1280
8,406,385,241,1032,1280
9,386,388,257,1031,1280
10,392,415,252,1059,1280
11,412,423,266,1101,1280
1,500,200,50,750,1281
2,479,232,92,803,1281
3,444,255,123,822,1281
4,407,281,153,841,1281
5,407,333,184,924,1281
6,382,354,221,957,1281
7,381,357,239,977,1281
8,410,365,241,1016,1281
9,414,381,234,1029,1281
10,411,379,259,1049,1281
11,425,422,264,1111,1281
1,500,200,50,750,1282
2,456,228,106,790,1282
3,445,257,125,827,1282
4,422,297,149,868,1282
5,416,322,173,911,1282
6,403,335,206,944,1282
7,396,363,220,979,1282
8,380,385,245,1010,1282
9,393,380,258,1031,1282
10,409,405,250,1064,1282
11,420,378,280,1078,1282
1,500,200,50,750,1283
2,466,228,85,779,1283
3,445,251,121,817,1283
4,432,292,151,875,1283
5,410,312,178,900,1283
6,424,335,202,961,1283
7,416,355,207,978,1283
8,406,374,217,997,1283
9,399,378,243,1020,1283
10,411,392,256,1059,1283
11,398,436,247,1081,1283
1,500,200,50,750,1284
2,473,217,92,782,1284
3,445,264,129,838,1284
4,420,278,161,859,1284
5,395,318,184,897,1284
6,396,339,223,958,1284
7,392,350,237,979,1284
8,404,365,238,1007,1284
9,367,403,262,1032,1284
10,381,423,250,1054,1284
11,375,443,275,1093,1284
1,500,200,50,750,1285
2,445,224,96,765,1285
3,442,255,120,817,1285
4,428,276,159,863,1285
5,427,293,188,908,1285
6,408,336,196,940,1285
7,422,375,207,1004,1285
8,425,360,219,1004,1285
9,419,355,256,1030,1285
10,426,373,259,1058,1285
11,414,401,277,1092,1285
1,500,200,50,750,1286
2,447,257,93,797,1286
3,410,272,137,819,1286
4,410,285,165,860,1286
5,404,289,215,908,1286
6,414,326,222,962,1286
7,412,337,239,988,1286
8,420,353,235,1008,1286
9,401,380,249,1030,1286
10,418,405,260,1083,1286
11,389,406,281,1076,1286
1,500,200,50,750,1287
2,445,238,104,787,1287
3,415,288,116,819,1287
4,407,296,163,866,1287
5,405,309,182,896,1287
6,419,343,210,972,1287
7,408,332,245,985,1287
8,404,353,238,995,1287
9,420,395,227,1042,1287
10,417,408,242,1067,1287
11,412,401,277,1090,1287
1,500,200,50,750,1288
2,463,231,94,788,1288
3,433,259,142,834,1288
4,400,280,170,850,1288
5,404,306,185,895,1288
6,424,309,212,945,1288
7,415,345,215,975,1288
8,394,365,234,993,1288
9,415,383,231,1029,1288
10,419,393,241,1053,1288
11,423,406,251,1080,1288
1,500,200,50,750,1289
2,449,240,86,775,1289
3,424,290,111,825,1289
4,417,312,141,870,1289
5,412,339,162,913,1289
6,415,355,181,951,1289
7,418,373,207,998,1289
8,382,376,239,997,1289
9,388,399,243,1030,1289
10,410,391,268,1069,1289
11,405,396,281,1082,1289
1,500,200,50,750,1290
2,466,223,103,792,1290
3,439,250,142,831,1290
4,424,274,171,869,1290
5,431,285,195,911,1290
6,408,318,204,930,1290
7,414,336,224,974,1290
8,406,370,232,1008,1290
9,398,392,225,1015,1290
10,404,390,259,1053,1290
11,410,434,247,1091,1290
1,500,200,50,750,1291
2,449,242,91,782,1291
3,431,275,124,830,1291
4,418,298,161,877,1291
5,395,318,195,908,1291
6,392,345,227,964,1291
7,406,364,230,1000,1291
8,363,369,269,1001,1291
9,386,372,285,1043,1291
10,393,371,302,1066,1291
11,396,389,300,1085,1291
1,500,200,50,750,1292
2,466,246,79,791,1292
3,425,275,137,837,1292
4,414,308,153,875,1292
5,397,325,182,904,1292
6,427,330,218,975,1292
7,408,328,240,976,1292
8,412,372,231,1015,1292
9,392,375,262,1029,1292
10,383,399,271,1053,1292
11,377,416,283,1076,1292
1,500,200,50,750,1293
2,461,218,101,780,1293
3,430,259,142,831,1293
4,404,297,170,871,1293
5,410,303,210,923,1293
6,394,340,219,953,1293
7,418,332,245,995,1293
8,417,360,233,1010,1293
9,372,390,242,1004,1293
10,399,411,238,1048,1293
11,425,422,238,1085,1293
1,500,200,50,750,1294
2,459,237,88,784,1294
3,441,252,128,821,1294
4,422,272,157,851,1294
5,424,307,187,918,1294
6,425,343,204,972,1294
7,398,359,226,983,1294
8,372,380,246,998,1294
9,385,399,245,1029,1294
10,382,398,263,1043,1294
11,376,408,291,1075,1294
1,500,200,50,750,1295
2,470,230,98,798,1295
3,452,243,129,824,1295
4,430,273,160,863,1295
5,440,291,189,920,1295
6,405,311,223,939,1295
7,406,329,235,970,1295
8,393,359,245,997,1295
9,393,369,264,1026,1295
10,407,374,270,1051,1295
11,404,413,265,1082,1295
1,500,200,50,750,1296
2,452,231,102,785,1296
3,436,285,111,832,1296
4,440,292,150,882,1296
5,411,326,173,910,1296
6,406,327,215,948,1296
7,415,342,231,988,1296
8,398,361,238,997,1296
9,391,388,250,1029,1296
10,379,409,266,1054,1296
11,387,419,292,1098,1296
1,500,200,50,750,1297
2,443,247,88,778,1297
3,427,270,120,817,1297
4,413,291,159,863,1297
5,409,329,184,922,1297
6,403,355,195,953,1297
7,408,365,213,986,1297
8,408,366,221,995,1297
9,403,388,226,1017,1297
10,422,380,259,1061,1297
11,418,395,285,1098,1297
1,500,200,50,750,1298
2,451,228,110,789,1298
3,423,257,156,836,1298
4,397,310,165,872,1298
5,396,314,204,914,1298
6,412,319,217,948,1298
7,408,327,253,988,1298
8,421,358,237,1016,1298
9,394,389,251,1034,1298
10,379,403,261,1043,1298
11,385,417,294,1096,1298
1,500,200,50,750,1299
2,461,226,95,782,1299
3,417,266,136,819,1299
4,412,298,155,865,1299
5,404,310,194,908,1299
6,426,339,210,975,1299
7,425,336,232,993,1299
8,403,360,246,1009,1299
9,387,348,288,1023,1299
10,379,358,293,1030,1299
11,413,412,258,1083,1299
1,500,200,50,750,1300
2,449,239,93,781,1300
3,413,274,131,818,1300
4,406,280,186,872,1300
5,406,320,187,913,1300
6,415,322,226,963,1300
7,394,344,238,976,1300
8,388,363,242,993,1300
9,403,385,240,1028,1300
10,416,390,239,1045,1300
11,425,395,253,1073,1300
1,500,200,50,750,1301
2,450,233,93,776,1301
3,425,261,142,828,1301
4,416,288,175,879,1301
5,406,285,202,893,1301
6,420,331,203,954,1301
7,409,349,217,975,1301
8,405,369,235,1009,1301
9,402,398,236,1036,1301
10,420,396,248,1064,1301
11,417,413,258,1088,1301
1,500,200,50,750,1302
2,458,227,102,787,1302
3,427,264,139,830,1302
4,413,281,161,855,1302
5,405,312,181,898,1302
6,370,360,213,943,1302
7,378,376,220,974,1302
8,401,381,221,1003,1302
9,384,400,240,1024,1302
10,385,413,256,1054,1302
11,357,438,270,1065,1302
1,500,200,50,750,1303
2,456,222,113,791,1303
3,439,261,140,840,1303
4,398,307,154,859,1303
5,382,327,197,906,1303
6,372,341,235,948,1303
7,366,390,243,999,1303
8,362,385,256,1003,1303
9,352,406,276,1034,1303
10,360,413,290,1063,1303
11,364,412,293,1069,1303
1,500,200,50,750,1304
2,446,245,88,779,1304
3,439,265,122,826,1304
4,418,282,173,873,1304
5,409,312,197,918,1304
6,406,341,214,961,1304
7,393,346,240,979,1304
8,394,359,246,999,1304
9,401,369,267,1037,1304
10,388,390,259,1037,1304
11,408,405,286,1099,1304
1,500,200,50,750,1305
2,444,262,93,799,1305
3,423,275,127,825,1305
4,387,301,155,843,1305
5,376,322,192,890,1305
6,421,341,213,975,1305
7,372,367,241,980,1305
8,376,372,255,1003,1305
9,400,380,261,1041,1305
10,396,401,260,1057,1305
11,402,397,272,1071,1305
1,500,200,50,750,1306
2,466,226,109,801,1306
3,423,256,158,837,1306
4,398,298,182,878,1306
5,393,323,186,902,1306
6,437,326,208,971,1306
7,410,351,212,973,1306
8,409,361,244,1014,1306
9,398,402,232,1032,1306
10,402,406,246,1054,1306
11,397,410,266,1073,1306
1,500,200,50,750,1307
2,482,212,100,794,1307
3,458,221,143,822,1307
4,441,262,175,878,1307
5,451,295,182,928,1307
6,413,341,196,950,1307
7,427,345,211,983,1307
8,415,352,242,1009,1307
9,393,383,251,1027,1307
10,379,409,264,1052,1307
11,406,402,271,1079,1307
1,500,200,50,750,1308
2,459,234,100,793,1308
3,445,268,125,838,1308
4,392,305,168,865,1308
5,400,319,194,913,1308
6,401,345,207,953,1308
7,409,352,219,980,1308
8,389,388,233,1010,1308
9,388,384,258,1030,1308
10,386,389,271,1046,1308
11,393,404,281,1078,1308
1,500,200,50,750,1309
2,443,244,89,776,1309
3,428,262,132,822,1309
4,416,283,168,867,1309
5,416,303,185,904,1309
6,405,337,212,954,1309
7,397,353,234,984,1309
8,406,361,245,1012,1309
9,395,383,258,1036,1309
10,398,385,266,1049,1309
11,411,410,256,1077,1309
1,500,200,50,750,1310
2,467,217,98,782,1310
3,454,240,132,826,1310
4,439,267,156,862,1310
5,401,315,185,901,1310
6,419,313,215,947,1310
7,377,349,239,965,1310
8,393,366,259,1018,1310
9,391,376,260,1027,1310
10,371,408,272,1051,1310
11,385,439,271,1095,1310
1,500,200,50,750,1311
2,448,222,107,777,1311
3,421,241,150,812,1311
4,402,299,160,861,1311
5,404,315,190,909,1311
6,425,316,218,959,1311
7,428,312,233,973,1311
8,449,317,243,1009,1311
9,419,331,277,1027,1311
10,405,385,260,1050,1311
11,403,383,277,1063,1311
1,500,200,50,750,1312
2,438,219,120,777,1312
3,416,254,146,816,1312
4,400,284,171,855,1312
5,420,312,193,925,1312
6,406,344,216,966,1312
7,385,365,232,982,1312
8,392,386,229,1007,1312
9,402,409,232,1043,1312
10,396,389,262,1047,1312
11,407,404,255,1066,1312
1,500,200,50,750,1313
2,470,227,99,796,1313
3,442,255,133,830,1313
4,438,259,171,868,1313
5,416,288,201,905,1313
6,416,326,219,961,1313
7,401,347,232,980,1313
8,400,366,251,1017,1313
9,394,379,254,1027,1313
10,379,393,276,1048,1313
11,374,389,300,1063,1313
1,500,200,50,750,1314
2,451,231,111,793,1314
3,423,261,145,829,1314
4,436,275,171,882,1314
5,421,320,175,916,1314
6,410,345,186,941,1314
7,412,360,211,983,1314
8,416,365,230,1011,1314
9,400,400,231,1031,1314
10,397,401,245,1043,1314
11,407,422,260,1089,1314
1,500,200,50,750,1315
2,465,233,90,788,1315
3,417,267,127,811,1315
4,405,286,184,875,1315
5,391,309,207,907,1315
6,401,325,235,961,1315
7,391,333,263,987,1315
8,392,346,267,1005,1315
9,410,355,261,1026,1315
10,390,376,279,1045,1315
11,407,383,282,1072,1315
1,500,200,50,750,1316
2,457,238,93,788,1316
3,441,243,151,835,1316
4,416,271,173,860,1316
5,416,310,194,920,1316
6,409,346,205,960,1316
7,397,351,232,980,1316
8,396,353,268,1017,1316
9,393,362,277,1032,1316
10,383,397,269,1049,1316
11,397,385,298,1080,1316
1,500,200,50,750,1317
2,453,221,112,786,1317
3,443,239,159,841,1317
4,421,274,177,872,1317
5,411,299,187,897,1317
6,412,332,209,953,1317
7,400,358,214,972,1317
8,397,376,218,991,1317
9,417,397,233,1047,1317
10,412,392,253,1057,1317
11,404,408,270,1082,1317
1,500,200,50,750,1318
2,473,225,90,788,1318
3,444,255,133,832,1318
4,413,286,154,853,1318
5,414,297,184,895,1318
6,430,326,187,943,1318
7,427,326,217,970,1318
8,419,333,247,999,1318
9,405,364,253,1022,1318
10,407,386,260,1053,1318
11,409,391,278,1078,1318
1,500,200,50,750,1319
2,481,226,96,803,1319
3,449,257,132,838,1319
4,416,283,158,857,1319
5,427,321,187,935,1319
6,412,342,204,958,1319
7,403,385,203,991,1319
8,388,386,228,1002,1319
9,393,368,272,1033,1319
10,392,380,279,1051,1319
11,387,412,273,1072,1319
1,500,200,50,750,1320
2,475,214,107,796,1320
3,443,251,135,829,1320
4,435,265,173,873,1320
5,428,301,185,914,1320
6,437,334,194,965,1320
7,427,337,220,984,1320
8,405,354,232,991,1320
9,412,372,259,1043,1320
10,409,366,272,1047,1320
11,410,404,261,1075,1320
1,500,200,50,750,1321
2,455,232,91,778,1321
3,420,255,143,818,1321
4,391,294,182,867,1321
5,402,326,195,923,1321
6,405,357,210,972,1321
7,380,373,232,985,1321
8,382,395,241,1018,1321
9,370,399,262,1031,1321
10,363,398,288,1049,1321
11,371,424,301,1096,1321
1,500,200,50,750,1322
2,477,232,96,805,1322
3,443,252,139,834,1322
4,430,288,159,877,1322
5,413,311,178,902,1322
6,421,343,192,956,1322
7,403,349,218,970,1322
8,424,377,231,1032,1322
9,380,386,257,1023,1322
10,399,384,264,1047,1322
11,423,402,250,1075,1322
1,500,200,50,750,1323
2,468,235,96,799,1323
3,429,281,113,823,1323
4,440,292,142,874,1323
5,434,325,155,914,1323
6,431,337,180,948,1323
7,420,340,221,981,1323
8,424,350,240,1014,1323
9,412,382,241,1035,1323
10,421,368,275,1064,1323
11,425,397,273,1095,1323
1,500,200,50,750,1324
2,456,245,93,794,1324
3,433,264,119,816,1324
4,416,276,156,848,1324
5,420,313,178,911,1324
6,407,331,196,934,1324
7,397,363,228,988,1324
8,383,380,248,1011,1324
9,365,401,265,1031,1324
10,368,405,274,1047,1324
11,381,420,281,1082,1324
1,500,200,50,750,1325
2,458,228,101,787,1325
3,427,248,144,819,1325
4,418,306,168,892,1325
5,400,322,194,916,1325
6,397,344,225,966,1325
7,389,352,240,981,1325
8,357,387,259,1003,1325
9,374,407,249,1030,1325
10,383,431,241,1055,1325
11,389,425,266,1080,1325
1,500,200,50,750,1326
2,453,239,102,794,1326
3,412,274,143,829,1326
4,386,293,162,841,1326
5,412,331,179,922,1326
6,409,348,208,965,1326
7,393,367,220,980,1326
8,413,396,216,1025,1326
9,379,400,257,1036,1326
10,389,400,265,1054,1326
11,371,400,283,1054,1326
1,500,200,50,750,1327
2,469,234,97,800,1327
3,441,248,144,833,1327
4,423,261,184,868,1327
5,419,303,194,916,1327
6,405,322,231,958,1327
7,391,341,253,985,1327
8,385,376,241,1002,1327
9,389,390,242,1021,1327
10,405,423,231,1059,1327
11,401,415,262,1078,1327
1,500,200,50,750,1328
2,468,232,94,794,1328
3,424,278,136,838,1328
4,424,291,160,875,1328
5,432,311,185,928,1328
6,454,323,187,964,1328
7,443,313,235,991,1328
8,421,340,233,994,1328
9,401,352,250,1003,1328
10,424,383,266,1073,1328
11,408,422,260,1090,1328
1,500,200,50,750,1329
2,433,245,104,782,1329
3,423,262,137,822,1329
4,390,296,158,844,1329
5,395,332,181,908,1329
6,393,361,202,956,1329
7,397,374,218,989,1329
8,399,393,230,1022,1329
9,385,398,243,1026,1329
10,386,403,272,1061,1329
11,382,437,259,1078,1329
1,500,200,50,750,1330
2,445,229,103,777,1330
3,426,274,136,836,1330
4,391,311,163,865,1330
5,402,328,187,917,1330
6,425,347,190,962,1330
7,405,352,232,989,1330
8,416,364,241,1021,1330
9,402,373,245,1020,1330
10,421,369,270,1060,1330
11,419,409,268,1096,1330
1,500,200,50,750,1331
2,458,230,104,792,1331
3,429,254,129,812,1331
4,420,297,164,881,1331
5,412,319,171,902,1331
6,418,353,186,957,1331
7,404,371,208,983,1331
8,390,380,224,994,1331
9,414,390,236,1040,1331
10,407,393,255,1055,1331
11,413,387,290,1090,1331
1,500,200,50,750,1332
2,454,247,87,788,1332
3,432,265,129,826,1332
4,419,277,168,864,1332
5,421,290,191,902,1332
6,415,326,209,950,1332
7,419,342,225,986,1332
8,414,360,241,1015,1332
9,414,370,249,1033,1332
10,407,401,241,1049,1332
11,424,411,255,1090,1332
1,500,200,50,750,1333
2,476,230,94,800,1333
3,428,251,149,828,1333
4,426,283,164,873,1333
5,423,307,190,920,1333
6,397,356,202,955,1333
7,389,349,248,986,1333
8,411,359,252,1022,1333
9,395,365,257,1017,1333
10,396,414,246,1056,1333
11,391,427,267,1085,1333
1,500,200,50,750,1334
2,450,232,103,785,1334
3,427,256,135,818,1334
4,409,299,167,875,1334
5,415,314,185,914,1334
6,412,316,208,936,1334
7,446,352,199,997,1334
8,424,356,212,992,1334
9,424,364,241,1029,1334
10,401,388,260,1049,1334
11,405,414,273,1092,1334
1,500,200,50,750,1335
2,447,251,83,781,1335
3,434,269,129,832,1335
4,425,269,163,857,1335
5,404,304,198,906,1335
6,417,316,226,959,1335
7,398,359,232,989,1335
8,392,366,238,996,1335
9,407,386,249,1042,1335
10,390,400,268,1058,1335
11,379,415,288,1082,1335
1,500,200,50,750,1336
2,454,229,113,796,1336
3,416,259,150,825,1336
4,407,283,195,885,1336
5,380,337,200,917,1336
6,382,340,231,953,1336
7,406,353,231,990,1336
8,393,369,256,1018,1336
9,406,380,263,1049,1336
10,384,401,270,1055,1336
11,378,412,294,1084,1336
1,500,200,50,750,1337
2,453,249,94,796,1337
3,419,267,149,835,1337
4,407,286,185,878,1337
5,387,305,199,891,1337
6,421,332,210,963,1337
7,413,344,215,972,1337
8,399,374,238,1011,1337
9,393,380,252,1025,1337
10,403,386,255,1044,1337
11,407,426,257,1090,1337
1,500,200,50,750,1338
2,428,238,127,793,1338
3,407,264,155,826,1338
4,396,291,169,856,1338
5,403,310,194,907,1338
6,415,341,207,963,1338
7,385,370,225,980,1338
8,383,368,253,1004,1338
9,378,398,262,1038,1338
10,395,410,258,1063,1338
11,409,422,258,1089,1338
1,500,200,50,750,1339
2,448,220,115,783,1339
3,431,240,152,823,1339
4,442,266,176,884,1339
5,407,292,199,898,1339
6,416,325,220,961,1339
7,419,325,260,1004,1339
8,397,334,273,1004,1339
9,388,344,287,1019,1339
10,407,352,299,1058,1339
11,385,382,289,1056,1339
1,500,200,50,750,1340
2,483,212,107,802,1340
3,440,260,131,831,1340
4,415,286,170,871,1340
5,403,322,186,911,1340
6,397,361,202,960,1340
7,409,343,237,989,1340
8,400,359,243,1002,1340
9,406,359,261,1026,1340
10,392,394,269,1055,1340
11,401,406,262,1069,1340
1,500,200,50,750,1341
2,448,253,90,791,1341
3,443,263,122,828,1341
4,410,269,170,849,1341
5,412,308,194,914,1341
6,391,344,215,950,1341
7,381,362,246,989,1341
8,387,372,260,1019,1341
9,380,386,265,1031,1341
10,388,401,272,1061,1341
11,400,403,285,1088,1341
1,500,200,50,750,1342
2,457,233,86,776,1342
3,457,236,136,829,1342
4,428,255,162,845,1342
5,423,296,186,905,1342
6,432,328,204,964,1342
7,426,347,211,984,1342
8,418,357,216,991,1342
9,403,372,243,1018,1342
10,407,425,251,1083,1342
11,408,390,293,1091,1342
1,500,200,50,750,1343
2,438,250,92,780,1343
3,404,291,134,829,1343
4,397,306,167,870,1343
5,375,334,196,905,1343
6,387,346,218,951,1343
7,364,381,240,985,1343
8,385,379,259,1023,1343
9,380,364,281,1025,1343
10,385,405,277,1067,1343
11,408,378,289,1075,1343
1,500,200,50,750,1344
2,453,244,101,798,1344
3,416,273,142,831,1344
4,408,278,183,869,1344
5,416,315,187,918,1344
6,388,337,202,927,1344
7,414,356,221,991,1344
8,412,355,226,993,1344
9,415,368,261,1044,1344
10,396,406,247,1049,1344
11,408,438,246,1092,1344
1,500,200,50,750,1345
2,458,219,98,775,1345
3,460,249,141,850,1345
4,419,281,171,871,1345
5,394,326,196,916,1345
6,399,314,228,941,1345
7,389,353,242,984,1345
8,389,377,251,1017,1345
9,386,398,243,1027,1345
10,426,393,269,1088,1345
11,385,396,278,1059,1345
1,500,200,50,750,1346
2,435,258,96,789,1346
3,379,305,134,818,1346
4,373,304,168,845,1346
5,401,360,175,936,1346
6,400,335,209,944,1346
7,393,361,220,974,1346
8,388,387,239,1014,1346
9,381,400,249,1030,1346
10,389,397,263,1049,1346
11,405,389,267,1061,1346
1,500,200,50,750,1347
2,459,234,86,779,1347
3,450,250,129,829,1347
4,403,289,160,852,1347
5,405,345,155,905,1347
6,410,362,182,954,1347
7,419,358,207,984,1347
8,409,373,234,1016,1347
9,425,372,245,1042,1347
10,397,377,282,1056,1347
11,419,395,272,1086,1347
1,500,200,50,750,1348
2,451,226,101,778,1348
3,441,249,132,822,1348
4,419,260,178,857,1348
5,413,294,206,913,1348
6,423,344,206,973,1348
7,413,343,228,984,1348
8,399,350,248,997,1348
9,405,375,269,1049,1348
10,396,385,276,1057,1348
11,416,413,271,1100,1348
1,500,200,50,750,1349
2,478,224,89,791,1349
3,461,238,137,836,1349
4,417,274,171,862,1349
5,396,314,194,904,1349
6,403,326,224,953,1349
7,396,345,255,996,1349
8,387,352,259,998,1349
9,416,355,274,1045,1349
10,388,397,272,1057,1349
11,388,406,289,1083,1349
1,500,200,50,750,1350
2,477,212,93,782,1350
3,438,240,144,822,1350
4,427,273,161,861,1350
5,432,305,174,911,1350
6,417,316,203,936,1350
7,399,341,234,974,1350
8,387,363,243,993,1350
9,381,390,269,1040,1350
10,385,392,276,1053,1350
11,382,436,269,1087,1350
1,500,200,50,750,1351
2,451,235,108,794,1351
3,435,271,133,839,1351
4,424,290,159,873,1351
5,403,319,170,892,1351
6,419,342,203,964,1351
7,401,353,234,988,1351
8,385,373,243,1001,1351
9,393,395,244,1032,1351
10,376,419,255,1050,1351
11,387,445,248,1080,1351
1,500,200,50,750,1352
2,469,230,88,787,1352
3,435,262,137,834,1352
4,432,278,164,874,1352
5,430,309,168,907,1352
6,429,346,185,960,1352
7,409,354,210,973,1352
8,387,367,229,983,1352
9,385,412,245,1042,1352
10,383,414,268,1065,1352
11,395,407,277,1079,1352
1,500,200,50,750,1353
2,458,241,95,794,1353
3,441,258,139,838,1353
4,424,277,163,864,1353
5,410,303,210,923,1353
6,417,347,196,960,1353
7,419,338,221,978,1353
8,426,342,237,1005,1353
9,417,355,254,1026,1353
10,418,382,267,1067,1353
11,423,386,273,1082,1353
1,500,200,50,750,1354
2,447,245,95,787,1354
3,430,258,134,822,1354
4,415,286,158,859,1354
5,392,315,178,885,1354
6,424,350,205,979,1354
7,403,344,242,989,1354
8,403,386,223,1012,1354
9,384,390,245,1019,1354
10,390,398,258,1046,1354
11,400,396,287,1083,1354
1,500,200,50,750,1355
2,471,225,92,788,1355
3,436,240,154,830,1355
4,403,286,186,875,1355
5,422,305,192,919,1355
6,421,323,218,962,1355
7,383,332,243,958,1355
8,403,367,247,1017,1355
9,386,390,245,1021,1355
10,410,396,274,1080,1355
11,385,426,265,1076,1355
1,500,200,50,750,1356
2,460,236,94,790,1356
3,431,280,127,838,1356
4,405,297,169,871,1356
5,415,317,186,918,1356
6,396,340,209,945,1356
7,414,356,222,992,1356
8,410,346,246,1002,1356
9,402,366,256,1024,1356
10,401,398,251,1050,1356
11,394,405,285,1084,1356
1,500,200,50,750,1357
2,473,220,95,788,1357
3,438,261,127,826,1357
4,438,280,172,890,1357
5,410,301,194,905,1357
6,418,320,215,953,1357
7,389,342,242,973,1357
8,406,360,248,1014,1357
9,433,357,242,1032,1357
10,406,385,259,1050,1357
11,408,401,289,1098,1357
1,500,200,50,750,1358
2,454,239,88,781,1358
3,442,242,142,826,1358
4,427,265,176,868,1358
5,427,307,178,912,1358
6,419,333,209,961,1358
7,403,374,210,987,1358
8,416,356,230,1002,1358
9,413,377,250,1040,1358
10,397,393,274,1064,1358
11,426,375,284,1085,1358
1,500,200,50,750,1359
2,469,222,112,803,1359
3,434,249,137,820,1359
4,429,296,155,880,1359
5,413,312,186,911,1359
6,401,350,208,959,1359
7,400,357,227,984,1359
8,400,378,236,1014,1359
9,381,402,252,1035,1359
10,391,395,260,1046,1359
11,412,423,251,1086,1359
1,500,200,50,750,1360
2,455,229,109,793,1360
3,406,268,152,826,1360
4,390,286,179,855,1360
5,375,315,210,900,1360
6,417,332,223,972,1360
7,411,346,232,989,1360
8,397,368,241,1006,1360
9,406,395,234,1035,1360
10,400,380,272,1052,1360
11,388,424,261,1073,1360
1,500,200,50,750,1361
2,471,223,99,793,1361
3,441,252,135,828,1361
4,401,301,159,861,1361
5,389,334,188,911,1361
6,394,347,217,958,1361
7,388,354,221,963,1361
8,383,366,248,997,1361
9,386,366,278,1030,1361
10,379,379,288,1046,1361
11,381,382,307,1070,1361
1,500,200,50,750,1362
2,455,239,103,797,1362
3,419,268,144,831,1362
4,410,292,171,873,1362
5,389,337,186,912,1362
6,393,358,224,975,1362
7,365,361,242,968,1362
8,385,375,239,999,1362
9,383,378,271,1032,1362
10,381,394,280,1055,1362
11,410,390,291,1091,1362
1,500,200,50,750,1363
2,471,229,87,787,1363
3,431,266,119,816,1363
4,407,305,151,863,1363
5,391,339,184,914,1363
6,395,349,207,951,1363
7,391,359,224,974,1363
8,404,348,242,994,1363
9,400,377,261,1038,1363
10,370,391,275,1036,1363
11,393,405,293,1091,1363
1,500,200,50,750,1364
2,453,233,98,784,1364
3,435,271,130,836,1364
4,390,317,166,873,1364
5,404,327,186,917,1364
6,420,355,201,976,1364
7,396,361,223,980,1364
8,388,373,244,1005,1364
9,375,377,269,1021,1364
10,379,383,293,1055,1364
11,398,387,298,1083,1364
1,500,200,50,750,1365
2,452,225,101,778,1365
3,426,269,130,825,1365
4,430,280,160,870,1365
5,429,302,181,912,1365
6,411,324,198,933,1365
7,385,352,225,962,1365
8,407,359,225,991,1365
9,437,366,249,1052,1365
10,423,393,253,1069,1365
11,435,385,267,1087,1365
1,500,200,50,750,1366
2,459,248,92,799,1366
3,408,261,141,810,1366
4,416,307,156,879,1366
5,413,322,179,914,1366
6,399,343,208,950,1366
7,400,382,209,991,1366
8,387,395,221,1003,1366
9,398,383,252,1033,1366
10,384,399,280,1063,1366
11,400,375,304,1079,1366
1,500,200,50,750,1367
2,443,238,99,780,1367
3,427,266,141,834,1367
4,425,289,164,878,1367
5,416,322,172,910,1367
6,426,335,187,948,1367
7,430,321,224,975,1367
8,415,368,243,1026,1367
9,388,398,230,1016,1367
10,398,417,260,1075,1367
11,396,408,291,1095,1367
1,500,200,50,750,1368
2,462,223,95,780,1368
3,428,258,129,815,1368
4,429,276,150,855,1368
5,422,309,182,913,1368
6,425,336,203,964,1368
7,407,348,222,977,1368
8,426,368,232,1026,1368
9,401,372,264,1037,1368
10,389,382,295,1066,1368
11,370,426,275,1071,1368
1,500,200,50,750,1369
2,453,236,93,782,1369
3,442,272,123,837,1369
4,436,301,145,882,1369
5,420,311,168,899,1369
6,408,364,186,958,1369
7,404,366,217,987,1369
8,409,366,238,1013,1369
9,400,373,262,1035,1369
10,423,371,253,1047,1369
11,440,398,254,1092,1369
1,500,200,50,750,1370
2,473,221,95,789,1370
3,457,251,121,829,1370
4,426,288,153,867,1370
5,424,306,187,917,1370
6,416,330,200,946,1370
7,409,366,216,991,1370
8,414,357,233,1004,1370
9,407,354,257,1018,1370
10,447,366,241,1054,1370
11,435,399,257,1091,1370
1,500,200,50,750,1371
2,461,228,92,781,1371
3,439,244,140,823,1371
4,405,273,167,845,1371
5,371,307,196,874,1371
6,379,331,219,929,1371
7,388,334,258,980,1371
8,370,380,253,1003,1371
9,370,391,273,1034,1371
10,398,391,272,1061,1371
11,406,409,274,1089,1371
1,500,200,50,750,1372
2,461,244,85,790,1372
3,435,270,126,831,1372
4,400,297,163,860,1372
5,415,298,178,891,1372
6,427,321,207,955,1372
7,413,351,224,988,1372
8,397,408,217,1022,1372
9,382,401,261,1044,1372
10,396,383,267,1046,1372
11,448,400,266,1114,1372
1,500,200,50,750,1373
2,453,239,107,799,1373
3,416,274,141,831,1373
4,392,298,155,845,1373
5,393,320,183,896,1373
6,435,326,213,974,1373
7,417,342,222,981,1373
8,416,347,239,1002,1373
9,396,383,241,1020,1373
10,393,393,273,1059,1373
11,400,394,280,1074,1373
1,500,200,50,750,1374
2,455,234,97,786,1374
3,434,262,137,833,1374
4,418,284,178,880,1374
5,400,323,193,916,1374
6,394,319,238,951,1374
7,396,343,233,972,1374
8,412,360,238,1010,1374
9,389,374,261,1024,1374
10,388,397,276,1061,1374
11,373,425,282,1080,1374
1,500,200,50,750,1375
2,452,225,105,782,1375
3,411,279,141,831,1375
4,378,325,165,868,1375
5,410,306,207,923,1375
6,409,307,237,953,1375
7,407,331,240,978,1375
8,397,354,247,998,1375
9,415,389,244,1048,1375
10,407,402,244,1053,1375
11,446,388,245,1079,1375
1,500,200,50,750,1376
2,454,231,98,783,1376
3,442,260,134,836,1376
4,407,277,169,853,1376
5,427,298,204,929,1376
6,436,326,200,962,1376
7,400,345,232,977,1376
8,416,360,250,1026,1376
9,397,341,277,1015,1376
10,405,362,275,1042,1376
11,408,381,292,1081,1376
1,500,200,50,750,1377
2,453,241,91,785,1377
3,442,236,144,822,1377
4,424,270,152,846,1377
5,414,318,178,910,1377
6,414,327,219,960,1377
7,416,330,234,980,1377
8,404,357,251,1012,1377
9,375,384,258,1017,1377
10,402,394,267,1063,1377
11,421,406,270,1097,1377
1,500,200,50,750,1378
2,450,243,97,790,1378
3,420,269,132,821,1378
4,381,331,152,864,1378
5,392,327,196,915,1378
6,381,353,231,965,1378
7,368,362,244,974,1378
8,366,354,257,977,1378
9,399,380,260,1039,1378
10,405,388,267,1060,1378
11,413,408,249,1070,1378
1,500,200,50,750,1379
2,444,237,100,781,1379
3,447,236,152,835,1379
4,402,289,162,853,1379
5,425,295,197,917,1379
6,420,334,207,961,1379
7,378,341,260,979,1379
8,392,338,269,999,1379
9,405,370,257,1032,1379
10,416,375,273,1064,1379
11,412,403,274,1089,1379
1,500,200,50,750,1380
2,458,225,100,783,1380
3,458,269,121,848,1380
4,427,272,161,860,1380
5,432,301,179,912,1380
6,418,337,201,956,1380
7,413,362,202,977,1380
8,409,353,237,999,1380
9,417,354,269,1040,1380
10,388,396,270,1054,1380
11,386,407,286,1079,1380
1,500,200,50,750,1381
2,458,226,98,782,1381
3,444,255,137,836,1381
4,407,285,180,872,1381
5,414,322,186,922,1381
6,401,336,213,950,1381
7,408,345,239,992,1381
8,399,372,225,996,1381
9,403,381,254,1038,1381
10,421,403,252,1076,1381
11,405,421,262,1088,1381
1,500,200,50,750,1382
2,459,236,93,788,1382
3,410,283,137,830,1382
4,410,283,171,864,1382
5,409,309,193,911,1382
6,429,321,218,968,1382
7,414,331,252,997,1382
8,387,371,250,1008,1382
9,391,390,251,1032,1382
10,411,388,261,1060,1382
11,423,411,264,1098,1382
1,500,200,50,750,1383
2,484,229,87,800,1383
3,437,237,142,816,1383
4,424,297,147,868,1383
5,409,334,174,917,1383
6,401,340,215,956,1383
7,409,348,229,986,1383
8,394,367,242,1003,1383
9,394,391,239,1024,1383
10,392,423,247,1062,1383
11,422,403,277,1102,1383
1,500,200,50,750,1384
2,449,238,102,789,1384
3,411,277,148,836,1384
4,395,319,166,880,1384
5,387,315,215,917,1384
6,402,323,223,948,1384
7,401,340,229,970,1384
8,382,376,245,1003,1384
9,397,383,259,1039,1384
10,392,387,269,1048,1384
11,404,400,285,1089,1384
1,500,200,50,750,1385
2,472,231,81,784,1385
3,433,248,134,815,1385
4,431,282,159,872,1385
5,428,321,167,916,1385
6,428,319,196,943,1385
7,447,355,199,1001,1385
8,417,383,206,1006,1385
9,419,378,230,1027,1385
10,431,379,255,1065,1385
11,402,393,276,1071,1385
1,500,200,50,750,1386
2,447,247,92,786,1386
3,424,273,126,823,1386
4,414,307,146,867,1386
5,394,317,193,904,1386
6,378,379,197,954,1386
7,370,396,210,976,1386
8,372,405,237,1014,1386
9,363,420,253,1036,1386
10,360,421,283,1064,1386
11,363,415,305,1083,1386
1,500,200,50,750,1387
2,433,268,93,794,1387
3,403,295,129,827,1387
4,395,315,166,876,1387
5,400,324,201,925,1387
6,393,357,197,947,1387
7,411,359,209,979,1387
8,409,360,225,994,1387
9,410,376,237,1023,1387
10,428,375,255,1058,1387
11,388,420,265,1073,1387
1,500,200,50,750,1388
2,434,253,95,782,1388
3,420,277,142,839,1388
4,393,299,171,863,1388
5,389,325,189,903,1388
6,395,331,233,959,1388
7,394,345,251,990,1388
8,380,364,263,1007,1388
9,371,363,292,1026,1388
10,370,376,307,1053,1388
11,379,404,313,1096,1388
1,500,200,50,750,1389
2,451,250,92,793,1389
3,431,274,128,833,1389
4,417,302,156,875,1389
5,410,322,178,910,1389
6,396,344,218,958,1389
7,398,342,251,991,1389
8,383,373,249,1005,1389
9,402,388,246,1036,1389
10,404,397,266,1067,1389
11,390,396,284,1070,1389
1,500,200,50,750,1390
2,459,214,111,784,1390
3,425,258,144,827,1390
4,412,298,165,875,1390
5,394,330,189,913,1390
6,408,347,210,965,1390
7,377,361,231,969,1390
8,371,396,245,1012,1390
9,347,426,252,1025,1390
10,327,434,279,1040,1390
11,358,447,287,1092,1390
1,500,200,50,750,1391
2,455,239,85,779,1391
3,446,263,125,834,1391
4,438,285,158,881,1391
5,403,330,167,900,1391
6,419,373,190,982,1391
7,408,353,210,971,1391
8,410,389,227,1026,1391
9,393,371,261,1025,1391
10,417,421,242,1080,1391
11,389,418,264,1071,1391
1,500,200,50,750,1392
2,472,235,94,801,1392
3,445,268,123,836,1392
4,416,306,135,857,1392
5,414,313,179,906,1392
6,416,353,188,957,1392
7,397,351,218,966,1392
8,391,373,234,998,1392
9,376,404,256,1036,1392
10,366,438,263,1067,1392
11,367,443,273,1083,1392
1,500,200,50,750,1393
2,438,222,115,775,1393
3,418,261,164,843,1393
4,383,294,191,868,1393
5,377,328,199,904,1393
6,402,357,205,964,1393
7,409,351,231,991,1393
8,383,366,256,1005,1393
9,398,358,265,1021,1393
10,422,386,265,1073,1393
11,420,376,277,1073,1393
1,500,200,50,750,1394
2,486,214,105,805,1394
3,455,241,137,833,1394
4,432,268,170,870,1394
5,424,294,196,914,1394
6,416,316,215,947,1394
7,409,343,229,981,1394
8,413,343,253,1009,1394
9,413,360,252,1025,1394
10,410,385,276,1071,1394
11,434,392,272,1098,1394
1,500,200,50,750,1395
2,469,232,93,794,1395
3,444,271,123,838,1395
4,387,310,168,865,1395
5,384,346,180,910,1395
6,378,369,213,960,1395
7,384,377,236,997,1395
8,381,368,242,991,1395
9,390,397,262,1049,1395
10,389,383,281,1053,1395
11,411,380,298,1089,1395
1,500,200,50,750,1396
2,459,233,94,786,1396
3,433,266,128,827,1396
4,412,293,174,879,1396
5,405,312,200,917,1396
6,404,339,216,959,1396
7,394,376,222,992,1396
8,383,371,259,1013,1396
9,384,370,269,1023,1396
10,388,400,251,1039,1396
11,384,425,258,1067,1396
1,500,200,50,750,1397
2,456,222,100,778,1397
3,428,252,145,825,1397
4,431,273,171,875,1397
5,422,304,199,925,1397
6,416,335,197,948,1397
7,381,352,234,967,1397
8,383,373,244,1000,1397
9,381,390,267,1038,1397
10,380,416,271,1067,1397
11,405,439,249,1093,1397
1,500,200,50,750,1398
2,453,228,103,784,1398
3,420,252,143,815,1398
4,420,269,179,868,1398
5,415,318,173,906,1398
6,407,338,216,961,1398
7,401,372,230,1003,1398
8,402,358,249,1009,1398
9,387,385,261,1033,1398
10,381,393,278,1052,1398
11,390,414,287,1091,1398
1,500,200,50,750,1399
2,441,239,102,782,1399
3,425,249,141,815,1399
4,426,284,167,877,1399
5,415,293,197,905,1399
6,410,303,231,944,1399
7,410,332,238,980,1399
8,393,372,246,1011,1399
9,381,379,268,1028,1399
10,389,383,282,1054,1399
11,406,384,295,1085,1399
1,500,200,50,750,1400
2,453,221,118,792,1400
3,420,263,151,834,1400
4,414,295,170,879,1400
5,407,317,199,923,1400
6,386,340,217,943,1400
7,387,365,229,981,1400
8,393,370,243,1006,1400
9,389,394,243,1026,1400
10,409,388,255,1052,1400
11,408,425,258,1091,1400
1,500,200,50,750,1401
2,438,243,115,796,1401
3,399,272,136,807,1401
4,399,271,175,845,1401
5,392,321,191,904,1401
6,382,355,216,953,1401
7,373,362,241,976,1401
8,397,386,239,1022,1401
9,387,390,256,1033,1401
10,404,403,258,1065,1401
11,393,399,283,1075,1401
1,500,200,50,750,1402
2,467,231,88,786,1402
3,438,256,132,826,1402
4,425,296,151,872,1402
5,419,312,178,909,1402
6,410,331,204,945,1402
7,405,356,226,987,1402
8,390,385,228,1003,1402
9,386,408,239,1033,1402
10,405,381,275,1061,1402
11,380,418,265,1063,1402
1,500,200,50,750,1403
2,479,228,83,790,1403
3,461,231,133,825,1403
4,430,279,154,863,1403
5,419,303,189,911,1403
6,423,313,220,956,1403
7,414,347,216,977,1403
8,400,357,248,1005,1403
9,408,362,261,1031,1403
10,417,384,262,1063,1403
11,421,373,291,1085,1403
1,500,200,50,750,1404
2,446,237,104,787,1404
3,405,281,134,820,1404
4,412,311,167,890,1404
5,381,341,183,905,1404
6,379,367,213,959,1404
7,363,372,233,968,1404
8,365,399,239,1003,1404
9,349,427,250,1026,1404
10,376,405,273,1054,1404
11,387,438,257,1082,1404
1,500,200,50,750,1405
2,455,239,85,779,1405
3,438,279,116,833,1405
4,425,292,146,863,1405
5,408,326,196,930,1405
6,402,344,219,965,1405
7,385,355,232,972,1405
8,373,386,232,991,1405
9,372,389,254,1015,1405
10,392,416,248,1056,1405
11,419,416,250,1085,1405
1,500,200,50,750,1406
2,459,243,86,788,1406
3,446,280,114,840,1406
4,432,265,166,863,1406
5,427,305,181,913,1406
6,405,326,216,947,1406
7,412,337,243,992,1406
8,396,353,262,1011,1406
9,430,352,270,1052,1406
10,413,373,266,1052,1406
11,426,385,263,1074,1406
1,500,200,50,750,1407
2,451,253,86,790,1407
3,423,270,128,821,1407
4,416,295,155,866,1407
5,404,338,168,910,1407
6,419,344,200,963,1407
7,419,349,216,984,1407
8,401,334,252,987,1407
9,412,368,249,1029,1407
10,406,400,251,1057,1407
11,433,399,254,1086,1407
1,500,200,50,750,1408
2,450,236,97,783,1408
3,424,262,137,823,1408
4,410,289,178,877,1408
5,380,335,210,925,1408
6,378,352,233,963,1408
7,382,353,257,992,1408
8,389,381,240,1010,1408
9,386,386,251,1023,1408
10,414,376,265,1055,1408
11,428,425,254,1107,1408
1,500,200,50,750,1409
2,466,237,97,800,1409
3,429,262,134,825,1409
4,403,289,167,859,1409
5,401,331,191,923,1409
6,393,366,197,956,1409
7,372,384,218,974,1409
8,364,401,246,1011,1409
9,371,402,235,1008,1409
10,386,409,263,1058,1409
11,388,431,263,1082,1409
1,500,200,50,750,1410
2,458,226,100,784,1410
3,435,255,127,817,1410
4,411,281,156,848,1410
5,416,307,185,908,1410
6,411,330,212,953,1410
7,411,336,244,991,1410
8,404,371,248,1023,1410
9,383,387,263,1033,1410
10,407,385,272,1064,1410
11,393,418,275,1086,1410
1,500,200,50,750,1411
2,461,223,108,792,1411
3,441,269,140,850,1411
4,404,300,172,876,1411
5,415,307,197,919,1411
6,405,329,216,950,1411
7,417,349,217,983,1411
8,418,375,216,1009,1411
9,403,380,249,1032,1411
10,409,396,260,1065,1411
11,422,404,248,1074,1411
1,500,200,50,750,1412
2,440,246,104,790,1412
3,424,258,143,825,1412
4,413,276,173,862,1412
5,412,311,186,909,1412
6,417,327,219,963,1412
7,391,360,242,993,1412
8,381,382,245,1008,1412
9,390,400,247,1037,1412
10,398,411,243,1052,1412
11,405,419,269,1093,1412
1,500,200,50,750,1413
2,453,236,100,789,1413
3,418,268,134,820,1413
4,397,296,173,866,1413
5,415,313,191,919,1413
6,427,332,208,967,1413
7,403,352,235,990,1413
8,384,380,247,1011,1413
9,389,384,255,1028,1413
10,387,393,263,1043,1413
11,421,390,273,1084,1413
1,500,200,50,750,1414
2,463,236,96,795,1414
3,440,264,134,838,1414
4,428,254,184,866,1414
5,434,298,183,915,1414
6,397,338,211,946,1414
7,393,364,224,981,1414
8,404,359,242,1005,1414
9,406,390,255,1051,1414
10,412,386,271,1069,1414
11,403,408,265,1076,1414
1,500,200,50,750,1415
2,456,244,95,795,1415
3,421,269,126,816,1415
4,406,304,162,872,1415
5,400,343,182,925,1415
6,395,360,217,972,1415
7,365,367,242,974,1415
8,373,369,261,1003,1415
9,374,401,249,1024,1415
10,378,407,272,1057,1415
11,392,414,290,1096,1415
1,500,200,50,750,1416
2,466,227,95,788,1416
3,447,253,134,834,1416
4,410,267,178,855,1416
5,425,298,195,918,1416
6,417,335,211,963,1416
7,418,343,209,970,1416
8,392,385,218,995,1416
9,398,413,215,1026,1416
10,399,421,242,1062,1416
11,394,448,255,1097,1416
1,500,200,50,750,1417
2,440,252,100,792,1417
3,412,277,134,823,1417
4,402,282,186,870,1417
5,413,300,206,919,1417
6,401,341,220,962,1417
7,412,333,238,983,1417
8,395,349,263,1007,1417
9,385,386,261,1032,1417
10,400,386,265,1051,1417
11,396,396,283,1075,1417
1,500,200,50,750,1418
2,460,233,90,783,1418
3,425,267,134,826,1418
4,403,296,166,865,1418
5,415,303,199,917,1418
6,407,362,198,967,1418
7,389,380,211,980,1418
8,396,401,219,1016,1418
9,387,399,233,1019,1418
10,410,405,249,1064,1418
11,398,407,270,1075,1418
1,500,200,50,750,1419
2,445,245,96,786,1419
3,417,274,127,818,1419
4,419,297,156,872,1419
5,404,318,185,907,1419
6,396,355,218,969,1419
7,379,367,239,985,1419
8,386,382,248,1016,1419
9,375,375,266,1016,1419
10,400,394,273,1067,1419
11,393,390,305,1088,1419
1,500,200,50,750,1420
2,448,240,84,772,1420
3,409,274,122,805,1420
4,415,303,153,871,1420
5,398,312,195,905,1420
6,383,350,212,945,1420
7,378,371,228,977,1420
8,388,369,254,1011,1420
9,387,378,268,1033,1420
10,391,382,273,1046,1420
11,407,423,267,1097,1420
1,500,200,50,750,1421
2,440,230,111,781,1421
3,433,261,133,827,1421
4,408,299,170,877,1421
5,417,317,190,924,1421
6,404,329,217,950,1421
7,381,349,248,978,1421
8,366,373,267,1006,1421
9,383,373,267,1023,1421
10,409,379,280,1068,1421
11,414,383,291,1088,1421
1,500,200,50,750,1422
2,448,223,112,783,1422
3,417,256,148,821,1422
4,424,274,179,877,1422
5,385,312,201,898,1422
6,413,341,214,968,1422
7,390,356,243,989,1422
8,370,393,258,1021,1422
9,365,395,274,1034,1422
10,363,395,296,1054,1422
11,380,395,290,1065,1422
1,500,200,50,750,1423
2,451,234,107,792,1423
3,425,259,137,821,1423
4,415,290,164,869,1423
5,408,320,172,900,1423
6,423,327,219,969,1423
7,413,336,238,987,1423
8,404,367,247,1018,1423
9,381,397,254,1032,1423
10,391,407,275,1073,1423
11,400,392,293,1085,1423
1,500,200,50,750,1424
2,462,223,94,779,1424
3,427,258,138,823,1424
4,422,294,156,872,1424
5,422,334,156,912,1424
6,419,348,188,955,1424
7,404,358,214,976,1424
8,388,374,236,998,1424
9,404,371,255,1030,1424
10,402,409,248,1059,1424
11,403,426,261,1090,1424
1,500,200,50,750,1425
2,438,235,103,776,1425
3,424,275,126,825,1425
4,417,291,154,862,1425
5,409,328,168,905,1425
6,390,357,188,935,1425
7,400,361,193,954,1425
8,396,362,227,985,1425
9,418,389,222,1029,1425
10,412,411,237,1060,1425
11,409,416,259,1084,1425
1,500,200,50,750,1426
2,464,227,97,788,1426
3,442,255,131,828,1426
4,425,278,168,871,1426
5,415,298,182,895,1426
6,414,331,199,944,1426
7,429,343,221,993,1426
8,407,340,254,1001,1426
9,417,356,264,1037,1426
10,401,383,283,1067,1426
11,390,413,271,1074,1426
1,500,200,50,750,1427
2,467,246,79,792,1427
3,453,258,117,828,1427
4,428,281,143,852,1427
5,426,324,171,921,1427
6,417,344,181,942,1427
7,428,347,206,981,1427
8,406,366,239,1011,1427
9,407,375,235,1017,1427
10,425,406,238,1069,1427
11,405,407,260,1072,1427
1,500,200,50,750,1428
2,462,225,110,797,1428
3,452,250,132,834,1428
4,417,284,161,862,1428
5,417,319,181,917,1428
6,402,347,190,939,1428
7,391,360,217,968,1428
8,403,369,224,996,1428
9,408,392,229,1029,1428
10,430,393,247,1070,1428
11,413,413,257,1083,1428
1,500,200,50,750,1429
2,467,224,110,801,1429
3,422,247,153,822,1429
4,405,284,173,862,1429
5,415,305,195,915,1429
6,409,332,210,951,1429
7,382,362,225,969,1429
8,372,392,249,1013,1429
9,367,412,249,1028,1429
10,376,398,273,1047,1429
11,394,405,294,1093,1429
1,500,200,50,750,1430
2,461,232,100,793,1430
3,424,255,141,820,1430
4,410,302,174,886,1430
5,401,315,202,918,1430
6,401,333,218,952,1430
7,383,328,257,968,1430
8,381,359,265,1005,1430
9,402,359,268,1029,1430
10,440,369,279,1088,1430
11,414,373,288,1075,1430
1,500,200,50,750,1431
2,452,229,95,776,1431
3,426,244,152,822,1431
4,417,292,171,880,1431
5,405,307,192,904,1431
6,394,337,216,947,1431
7,396,356,230,982,1431
8,384,387,231,1002,1431
9,368,415,250,1033,1431
10,377,420,258,1055,1431
11,375,434,290,1099,1431
1,500,200,50,750,1432
2,474,237,99,810,1432
3,427,257,134,818,1432
4,415,285,175,875,1432
5,428,316,193,937,1432
6,425,302,231,958,1432
7,388,347,241,976,1432
8,367,398,240,1005,1432
9,397,389,254,1040,1432
10,402,394,269,1065,1432
11,405,404,275,1084,1432
1,500,200,50,750,1433
2,442,244,102,788,1433
3,427,270,134,831,1433
4,397,292,167,856,1433
5,396,320,194,910,1433
6,382,342,227,951,1433
7,371,351,266,988,1433
8,355,379,260,994,1433
9,371,380,273,1024,1433
10,362,413,276,1051,1433
11,355,455,280,1090,1433
1,500,200,50,750,1434
2,466,224,101,791,1434
3,444,257,129,830,1434
4,417,285,160,862,1434
5,430,290,191,911,1434
6,401,322,210,933,1434
7,391,353,233,977,1434
8,369,390,235,994,1434
9,386,401,256,1043,1434
10,385,409,263,1057,1434
11,376,429,275,1080,1434
1,500,200,50,750,1435
2,465,231,86,782,1435
3,419,265,127,811,1435
4,401,296,176,873,1435
5,384,322,209,915,1435
6,403,326,225,954,1435
7,381,350,243,974,1435
8,382,377,239,998,1435
9,408,391,251,1050,1435
10,401,372,275,1048,1435
11,386,413,282,1081,1435
1,500,200,50,750,1436
2,466,231,93,790,1436
3,417,266,133,816,1436
4,431,277,160,868,1436
5,408,290,196,894,1436
6,434,336,219,989,1436
7,403,343,232,978,1436
8,397,355,244,996,1436
9,389,390,265,1044,1436
10,387,415,262,1064,1436
11,392,418,271,1081,1436
1,500,200,50,750,1437
2,453,220,112,785,1437
3,431,239,151,821,1437
4,430,287,173,890,1437
5,401,328,184,913,1437
6,413,352,197,962,1437
7,384,365,228,977,1437
8,392,376,251,1019,1437
9,374,388,262,1024,1437
10,391,413,268,1072,1437
11,396,413,282,1091,1437
1,500,200,50,750,1438
2,466,223,99,788,1438
3,432,258,128,818,1438
4,429,285,149,863,1438
5,410,311,190,911,1438
6,400,330,204,934,1438
7,407,343,220,970,1438
8,417,365,233,1015,1438
9,420,389,244,1053,1438
10,416,409,245,1070,1438
11,421,399,269,1089,1438
1,500,200,50,750,1439
2,468,228,93,789,1439
3,427,268,131,826,1439
4,404,300,163,867,1439
5,420,301,202,923,1439
6,404,329,224,957,1439
7,402,359,250,1011,1439
8,387,355,255,997,1439
9,407,361,258,1026,1439
10,404,404,259,1067,1439
11,380,408,288,1076,1439
1,500,200,50,750,1440
2,452,230,106,788,1440
3,415,273,135,823,1440
4,404,303,166,873,1440
5,399,321,198,918,1440
6,397,339,210,946,1440
7,388,334,249,971,1440
8,382,382,243,1007,1440
9,368,390,263,1021,1440
10,399,395,258,1052,1440
11,403,416,272,1091,1440
1,500,200,50,750,1441
2,445,237,103,785,1441
3,417,266,143,826,1441
4,399,294,179,872,1441
5,408,341,186,935,1441
6,421,311,225,957,1441
7,392,338,238,968,1441
8,406,350,247,1003,1441
9,389,355,260,1004,1441
10,413,377,250,1040,1441
11,430,415,244,1089,1441
1,500,200,50,750,1442
2,460,230,94,784,1442
3,459,238,137,834,1442
4,431,273,164,868,1442
5,414,313,190,917,1442
6,426,322,222,970,1442
7,401,348,241,990,1442
8,384,375,246,1005,1442
9,383,395,265,1043,1442
10,369,406,289,1064,1442
11,359,420,301,1080,1442
1,500,200,50,750,1443
2,441,239,107,787,1443
3,431,269,134,834,1443
4,416,305,156,877,1443
5,414,303,190,907,1443
6,405,332,222,959,1443
7,402,347,229,978,1443
8,398,356,248,1002,1443
9,384,383,267,1034,1443
10,385,384,291,1060,1443
11,391,418,291,1100,1443
1,500,200,50,750,1444
2,471,221,102,794,1444
3,451,229,144,824,1444
4,430,258,175,863,1444
5,413,306,200,919,1444
6,418,314,228,960,1444
7,395,346,228,969,1444
8,411,363,241,1015,1444
9,411,372,258,1041,1444
10,398,393,263,1054,1444
11,389,395,297,1081,1444
1,500,200,50,750,1445
2,442,246,94,782,1445
3,397,279,138,814,1445
4,392,300,169,861,1445
5,389,368,173,930,1445
6,374,366,209,949,1445
7,364,382,230,976,1445
8,369,389,243,1001,1445
9,379,406,261,1046,1445
10,392,389,279,1060,1445
11,396,406,284,1086,1445
1,500,200,50,750,1446
2,463,232,85,780,1446
3,412,262,145,819,1446
4,400,267,185,852,1446
5,397,297,215,909,1446
6,418,319,220,957,1446
7,393,360,242,995,1446
8,378,389,243,1010,1446
9,367,396,261,1024,1446
10,387,389,283,1059,1446
11,409,398,268,1075,1446
1,500,200,50,750,1447
2,451,236,107,794,1447
3,432,261,142,835,1447
4,414,283,187,884,1447
5,397,305,205,907,1447
6,391,314,238,943,1447
7,403,341,253,997,1447
8,401,345,253,999,1447
9,382,375,255,1012,1447
10,409,387,274,1070,1447
11,401,406,268,1075,1447
1,500,200,50,750,1448
2,465,243,79,787,1448
3,434,258,133,825,1448
4,425,287,169,881,1448
5,403,314,193,910,1448
6,425,329,211,965,1448
7,404,350,222,976,1448
8,395,373,242,1010,1448
9,393,369,240,1002,1448
10,412,390,252,1054,1448
11,428,400,268,1096,1448
1,500,200,50,750,1449
2,465,230,101,796,1449
3,430,261,140,831,1449
4,429,281,157,867,1449
5,396,312,196,904,1449
6,415,318,227,960,1449
7,384,331,250,965,1449
8,405,342,263,1010,1449
9,397,364,276,1037,1449
10,386,378,299,1063,1449
11,374,387,301,1062,1449
1,500,200,50,750,1450
2,472,228,99,799,1450
3,433,253,151,837,1450
4,398,294,189,881,1450
5,379,301,216,896,1450
6,391,336,237,964,1450
7,369,363,251,983,1450
8,364,403,251,1018,1450
9,350,398,264,1012,1450
10,372,414,260,1046,1450
11,370,440,281,1091,1450
1,500,200,50,750,1451
2,462,226,100,788,1451
3,452,241,145,838,1451
4,424,266,159,849,1451
5,409,313,179,901,1451
6,414,339,220,973,1451
7,383,362,231,976,1451
8,397,359,256,1012,1451
9,397,389,259,1045,1451
10,381,412,279,1072,1451
11,378,427,291,1096,1451
1,500,200,50,750,1452
2,467,228,88,783,1452
3,447,265,118,830,1452
4,429,296,159,884,1452
5,403,319,187,909,1452
6,389,341,231,961,1452
7,369,361,243,973,1452
8,366,384,264,1014,1452
9,373,390,267,1030,1452
10,356,414,297,1067,1452
11,352,426,288,1066,1452
1,500,200,50,750,1453
2,460,220,108,788,1453
3,446,262,126,834,1453
4,400,303,160,863,1453
5,403,344,187,934,1453
6,399,359,202,960,1453
7,380,367,231,978,1453
8,403,346,272,1021,1453
9,392,381,248,1021,1453
10,415,397,257,1069,1453
11,417,410,260,1087,1453
1,500,200,50,750,1454
2,472,215,102,789,1454
3,440,259,126,825,1454
4,418,289,157,864,1454
5,410,318,182,910,1454
6,420,307,213,940,1454
7,409,345,225,979,1454
8,402,332,261,995,1454
9,404,352,281,1037,1454
10,390,388,289,1067,1454
11,393,414,284,1091,1454
1,500,200,50,750,1455
2,456,249,78,783,1455
3,450,257,137,844,1455
4,431,275,152,858,1455
5,433,299,167,899,1455
6,440,345,182,967,1455
7,435,347,193,975,1455
8,416,341,239,996,1455
9,415,366,255,1036,1455
10,421,391,256,1068,1455
11,414,407,259,1080,1455
1,500,200,50,750,1456
2,448,237,103,788,1456
3,425,283,128,836,1456
4,385,312,168,865,1456
5,364,312,213,889,1456
6,380,355,206,941,1456
7,379,363,229,971,1456
8,375,388,229,992,1456
9,373,411,248,1032,1456
10,414,395,256,1065,1456
11,394,405,272,1071,1456
1,500,200,50,750,1457
2,468,220,100,788,1457
3,426,247,137,810,1457
4,410,277,172,859,1457
5,401,328,187,916,1457
6,394,350,205,949,1457
7,401,365,220,986,1457
8,403,378,232,1013,1457
9,408,390,251,1049,1457
10,395,406,242,1043,1457
11,398,402,275,1075,1457
1,500,200,50,750,1458
2,466,239,84,789,1458
3,449,272,113,834,1458
4,409,292,167,868,1458
5,403,315,181,899,1458
6,403,363,194,960,1458
7,391,373,214,978,1458
8,397,382,235,1014,1458
9,383,388,248,1019,1458
10,379,403,278,1060,1458
11,376,409,290,1075,1458
1,500,200,50,750,1459
2,452,235,98,785,1459
3,423,252,144,819,1459
4,430,286,170,886,1459
5,415,314,176,905,1459
6,410,346,196,952,1459
7,387,359,232,978,1459
8,400,370,248,1018,1459
9,374,381,278,1033,1459
10,391,390,284,1065,1459
11,381,421,269,1071,1459
1,500,200,50,750,1460
2,450,240,94,784,1460
3,432,263,145,840,1460
4,416,282,162,860,1460
5,428,310,206,944,1460
6,417,338,212,967,1460
7,372,385,217,974,1460
8,396,384,238,1018,1460
9,365,399,264,1028,1460
10,367,416,276,1059,1460
11,358,440,285,1083,1460
1,500,200,50,750,1461
2,452,236,94,782,1461
3,407,294,123,824,1461
4,403,309,155,867,1461
5,384,342,170,896,1461
6,406,329,214,949,1461
7,411,338,222,971,1461
8,405,346,254,1005,1461
9,414,367,255,1036,1461
10,416,390,259,1065,1461
11,406,414,272,1092,1461
1,500,200,50,750,1462
2,440,236,101,777,1462
3,408,250,144,802,1462
4,420,289,173,882,1462
5,413,310,198,921,1462
6,413,321,225,959,1462
7,408,350,224,982,1462
8,406,367,239,1012,1462
9,401,381,270,1052,1462
10,389,395,272,1056,1462
11,374,406,299,1079,1462
1,500,200,50,750,1463
2,462,235,88,785,1463
3,452,259,138,849,1463
4,450,240,178,868,1463
5,427,305,191,923,1463
6,427,317,218,962,1463
7,419,333,227,979,1463
8,430,338,261,1029,1463
9,419,356,258,1033,1463
10,408,377,276,1061,1463
11,385,407,268,1060,1463
1,500,200,50,750,1464
2,454,247,90,791,1464
3,417,275,132,824,1464
4,397,311,164,872,1464
5,376,350,179,905,1464
6,418,350,202,970,1464
7,408,347,227,982,1464
8,399,378,229,1006,1464
9,391,414,247,1052,1464
10,393,418,247,1058,1464
11,384,407,277,1068,1464
1,500,200,50,750,1465
2,463,241,88,792,1465
3,436,279,117,832,1465
4,403,295,166,864,1465
5,412,319,188,919,1465
6,435,333,204,972,1465
7,401,334,234,969,1465
8,420,365,241,1026,1465
9,406,387,242,1035,1465
10,372,418,253,1043,1465
11,385,426,271,1082,1465
1,500,200,50,750,1466
2,442,239,91,772,1466
3,445,253,134,832,1466
4,411,290,167,868,1466
5,397,297,199,893,1466
6,410,314,216,940,1466
7,432,324,224,980,1466
8,425,363,232,1020,1466
9,415,381,236,1032,1466
10,433,363,268,1064,1466
11,425,387,275,1087,1466
1,500,200,50,750,1467
2,475,233,91,799,1467
3,446,232,132,810,1467
4,444,273,150,867,1467
5,434,301,172,907,1467
6,444,336,191,971,1467
7,390,346,236,972,1467
8,400,362,261,1023,1467
9,404,357,290,1051,1467
10,402,378,282,1062,1467
11,411,393,286,1090,1467
1,500,200,50,750,1468
2,454,231,101,786,1468
3,413,264,142,819,1468
4,407,294,177,878,1468
5,407,315,189,911,1468
6,410,350,223,983,1468
7,397,354,225,976,1468
8,395,363,251,1009,1468
9,382,387,261,1030,1468
10,379,399,274,1052,1468
11,389,402,296,1087,1468
1,500,200,50,750,1469
2,470,220,95,785,1469
3,447,254,136,837,1469
4,439,288,151,878,1469
5,443,301,179,923,1469
6,440,327,178,945,1469
7,442,333,206,981,1469
8,424,347,239,1010,1469
9,390,394,245,1029,1469
10,379,408,261,1048,1469
11,396,409,277,1082,1469
1,500,200,50,750,1470
2,455,221,104,780,1470
3,414,262,150,826,1470
4,418,293,161,872,1470
5,417,310,194,921,1470
6,424,344,196,964,1470
7,413,345,218,976,1470
8,419,371,230,1020,1470
9,391,419,228,1038,1470
10,403,402,244,1049,1470
11,409,411,260,1080,1470
1,500,200,50,750,1471
2,462,231,104,797,1471
3,431,261,128,820,1471
4,417,299,147,863,1471
5,400,343,165,908,1471
6,419,336,195,950,1471
7,406,344,227,977,1471
8,422,364,235,1021,1471
9,418,370,246,1034,1471
10,410,403,241,1054,1471
11,404,414,273,1091,1471
1,500,200,50,750,1472
2,431,243,108,782,1472
3,385,296,145,826,1472
4,365,320,181,866,1472
5,369,333,214,916,1472
6,367,361,227,955,1472
7,366,364,242,972,1472
8,371,387,255,1013,1472
9,363,403,257,1023,1472
10,385,420,255,1060,1472
11,387,440,257,1084,1472
1,500,200,50,750,1473
2,486,216,94,796,1473
3,431,238,149,818,1473
4,415,266,186,867,1473
5,431,307,183,921,1473
6,419,332,200,951,1473
7,434,349,219,1002,1473
8,435,353,225,1013,1473
9,432,345,249,1026,1473
10,429,383,251,1063,1473
11,419,419,259,1097,1473
1,500,200,50,750,1474
2,444,236,99,779,1474
3,425,268,128,821,1474
4,413,289,161,863,1474
5,384,303,209,896,1474
6,407,323,217,947,1474
7,418,324,232,974,1474
8,397,341,245,983,1474
9,432,358,255,1045,1474
10,402,384,257,1043,1474
11,416,420,255,1091,1474
1,500,200,50,750,1475
2,453,225,110,788,1475
3,432,256,150,838,1475
4,419,280,167,866,1475
5,419,302,191,912,1475
6,412,354,192,958,1475
7,416,357,215,988,1475
8,393,358,233,984,1475
9,431,390,229,1050,1475
10,409,391,251,1051,1475
11,424,375,296,1095,1475
1,500,200,50,750,1476
2,471,235,91,797,1476
3,437,251,140,828,1476
4,406,274,175,855,1476
5,413,313,180,906,1476
6,415,346,203,964,1476
7,402,352,229,983,1476
8,388,371,246,1005,1476
9,396,391,257,1044,1476
10,393,385,277,1055,1476
11,425,374,299,1098,1476
1,500,200,50,750,1477
2,453,230,102,785,1477
3,421,274,132,827,1477
4,414,287,176,877,1477
5,394,318,193,905,1477
6,384,372,206,962,1477
7,382,368,236,986,1477
8,393,367,246,1006,1477
9,407,353,266,1026,1477
10,425,351,277,1053,1477
11,427,372,298,1097,1477
1,500,200,50,750,1478
2,450,235,93,778,1478
3,433,274,127,834,1478
4,422,297,158,877,1478
5,400,313,197,910,1478
6,381,344,230,955,1478
7,365,368,243,976,1478
8,370,380,259,1009,1478
9,395,404,248,1047,1478
10,401,416,256,1073,1478
11,377,429,270,1076,1478
1,500,200,50,750,1479
2,452,218,112,782,1479
3,416,264,134,814,1479
4,401,284,175,860,1479
5,420,306,185,911,1479
6,433,321,211,965,1479
7,419,341,223,983,1479
8,408,351,246,1005,1479
9,405,372,269,1046,1479
10,382,394,279,1055,1479
11,390,403,283,1076,1479
1,500,200,50,750,1480
2,470,239,100,809,1480
3,411,263,145,819,1480
4,415,296,172,883,1480
5,392,296,218,906,1480
6,390,320,243,953,1480
7,382,359,252,993,1480
8,379,365,274,1018,1480
9,375,354,273,1002,1480
10,400,392,285,1077,1480
11,373,412,294,1079,1480
1,500,200,50,750,1481
2,459,233,101,793,1481
3,424,254,148,826,1481
4,420,255,177,852,1481
5,415,295,203,913,1481
6,417,314,203,934,1481
7,408,339,239,986,1481
8,409,345,253,1007,1481
9,391,361,267,1019,1481
10,404,401,252,1057,1481
11,443,389,276,1108,1481
1,500,200,50,750,1482
2,465,234,91,790,1482
3,442,244,131,817,1482
4,432,295,157,884,1482
5,407,339,188,934,1482
6,406,339,213,958,1482
7,397,339,243,979,1482
8,395,371,262,1028,1482
9,373,380,280,1033,1482
10,378,400,280,1058,1482
11,397,409,276,1082,1482
1,500,200,50,750,1483
2,456,222,104,782,1483
3,431,243,159,833,1483
4,435,278,172,885,1483
5,424,291,202,917,1483
6,430,319,206,955,1483
7,397,358,226,981,1483
8,400,372,227,999,1483
9,405,359,260,1024,1483
10,412,376,273,1061,1483
11,423,412,253,1088,1483
1,500,200,50,750,1484
2,463,237,84,784,1484
3,423,273,126,822,1484
4,401,296,177,874,1484
5,391,320,198,909,1484
6,372,368,215,955,1484
7,380,390,215,985,1484
8,403,402,218,1023,1484
9,382,406,248,1036,1484
10,391,396,276,1063,1484
11,408,420,267,1095,1484
1,500,200,50,750,1485
2,481,223,94,798,1485
3,449,265,120,834,1485
4,436,290,148,874,1485
5,433,300,170,903,1485
6,428,337,190,955,1485
7,405,365,206,976,1485
8,412,369,226,1007,1485
9,408,374,249,1031,1485
10,409,380,285,1074,1485
11,396,386,307,1089,1485
1,500,200,50,750,1486
2,450,232,106,788,1486
3,413,259,132,804,1486
4,406,293,170,869,1486
5,398,321,208,927,1486
6,397,321,237,955,1486
7,397,334,249,980,1486
8,395,328,278,1001,1486
9,384,359,284,1027,1486
10,395,400,258,1053,1486
11,404,420,260,1084,1486
1,500,200,50,750,1487
2,471,217,101,789,1487
3,434,258,133,825,1487
4,436,280,173,889,1487
5,422,296,181,899,1487
6,434,324,208,966,1487
7,410,358,219,987,1487
8,391,359,255,1005,1487
9,389,366,274,1029,1487
10,399,386,270,1055,1487
11,396,389,289,1074,1487
1,500,200,50,750,1488
2,446,240,102,788,1488
3,405,283,137,825,1488
4,394,294,173,861,1488
5,393,303,196,892,1488
6,412,348,196,956,1488
7,401,346,215,962,1488
8,406,381,222,1009,1488
9,408,387,239,1034,1488
10,384,403,278,1065,1488
11,383,411,278,1072,1488
1,500,200,50,750,1489
2,466,212,99,777,1489
3,446,247,132,825,1489
4,430,286,152,868,1489
5,402,313,197,912,1489
6,434,318,224,976,1489
7,413,362,216,991,1489
8,390,391,227,1008,1489
9,400,394,240,1034,1489
10,374,407,262,1043,1489
11,389,428,268,1085,1489
1,500,200,50,750,1490
2,475,221,98,794,1490
3,446,247,140,833,1490
4,419,268,181,868,1490
5,408,299,204,911,1490
6,421,300,234,955,1490
7,427,325,232,984,1490
8,428,345,231,1004,1490
9,429,365,233,1027,1490
10,421,387,225,1033,1490
11,453,398,253,1104,1490
1,500,200,50,750,1491
2,448,241,94,783,1491
3,414,285,140,839,1491
4,405,302,162,869,1491
5,407,316,193,916,1491
6,389,343,216,948,1491
7,390,372,238,1000,1491
8,375,365,264,1004,1491
9,389,383,274,1046,1491
10,371,403,267,1041,1491
11,399,423,266,1088,1491
1,500,200,50,750,1492
2,460,223,96,779,1492
3,456,239,135,830,1492
4,425,252,178,855,1492
5,394,284,217,895,1492
6,445,318,215,978,1492
7,411,338,233,982,1492
8,412,352,251,1015,1492
9,393,383,263,1039,1492
10,384,403,264,1051,1492
11,390,428,273,1091,1492
1,500,200,50,750,1493
2,456,220,101,777,1493
3,438,274,129,841,1493
4,409,303,157,869,1493
5,406,329,175,910,1493
6,417,339,189,945,1493
7,398,367,216,981,1493
8,386,389,237,1012,1493
9,388,392,246,1026,1493
10,381,408,267,1056,1493
11,376,432,268,1076,1493
1,500,200,50,750,1494
2,478,224,92,794,1494
3,459,244,122,825,1494
4,434,282,146,862,1494
5,438,306,174,918,1494
6,435,349,178,962,1494
7,423,359,194,976,1494
8,428,392,220,1040,1494
9,405,363,272,1040,1494
10,410,361,280,1051,1494
11,419,401,277,1097,1494
1,500,200,50,750,1495
2,451,263,85,799,1495
3,420,295,111,826,1495
4,389,304,165,858,1495
5,389,330,182,901,1495
6,406,338,213,957,1495
7,386,356,253,995,1495
8,397,360,256,1013,1495
9,383,360,280,1023,1495
10,392,407,261,1060,1495
11,401,412,272,1085,1495
1,500,200,50,750,1496
2,441,235,94,770,1496
3,425,278,143,846,1496
4,398,273,189,860,1496
5,418,295,189,902,1496
6,416,319,221,956,1496
7,381,348,240,969,1496
8,403,377,232,1012,1496
9,402,397,241,1040,1496
10,391,394,260,1045,1496
11,396,416,273,1085,1496
1,500,200,50,750,1497
2,430,264,87,781,1497
3,402,278,158,838,1497
4,405,276,186,867,1497
5,396,312,196,904,1497
6,410,343,203,956,1497
7,387,356,229,972,1497
8,376,371,249,996,1497
9,401,385,241,1027,1497
10,400,412,252,1064,1497
11,413,416,273,1102,1497
1,500,200,50,750,1498
2,455,219,117,791,1498
3,412,265,141,818,1498
4,400,296,176,872,1498
5,388,328,190,906,1498
6,374,341,221,936,1498
7,389,367,241,997,1498
8,377,370,258,1005,1498
9,362,388,262,1012,1498
10,369,399,285,1053,1498
11,372,412,298,1082,1498
1,500,200,50,750,1499
2,444,233,102,779,1499
3,430,263,126,819,1499
4,414,309,162,885,1499
5,392,343,168,903,1499
6,390,355,204,949,1499
7,385,374,216,975,1499
8,406,365,254,1025,1499
9,387,380,257,1024,1499
10,383,386,284,1053,1499
11,390,409,266,1065,1499
1,500,200,50,750,1500
2,441,250,93,784,1500
3,413,274,144,831,1500
4,405,292,168,865,1500
5,403,313,182,898,1500
6,413,332,207,952,1500
7,399,372,225,996,1500
8,406,356,243,1005,1500
9,402,377,255,1034,1500
10,400,387,263,1050,1500
11,414,402,276,1092,1500
1,500,200,50,750,1501
2,462,232,92,786,1501
3,428,267,136,831,1501
4,418,275,162,855,1501
5,413,303,185,901,1501
6,410,327,221,958,1501
7,396,347,241,984,1501
8,395,365,239,999,1501
9,414,370,253,1037,1501
10,428,388,259,1075,1501
11,421,387,271,1079,1501
1,500,200,50,750,1502
2,457,234,101,792,1502
3,414,267,144,825,1502
4,402,287,175,864,1502
5,379,309,225,913,1502
6,385,351,223,959,1502
7,380,368,233,981,1502
8,373,397,230,1000,1502
9,382,412,232,1026,1502
10,385,427,243,1055,1502
11,384,428,270,1082,1502
1,500,200,50,750,1503
2,445,237,94,776,1503
3,429,290,118,837,1503
4,390,312,162,864,1503
5,393,334,169,896,1503
6,425,347,192,964,1503
7,418,350,219,987,1503
8,402,364,239,1005,1503
9,378,390,256,1024,1503
10,399,384,290,1073,1503
11,390,410,269,1069,1503
1,500,200,50,750,1504
2,471,223,92,786,1504
3,445,244,139,828,1504
4,428,290,158,876,1504
5,423,321,170,914,1504
6,412,391,157,960,1504
7,395,384,203,982,1504
8,385,401,223,1009,1504
9,381,400,251,1032,1504
10,395,395,278,1068,1504
11,385,423,283,1091,1504
1,500,200,50,750,1505
2,450,233,103,786,1505
3,427,260,123,810,1505
4,423,289,148,860,1505
5,397,314,196,907,1505
6,384,334,231,949,1505
7,380,347,240,967,1505
8,386,388,232,1006,1505
9,406,381,250,1037,1505
10,386,384,280,1050,1505
11,380,421,287,1088,1505
1,500,200,50,750,1506
2,459,248,90,797,1506
3,413,273,134,820,1506
4,406,291,185,882,1506
5,408,316,205,929,1506
6,406,337,205,948,1506
7,405,351,224,980,1506
8,403,371,226,1000,1506
9,388,368,271,1027,1506
10,386,389,278,1053,1506
11,381,394,296,1071,1506
1,500,200,50,750,1507
2,455,230,88,773,1507
3,403,256,142,801,1507
4,433,254,170,857,1507
5,420,306,185,911,1507
6,400,321,234,955,1507
7,375,357,253,985,1507
8,387,372,262,1021,1507
9,387,359,268,1014,1507
10,383,398,279,1060,1507
11,384,412,286,1082,1507
1,500,200,50,750,1508
2,464,232,93,789,1508
3,409,254,138,801,1508
4,415,286,159,860,1508
5,428,285,196,909,1508
6,413,330,215,958,1508
7,411,355,227,993,1508
8,400,366,243,1009,1508
9,402,361,285,1048,1508
10,381,385,290,1056,1508
11,397,393,277,1067,1508
1,500,200,50,750,1509
2,456,228,98,782,1509
3,451,255,133,839,1509
4,459,262,156,877,1509
5,445,298,170,913,1509
6,415,348,205,968,1509
7,383,364,236,983,1509
8,382,378,233,993,1509
9,384,396,255,1035,1509
10,377,413,252,1042,1509
11,386,425,257,1068,1509
1,500,200,50,750,1510
2,459,245,93,797,1510
3,413,278,132,823,1510
4,422,285,172,879,1510
5,425,294,196,915,1510
6,412,325,215,952,1510
7,416,327,232,975,1510
8,409,338,242,989,1510
9,418,360,247,1025,1510
10,422,378,268,1068,1510
11,412,381,273,1066,1510
1,500,200,50,750,1511
2,468,213,110,791,1511
3,448,227,154,829,1511
4,423,257,173,853,1511
5,428,290,191,909,1511
6,414,287,242,943,1511
7,406,331,240,977,1511
8,392,362,258,1012,1511
9,415,383,242,1040,1511
10,394,402,248,1044,1511
11,374,413,274,1061,1511
1,500,200,50,750,1512
2,459,224,100,783,1512
3,418,259,139,816,1512
4,432,283,166,881,1512
5,402,334,175,911,1512
6,384,340,239,963,1512
7,388,357,242,987,1512
8,386,372,248,1006,1512
9,379,387,246,1012,1512
10,408,395,256,1059,1512
11,408,414,269,1091,1512
1,500,200,50,750,1513
2,471,222,97,790,1513
3,436,248,139,823,1513
4,429,295,165,889,1513
5,398,302,193,893,1513
6,407,343,210,960,1513
7,372,386,222,980,1513
8,369,417,223,1009,1513
9,371,408,244,1023,1513
10,391,398,248,1037,1513
11,415,398,270,1083,1513
1,500,200,50,750,1514
2,446,243,99,788,1514
3,438,266,139,843,1514
4,406,314,139,859,1514
5,398,343,167,908,1514
6,408,348,190,946,1514
7,418,375,204,997,1514
8,415,370,221,1006,1514
9,406,381,238,1025,1514
10,406,387,276,1069,1514
11,413,395,275,1083,1514
1,500,200,50,750,1515
2,459,243,82,784,1515
3,432,262,137,831,1515
4,409,292,165,866,1515
5,393,318,192,903,1515
6,414,332,226,972,1515
7,395,370,233,998,1515
8,390,374,240,1004,1515
9,402,402,230,1034,1515
10,403,396,256,1055,1515
11,399,416,247,1062,1515
1,500,200,50,750,1516
2,468,232,93,793,1516
3,437,252,127,816,1516
4,427,278,169,874,1516
5,411,304,184,899,1516
6,427,308,221,956,1516
7,433,340,223,996,1516
8,440,338,232,1010,1516
9,427,355,248,1030,1516
10,422,359,265,1046,1516
11,429,381,289,1099,1516
1,500,200,50,750,1517
2,446,234,100,780,1517
3,426,248,141,815,1517
4,423,285,162,870,1517
5,404,312,194,910,1517
6,401,352,190,943,1517
7,396,356,227,979,1517
8,405,362,245,1012,1517
9,390,375,251,1016,1517
10,373,413,258,1044,1517
11,378,417,268,1063,1517
1,500,200,50,750,1518
2,491,217,101,809,1518
3,452,248,134,834,1518
4,434,276,159,869,1518
5,431,299,179,909,1518
6,408,349,200,957,1518
7,389,360,226,975,1518
8,398,347,246,991,1518
9,389,378,243,1010,1518
10,422,387,250,1059,1518
11,413,403,259,1075,1518
1,500,200,50,750,1519
2,460,211,112,783,1519
3,437,254,133,824,1519
4,423,291,152,866,1519
5,411,318,186,915,1519
6,397,354,203,954,1519
7,409,354,225,988,1519
8,386,373,250,1009,1519
9,374,405,247,1026,1519
10,386,418,254,1058,1519
11,409,409,270,1088,1519
1,500,200,50,750,1520
2,465,231,100,796,1520
3,431,258,133,822,1520
4,414,277,161,852,1520
5,423,305,194,922,1520
6,422,306,240,968,1520
7,401,339,247,987,1520
8,391,342,270,1003,1520
9,387,377,272,1036,1520
10,374,412,275,1061,1520
11,380,407,293,1080,1520
1,500,200,50,750,1521
2,466,233,102,801,1521
3,432,262,144,838,1521
4,431,293,160,884,1521
5,430,318,184,932,1521
6,417,341,209,967,1521
7,391,368,220,979,1521
8,381,387,217,985,1521
9,394,359,274,1027,1521
10,398,389,270,1057,1521
11,398,390,279,1067,1521
1,500,200,50,750,1522
2,454,222,111,787,1522
3,412,253,164,829,1522
4,409,287,179,875,1522
5,431,312,183,926,1522
6,435,339,189,963,1522
7,409,343,226,978,1522
8,410,359,252,1021,1522
9,397,370,266,1033,1522
10,393,399,256,1048,1522
11,406,420,259,1085,1522
1,500,200,50,750,1523
2,459,239,93,791,1523
3,426,262,139,827,1523
4,429,270,165,864,1523
5,423,306,198,927,1523
6,423,308,232,963,1523
7,408,330,245,983,1523
8,398,364,248,1010,1523
9,389,383,270,1042,1523
10,374,390,284,1048,1523
11,401,407,291,1099,1523
1,500,200,50,750,1524
2,477,226,97,800,1524
3,442,267,127,836,1524
4,412,288,156,856,1524
5,441,300,184,925,1524
6,444,310,214,968,1524
7,428,318,240,986,1524
8,413,353,248,1014,1524
9,404,379,240,1023,1524
10,398,389,266,1053,1524
11,389,429,265,1083,1524
1,500,200,50,750,1525
2,449,226,101,776,1525
3,448,270,131,849,1525
4,419,285,160,864,1525
5,436,297,198,931,1525
6,423,341,216,980,1525
7,397,370,222,989,1525
8,397,363,255,1015,1525
9,388,376,258,1022,1525
10,403,403,269,1075,1525
11,387,397,293,1077,1525
1,500,200,50,750,1526
2,441,251,101,793,1526
3,407,274,155,836,1526
4,409,311,154,874,1526
5,404,320,186,910,1526
6,397,327,222,946,1526
7,407,335,240,982,1526
8,376,356,266,998,1526
9,362,395,263,1020,1526
10,386,396,270,1052,1526
11,413,421,272,1106,1526
1,500,200,50,750,1527
2,457,232,97,786,1527
3,413,263,144,820,1527
4,390,266,185,841,1527
5,426,309,197,932,1527
6,404,331,214,949,1527
7,391,361,223,975,1527
8,396,364,254,1014,1527
9,381,366,280,1027,1527
10,393,391,267,1051,1527
11,401,417,286,1104,1527
1,500,200,50,750,1528
2,449,233,104,786,1528
3,423,275,131,829,1528
4,421,298,159,878,1528
5,399,329,189,917,1528
6,394,358,210,962,1528
7,414,338,235,987,1528
8,403,371,245,1019,1528
9,376,376,264,1016,1528
10,382,373,301,1056,1528
11,398,392,287,1077,1528
1,500,200,50,750,1529
2,460,224,94,778,1529
3,439,261,122,822,1529
4,438,295,140,873,1529
5,417,310,179,906,1529
6,417,333,209,959,1529
7,408,343,225,976,1529
8,429,355,243,1027,1529
9,406,376,237,1019,1529
10,425,407,227,1059,1529
11,412,413,255,1080,1529
1,500,200,50,750,1530
2,465,233,98,796,1530
3,425,249,146,820,1530
4,406,287,165,858,1530
5,429,330,177,936,1530
6,425,349,213,987,1530
7,380,375,226,981,1530
8,384,380,240,1004,1530
9,370,396,259,1025,1530
10,352,400,279,1031,1530
11,417,399,275,1091,1530
1,500,200,50,750,1531
2,451,240,106,797,1531
3,419,271,139,829,1531
4,399,305,167,871,1531
5,385,313,208,906,1531
6,373,339,239,951,1531
7,365,360,250,975,1531
8,390,362,254,1006,1531
9,424,374,244,1042,1531
10,401,395,258,1054,1531
11,396,389,279,1064,1531
1,500,200,50,750,1532
2,455,249,100,804,1532
3,422,263,137,822,1532
4,404,293,178,875,1532
5,424,319,182,925,1532
6,408,342,209,959,1532
7,408,358,214,980,1532
8,409,373,223,1005,1532
9,401,401,236,1038,1532
10,406,406,248,1060,1532
11,398,407,275,1080,1532
1,500,200,50,750,1533
2,448,233,108,789,1533
3,405,260,154,819,1533
4,393,287,174,854,1533
5,395,327,180,902,1533
6,413,357,194,964,1533
7,395,387,205,987,1533
8,391,390,244,1025,1533
9,383,389,266,1038,1533
10,409,401,261,1071,1533
11,384,427,272,1083,1533
1,500,200,50,750,1534
2,451,258,94,803,1534
3,418,288,124,830,1534
4,407,298,171,876,1534
5,394,322,199,915,1534
6,399,351,226,976,1534
7,390,352,233,975,1534
8,364,378,252,994,1534
9,363,405,260,1028,1534
10,372,398,275,1045,1534
11,384,423,281,1088,1534
1,500,200,50,750,1535
2,452,241,88,781,1535
3,445,259,123,827,1535
4,409,296,168,873,1535
5,410,315,176,901,1535
6,395,324,217,936,1535
7,398,333,231,962,1535
8,389,367,247,1003,1535
9,395,381,257,1033,1535
10,404,401,263,1068,1535
11,411,404,275,1090,1535
1,500,200,50,750,1536
2,443,232,100,775,1536
3,415,253,163,831,1536
4,386,300,186,872,1536
5,364,334,210,908,1536
6,386,338,237,961,1536
7,376,354,252,982,1536
8,380,365,265,1010,1536
9,360,385,259,1004,1536
10,380,407,264,1051,1536
11,399,395,280,1074,1536
1,500,200,50,750,1537
2,446,252,104,802,1537
3,433,251,143,827,1537
4,410,306,156,872,1537
5,420,316,194,930,1537
6,415,333,207,955,1537
7,403,355,233,991,1537
8,404,364,245,1013,1537
9,411,368,262,1041,1537
10,398,403,264,1065,1537
11,380,413,275,1068,1537
1,500,200,50,750,1538
2,450,227,107,784,1538
3,397,289,136,822,1538
4,427,281,156,864,1538
5,426,301,189,916,1538
6,413,313,213,939,1538
7,426,325,214,965,1538
8,426,348,238,1012,1538
9,414,373,244,1031,1538
10,419,372,267,1058,1538
11,429,389,289,1107,1538
1,500,200,50,750,1539
2,474,213,104,791,1539
3,430,266,128,824,1539
4,399,303,178,880,1539
5,394,327,200,921,1539
6,378,345,225,948,1539
7,392,359,229,980,1539
8,387,374,248,1009,1539
9,380,402,244,1026,1539
10,372,427,262,1061,1539
11,384,413,291,1088,1539
1,500,200,50,750,1540
2,453,243,98,794,1540
3,403,291,131,825,1540
4,388,298,174,860,1540
5,372,321,205,898,1540
6,397,363,199,959,1540
7,400,352,212,964,1540
8,404,381,241,1026,1540
9,394,378,252,1024,1540
10,417,379,261,1057,1540
11,425,376,281,1082,1540
1,500,200,50,750,1541
2,463,217,101,781,1541
3,435,261,139,835,1541
4,417,296,166,879,1541
5,398,310,202,910,1541
6,411,334,227,972,1541
7,381,365,230,976,1541
8,382,378,239,999,1541
9,380,382,257,1019,1541
10,376,419,273,1068,1541
11,384,425,266,1075,1541
1,500,200,50,750,1542
2,460,232,94,786,1542
3,420,266,141,827,1542
4,403,275,182,860,1542
5,391,321,193,905,1542
6,380,341,226,947,1542
7,382,365,240,987,1542
8,378,367,261,1006,1542
9,391,407,255,1053,1542
10,376,405,282,1063,1542
11,390,406,296,1092,1542
1,500,200,50,750,1543
2,465,235,91,791,1543
3,415,264,132,811,1543
4,412,294,163,869,1543
5,405,336,176,917,1543
6,404,350,216,970,1543
7,389,373,230,992,1543
8,384,391,236,1011,1543
9,378,407,241,1026,1543
10,410,392,238,1040,1543
11,439,393,266,1098,1543
1,500,200,50,750,1544
2,464,223,93,780,1544
3,440,258,143,841,1544
4,434,280,153,867,1544
5,400,302,201,903,1544
6,417,344,199,960,1544
7,411,363,210,984,1544
8,397,367,232,996,1544
9,391,388,260,1039,1544
10,375,406,276,1057,1544
11,374,413,286,1073,1544
1,500,200,50,750,1545
2,444,238,100,782,1545
3,416,265,153,834,1545
4,393,296,171,860,1545
5,411,319,195,925,1545
6,431,333,194,958,1545
7,416,374,198,988,1545
8,410,375,239,1024,1545
9,401,368,261,1030,1545
10,390,390,279,1059,1545
11,385,411,290,1086,1545
1,500,200,50,750,1546
2,474,230,99,803,1546
3,409,268,137,814,1546
4,412,292,156,860,1546
5,407,326,169,902,1546
6,396,357,203,956,1546
7,404,365,230,999,1546
8,399,378,226,1003,1546
9,397,371,266,1034,1546
10,392,387,285,1064,1546
11,396,392,294,1082,1546
1,500,200,50,750,1547
2,459,238,81,778,1547
3,427,276,130,833,1547
4,394,299,168,861,1547
5,405,328,186,919,1547
6,412,372,201,985,1547
7,399,343,228,970,1547
8,400,366,256,1022,1547
9,397,372,262,1031,1547
10,403,392,265,1060,1547
11,413,391,274,1078,1547
1,500,200,50,750,1548
2,472,230,104,806,1548
3,432,245,150,827,1548
4,406,282,170,858,1548
5,408,291,200,899,1548
6,422,329,209,960,1548
7,409,366,205,980,1548
8,403,387,216,1006,1548
9,409,376,240,1025,1548
10,415,385,248,1048,1548
11,436,411,259,1106,1548
1,500,200,50,750,1549
2,464,244,93,801,1549
3,421,270,136,827,1549
4,387,296,195,878,1549
5,393,320,217,930,1549
6,389,349,236,974,1549
7,383,374,228,985,1549
8,373,390,237,1000,1549
9,362,405,253,1020,1549
10,361,408,264,1033,1549
11,382,411,285,1078,1549
1,500,200,50,750,1550
2,468,236,86,790,1550
3,446,256,129,831,1550
4,428,271,171,870,1550
5,381,319,173,873,1550
6,396,363,195,954,1550
7,377,391,220,988,1550
8,373,391,238,1002,1550
9,400,368,259,1027,1550
10,401,387,254,1042,1550
11,405,401,270,1076,1550
1,500,200,50,750,1551
2,471,228,100,799,1551
3,452,246,134,832,1551
4,417,287,170,874,1551
5,396,331,196,923,1551
6,387,344,229,960,1551
7,388,362,225,975,1551
8,395,376,251,1022,1551
9,375,384,275,1034,1551
10,377,390,288,1055,1551
11,386,415,280,1081,1551
1,500,200,50,750,1552
2,460,251,93,804,1552
3,433,245,153,831,1552
4,403,283,177,863,1552
5,413,280,210,903,1552
6,435,303,210,948,1552
7,411,341,225,977,1552
8,411,351,254,1016,1552
9,397,372,247,1016,1552
10,408,393,252,1053,1552
11,401,400,285,1086,1552
1,500,200,50,750,1553
2,461,233,96,790,1553
3,424,264,142,830,1553
4,411,282,162,855,1553
5,417,318,168,903,1553
6,428,342,194,964,1553
7,405,345,215,965,1553
8,406,371,231,1008,1553
9,394,381,247,1022,1553
10,390,422,241,1053,1553
11,391,446,237,1074,1553
1,500,200,50,750,1554
2,447,232,88,767,1554
3,418,258,145,821,1554
4,411,283,164,858,1554
5,435,310,190,935,1554
6,422,329,207,958,1554
7,422,321,246,989,1554
8,414,351,236,1001,1554
9,398,367,265,1030,1554
10,411,395,257,1063,1554
11,402,391,281,1074,1554
1,500,200,50,750,1555
2,462,237,89,788,1555
3,435,243,143,821,1555
4,422,279,169,870,1555
5,411,323,175,909,1555
6,403,368,187,958,1555
7,389,377,218,984,1555
8,370,394,248,1012,1555
9,375,390,274,1039,1555
10,367,399,268,1034,1555
11,407,420,266,1093,1555
1,500,200,50,750,1556
2,467,221,101,789,1556
3,429,256,136,821,1556
4,421,295,143,859,1556
5,399,343,170,912,1556
6,409,339,215,963,1556
7,415,363,215,993,1556
8,418,371,224,1013,1556
9,406,391,231,1028,1556
10,402,413,241,1056,1556
11,413,427,262,1102,1556
1,500,200,50,750,1557
2,462,236,103,801,1557
3,435,242,153,830,1557
4,421,256,187,864,1557
5,411,302,197,910,1557
6,399,351,201,951,1557
7,377,368,223,968,1557
8,381,412,230,1023,1557
9,347,433,243,1023,1557
10,373,414,287,1074,1557
11,384,429,270,1083,1557
1,500,200,50,750,1558
2,441,240,92,773,1558
3,429,270,126,825,1558
4,416,293,170,879,1558
5,396,319,204,919,1558
6,392,329,227,948,1558
7,388,366,226,980,1558
8,383,376,257,1016,1558
9,396,360,283,1039,1558
10,389,374,286,1049,1558
11,399,386,295,1080,1558
1,500,200,50,750,1559
2,453,239,104,796,1559
3,427,252,144,823,1559
4,426,285,171,882,1559
5,411,312,186,909,1559
6,409,355,193,957,1559
7,408,384,200,992,1559
8,410,383,225,1018,1559
9,393,392,243,1028,1559
10,373,399,272,1044,1559
11,414,415,267,1096,1559
1,500,200,50,750,1560
2,477,225,82,784,1560
3,445,263,117,825,1560
4,441,272,149,862,1560
5,419,322,184,925,1560
6,436,332,201,969,1560
7,424,362,206,992,1560
8,392,341,257,990,1560
9,386,385,259,1030,1560
10,380,405,266,1051,1560
11,379,432,276,1087,1560
1,500,200,50,750,1561
2,461,242,92,795,1561
3,448,248,131,827,1561
4,423,277,170,870,1561
5,413,304,199,916,1561
6,421,327,205,953,1561
7,401,351,232,984,1561
8,392,384,249,1025,1561
9,400,388,259,1047,1561
10,367,435,255,1057,1561
11,365,431,276,1072,1561
1,500,200,50,750,1562
2,466,241,88,795,1562
3,444,251,118,813,1562
4,443,287,140,870,1562
5,450,298,177,925,1562
6,417,337,201,955,1562
7,382,372,236,990,1562
8,392,390,227,1009,1562
9,396,396,250,1042,1562
10,389,398,276,1063,1562
11,390,401,279,1070,1562
1,500,200,50,750,1563
2,463,227,87,777,1563
3,436,263,129,828,1563
4,434,278,159,871,1563
5,411,329,182,922,1563
6,409,348,200,957,1563
7,425,350,209,984,1563
8,418,376,220,1014,1563
9,414,382,250,1046,1563
10,393,393,263,1049,1563
11,397,389,298,1084,1563
1,500,200,50,750,1564
2,453,235,101,789,1564
3,435,268,129,832,1564
4,420,288,161,869,1564
5,403,321,191,915,1564
6,402,365,199,966,1564
7,394,372,224,990,1564
8,403,380,227,1010,1564
9,387,395,248,1030,1564
10,387,400,265,1052,1564
11,401,389,283,1073,1564
1,500,200,50,750,1565
2,472,236,95,803,1565
3,431,275,122,828,1565
4,416,296,149,861,1565
5,399,327,189,915,1565
6,401,354,206,961,1565
7,381,376,215,972,1565
8,395,371,240,1006,1565
9,387,395,251,1033,1565
10,392,410,254,1056,1565
11,395,407,285,1087,1565
1,500,200,50,750,1566
2,452,241,101,794,1566
3,409,278,148,835,1566
4,380,282,189,851,1566
5,412,334,196,942,1566
6,380,341,227,948,1566
7,385,361,238,984,1566
8,396,383,227,1006,1566
9,389,400,246,1035,1566
10,391,390,269,1050,1566
11,383,412,287,1082,1566
1,500,200,50,750,1567
2,449,243,99,791,1567
3,437,259,136,832,1567
4,414,296,165,875,1567
5,406,313,199,918,1567
6,411,348,205,964,1567
7,409,346,228,983,1567
8,405,368,236,1009,1567
9,375,393,255,1023,1567
10,387,397,266,1050,1567
11,397,417,263,1077,1567
1,500,200,50,750,1568
2,450,236,106,792,1568
3,405,273,143,821,1568
4,405,296,172,873,1568
5,387,320,194,901,1568
6,404,346,209,959,1568
7,393,370,220,983,1568
8,411,397,220,1028,1568
9,389,396,238,1023,1568
10,403,388,266,1057,1568
11,414,397,268,1079,1568
1,500,200,50,750,1569
2,450,233,97,780,1569
3,445,243,128,816,1569
4,404,291,171,866,1569
5,411,342,173,926,1569
6,401,361,184,946,1569
7,395,361,213,969,1569
8,421,366,241,1028,1569
9,390,394,240,1024,1569
10,401,409,261,1071,1569
11,397,406,287,1090,1569
1,500,200,50,750,1570
2,463,239,94,796,1570
3,442,264,130,836,1570
4,397,277,171,845,1570
5,403,319,187,909,1570
6,410,347,218,975,1570
7,381,345,253,979,1570
8,391,366,258,1015,1570
9,371,374,278,1023,1570
10,373,408,265,1046,1570
11,400,420,275,1095,1570
1,500,200,50,750,1571
2,469,222,96,787,1571
3,420,258,142,820,1571
4,427,272,176,875,1571
5,438,282,202,922,1571
6,427,318,216,961,1571
7,410,343,239,992,1571
8,394,388,238,1020,1571
9,395,398,235,1028,1571
10,419,407,236,1062,1571
11,399,417,264,1080,1571
1,500,200,50,750,1572
2,465,216,104,785,1572
3,426,267,136,829,1572
4,400,300,159,859,1572
5,392,335,194,921,1572
6,393,350,211,954,1572
7,399,360,232,991,1572
8,379,370,242,991,1572
9,389,380,259,1028,1572
10,394,404,252,1050,1572
11,408,384,275,1067,1572
1,500,200,50,750,1573
2,444,242,100,786,1573
3,426,267,141,834,1573
4,391,305,165,861,1573
5,409,329,192,930,1573
6,393,341,216,950,1573
7,401,349,233,983,1573
8,395,370,244,1009,1573
9,371,376,265,1012,1573
10,390,400,280,1070,1573
11,375,410,280,1065,1573
1,500,200,50,750,1574
2,447,249,94,790,1574
3,445,272,113,830,1574
4,415,301,149,865,1574
5,384,331,178,893,1574
6,398,347,207,952,1574
7,388,369,220,977,1574
8,403,374,242,1019,1574
9,392,376,256,1024,1574
10,414,394,248,1056,1574
11,427,404,261,1092,1574
1,500,200,50,750,1575
2,466,222,96,784,1575
3,445,244,135,824,1575
4,436,271,165,872,1575
5,394,312,207,913,1575
6,402,337,225,964,1575
7,371,361,254,986,1575
8,363,391,242,996,1575
9,378,403,254,1035,1575
10,391,401,284,1076,1575
11,375,428,274,1077,1575
1,500,200,50,750,1576
2,468,221,90,779,1576
3,424,255,127,806,1576
4,435,264,166,865,1576
5,412,282,202,896,1576
6,422,329,210,961,1576
7,393,375,209,977,1576
8,378,392,233,1003,1576
9,369,399,263,1031,1576
10,365,422,266,1053,1576
11,370,429,279,1078,1576
1,500,200,50,750,1577
2,468,230,100,798,1577
3,407,260,145,812,1577
4,394,312,171,877,1577
5,414,328,187,929,1577
6,415,350,201,966,1577
7,403,370,222,995,1577
8,391,382,239,1012,1577
9,373,418,220,1011,1577
10,402,418,243,1063,1577
11,403,420,265,1088,1577
1,500,200,50,750,1578
2,452,238,100,790,1578
3,411,285,116,812,1578
4,412,304,154,870,1578
5,405,339,166,910,1578
6,406,345,214,965,1578
7,401,369,221,991,1578
8,390,371,231,992,1578
9,389,369,255,1013,1578
10,389,394,283,1066,1578
11,382,419,286,1087,1578
1,500,200,50,750,1579
2,452,237,101,790,1579
3,421,282,130,833,1579
4,397,306,172,875,1579
5,388,298,214,900,1579
6,398,350,201,949,1579
7,383,380,230,993,1579
8,376,390,236,1002,1579
9,390,407,229,1026,1579
10,403,412,247,1062,1579
11,406,393,269,1068,1579
1,500,200,50,750,1580
2,460,230,98,788,1580
3,434,274,121,829,1580
4,410,299,169,878,1580
5,406,310,194,910,1580
6,403,351,205,959,1580
7,404,372,208,984,1580
8,406,377,222,1005,1580
9,392,379,253,1024,1580
10,372,399,280,1051,1580
11,379,398,303,1080,1580
1,500,200,50,750,1581
2,457,220,95,772,1581
3,426,262,126,814,1581
4,426,307,147,880,1581
5,416,326,178,920,1581
6,406,348,190,944,1581
7,416,351,218,985,1581
8,413,339,253,1005,1581
9,408,348,261,1017,1581
10,407,379,264,1050,1581
11,411,373,289,1073,1581
1,500,200,50,750,1582
2,478,237,89,804,1582
3,432,266,122,820,1582
4,446,257,164,867,1582
5,429,301,189,919,1582
6,429,332,189,950,1582
7,448,335,207,990,1582
8,413,349,230,992,1582
9,396,365,239,1000,1582
10,380,397,267,1044,1582
11,435,400,271,1106,1582
1,500,200,50,750,1583
2,437,252,100,789,1583
3,409,294,137,840,1583
4,414,287,174,875,1583
5,402,307,195,904,1583
6,416,338,219,973,1583
7,404,353,227,984,1583
8,396,366,241,1003,1583
9,400,376,261,1037,1583
10,402,406,255,1063,1583
11,410,422,262,1094,1583
1,500,200,50,750,1584
2,461,218,94,773,1584
3,417,273,124,814,1584
4,417,312,160,889,1584
5,397,319,198,914,1584
6,395,334,220,949,1584
7,400,381,213,994,1584
8,393,380,233,1006,1584
9,401,383,261,1045,1584
10,389,383,276,1048,1584
11,384,428,268,1080,1584
1,500,200,50,750,1585
2,473,232,91,796,1585
3,438,257,133,828,1585
4,461,254,154,869,1585
5,434,288,181,903,1585
6,433,313,218,964,1585
7,436,325,247,1008,1585
8,410,342,252,1004,1585
9,406,338,285,1029,1585
10,389,386,276,1051,1585
11,374,392,303,1069,1585
1,500,200,50,750,1586
2,426,247,102,775,1586
3,429,278,133,840,1586
4,408,302,156,866,1586
5,408,325,202,935,1586
6,387,329,227,943,1586
7,397,362,223,982,1586
8,382,356,261,999,1586
9,386,381,275,1042,1586
10,380,397,285,1062,1586
11,400,410,284,1094,1586
1,500,200,50,750,1587
2,460,233,102,795,1587
3,430,246,152,828,1587
4,426,293,157,876,1587
5,401,325,183,909,1587
6,390,357,217,964,1587
7,387,348,252,987,1587
8,378,377,252,1007,1587
9,354,403,275,1032,1587
10,338,413,299,1050,1587
11,344,425,314,1083,1587
1,500,200,50,750,1588
2,457,233,99,789,1588
3,437,268,130,835,1588
4,413,285,168,866,1588
5,415,298,192,905,1588
6,407,331,221,959,1588
7,401,343,245,989,1588
8,389,389,229,1007,1588
9,389,402,248,1039,1588
10,387,422,239,1048,1588
11,401,430,259,1090,1588
1,500,200,50,750,1589
2,466,221,111,798,1589
3,449,233,145,827,1589
4,457,286,149,892,1589
5,422,306,176,904,1589
6,425,328,195,948,1589
7,422,348,215,985,1589
8,415,365,252,1032,1589
9,393,377,273,1043,1589
10,411,390,260,1061,1589
11,402,415,265,1082,1589
1,500,200,50,750,1590
2,479,202,97,778,1590
3,465,234,138,837,1590
4,442,268,163,873,1590
5,424,301,198,923,1590
6,403,339,207,949,1590
7,412,359,221,992,1590
8,395,384,231,1010,1590
9,389,388,257,1034,1590
10,395,402,254,1051,1590
11,401,430,250,1081,1590
1,500,200,50,750,1591
2,466,209,111,786,1591
3,416,263,148,827,1591
4,403,275,185,863,1591
5,401,304,211,916,1591
6,393,350,189,932,1591
7,388,374,214,976,1591
8,384,366,241,991,1591
9,416,384,252,1052,1591
10,413,382,270,1065,1591
11,396,409,265,1070,1591
1,500,200,50,750,1592
2,450,224,112,786,1592
3,427,262,140,829,1592
4,404,278,176,858,1592
5,409,298,196,903,1592
6,405,333,218,956,1592
7,428,339,218,985,1592
8,435,326,246,1007,1592
9,441,353,244,1038,1592
10,436,379,253,1068,1592
11,410,376,286,1072,1592
1,500,200,50,750,1593
2,452,227,92,771,1593
3,440,260,140,840,1593
4,442,274,165,881,1593
5,396,304,202,902,1593
6,398,344,227,969,1593
7,364,357,264,985,1593
8,389,369,262,1020,1593
9,399,387,248,1034,1593
10,411,377,274,1062,1593
11,391,428,269,1088,1593
1,500,200,50,750,1594
2,470,221,100,791,1594
3,429,259,140,828,1594
4,417,275,181,873,1594
5,403,305,198,906,1594
6,419,323,207,949,1594
7,391,354,220,965,1594
8,404,359,256,1019,1594
9,405,354,273,1032,1594
10,413,371,278,1062,1594
11,401,407,267,1075,1594
1,500,200,50,750,1595
2,477,227,78,782,1595
3,453,258,127,838,1595
4,440,295,144,879,1595
5,421,314,164,899,1595
6,417,365,184,966,1595
7,412,382,193,987,1595
8,391,388,232,1011,1595
9,382,396,265,1043,1595
10,404,410,241,1055,1595
11,403,417,240,1060,1595
1,500,200,50,750,1596
2,456,233,92,781,1596
3,431,255,129,815,1596
4,437,294,150,881,1596
5,420,316,173,909,1596
6,442,321,195,958,1596
7,422,313,239,974,1596
8,420,363,235,1018,1596
9,414,375,257,1046,1596
10,411,387,273,1071,1596
11,410,405,273,1088,1596
1,500,200,50,750,1597
2,452,241,96,789,1597
3,395,282,138,815,1597
4,385,319,164,868,1597
5,383,340,193,916,1597
6,390,361,201,952,1597
7,398,352,239,989,1597
8,383,347,258,988,1597
9,376,380,277,1033,1597
10,378,395,280,1053,1597
11,395,418,265,1078,1597
1,500,200,50,750,1598
2,455,239,97,791,1598
3,430,261,136,827,1598
4,409,296,169,874,1598
5,390,310,202,902,1598
6,406,327,223,956,1598
7,409,345,212,966,1598
8,401,374,234,1009,1598
9,390,377,259,1026,1598
10,383,392,282,1057,1598
11,412,394,288,1094,1598
1,500,200,50,750,1599
2,443,238,96,777,1599
3,409,265,147,821,1599
4,407,276,188,871,1599
5,407,305,204,916,1599
6,413,331,223,967,1599
7,395,345,232,972,1599
8,399,373,249,1021,1599
9,376,389,257,1022,1599
10,380,429,251,1060,1599
11,377,446,255,1078,1599
1,500,200,50,750,1600
2,439,238,95,772,1600
3,424,263,122,809,1600
4,411,299,161,871,1600
5,405,311,186,902,1600
6,408,342,200,950,1600
7,411,359,209,979,1600
8,410,370,229,1009,1600
9,400,376,256,1032,1600
10,405,397,237,1039,1600
11,401,419,261,1081,1600
1,500,200,50,750,1601
2,460,235,99,794,1601
3,442,255,134,831,1601
4,431,282,165,878,1601
5,402,336,183,921,1601
6,395,352,206,953,1601
7,399,375,219,993,1601
8,380,373,245,998,1601
9,395,392,248,1035,1601
10,404,417,246,1067,1601
11,393,407,278,1078,1601
1,500,200,50,750,1602
2,465,241,89,795,1602
3,464,249,128,841,1602
4,428,270,163,861,1602
5,426,294,169,889,1602
6,424,328,194,946,1602
7,402,370,211,983,1602
8,388,403,218,1009,1602
9,401,398,232,1031,1602
10,417,411,239,1067,1602
11,396,416,261,1073,1602
1,500,200,50,750,1603
2,446,233,106,785,1603
3,421,251,146,818,1603
4,434,278,175,887,1603
5,432,299,188,919,1603
6,416,305,222,943,1603
7,412,332,235,979,1603
8,418,353,245,1016,1603
9,409,375,254,1038,1603
10,399,391,275,1065,1603
11,408,414,254,1076,1603
1,500,200,50,750,1604
2,456,232,94,782,1604
3,434,245,128,807,1604
4,449,269,144,862,1604
5,439,314,157,910,1604
6,444,331,184,959,1604
7,413,340,225,978,1604
8,402,360,238,1000,1604
9,402,383,259,1044,1604
10,412,391,258,1061,1604
11,398,412,272,1082,1604
1,500,200,50,750,1605
2,460,233,100,793,1605
3,430,243,145,818,1605
4,426,267,174,867,1605
5,419,316,186,921,1605
6,419,344,200,963,1605
7,416,354,218,988,1605
8,411,374,234,1019,1605
9,398,379,244,1021,1605
10,400,391,264,1055,1605
11,395,409,278,1082,1605
1,500,200,50,750,1606
2,467,225,103,795,1606
3,422,266,136,824,1606
4,388,322,159,869,1606
5,390,333,191,914,1606
6,406,355,213,974,1606
7,380,350,249,979,1606
8,378,372,256,1006,1606
9,398,383,272,1053,1606
10,361,400,290,1051,1606
11,389,407,292,1088,1606
1,500,200,50,750,1607
2,459,224,103,786,1607
3,433,257,141,831,1607
4,410,274,168,852,1607
5,424,308,199,931,1607
6,415,332,222,969,1607
7,397,356,229,982,1607
8,377,375,248,1000,1607
9,375,377,272,1024,1607
10,377,404,283,1064,1607
11,376,425,285,1086,1607
1,500,200,50,750,1608
2,470,206,103,779,1608
3,468,230,138,836,1608
4,456,270,154,880,1608
5,445,297,184,926,1608
6,433,339,197,969,1608
7,412,352,211,975,1608
8,396,366,226,988,1608
9,400,385,244,1029,1608
10,407,390,255,1052,1608
11,401,404,267,1072,1608
1,500,200,50,750,1609
2,466,225,92,783,1609
3,451,249,119,819,1609
4,427,268,172,867,1609
5,428,303,189,920,1609
6,409,335,207,951,1609
7,408,346,225,979,1609
8,402,367,249,1018,1609
9,378,384,272,1034,1609
10,370,392,289,1051,1609
11,366,406,308,1080,1609
1,500,200,50,750,1610
2,459,232,83,774,1610
3,434,275,126,835,1610
4,409,294,165,868,1610
5,404,325,187,916,1610
6,383,369,212,964,1610
7,375,374,206,955,1610
8,386,393,231,1010,1610
9,376,411,238,1025,1610
10,381,421,252,1054,1610
11,401,408,276,1085,1610
1,500,200,50,750,1611
2,454,229,106,789,1611
3,437,258,134,829,1611
4,414,288,179,881,1611
5,406,313,187,906,1611
6,412,328,205,945,1611
7,420,344,218,982,1611
8,407,360,231,998,1611
9,418,367,260,1045,1611
10,406,398,248,1052,1611
11,428,405,257,1090,1611
1,500,200,50,750,1612
2,460,224,107,791,1612
3,441,259,137,837,1612
4,421,277,168,866,1612
5,431,313,169,913,1612
6,442,333,193,968,1612
7,404,358,223,985,1612
8,394,369,249,1012,1612
9,388,381,254,1023,1612
10,397,387,281,1065,1612
11,386,408,279,1073,1612
1,500,200,50,750,1613
2,458,235,91,784,1613
3,438,256,124,818,1613
4,440,263,174,877,1613
5,433,298,193,924,1613
6,417,324,210,951,1613
7,400,369,233,1002,1613
8,379,384,235,998,1613
9,403,389,253,1045,1613
10,391,385,278,1054,1613
11,381,415,279,1075,1613
1,500,200,50,750,1614
2,458,216,100,774,1614
3,417,259,138,814,1614
4,397,302,159,858,1614
5,380,349,184,913,1614
6,394,359,208,961,1614
7,392,374,222,988,1614
8,384,377,249,1010,1614
9,372,384,273,1029,1614
10,373,380,295,1048,1614
11,368,413,307,1088,1614
1,500,200,50,750,1615
2,451,238,93,782,1615
3,436,268,116,820,1615
4,399,315,152,866,1615
5,399,322,190,911,1615
6,424,340,206,970,1615
7,394,344,241,979,1615
8,393,349,254,996,1615
9,409,364,252,1025,1615
10,416,396,243,1055,1615
11,399,410,283,1092,1615
1,500,200,50,750,1616
2,452,224,106,782,1616
3,429,249,142,820,1616
4,410,291,164,865,1616
5,393,325,202,920,1616
6,385,354,205,944,1616
7,383,372,211,966,1616
8,379,376,233,988,1616
9,397,392,243,1032,1616
10,405,400,269,1074,1616
11,416,383,279,1078,1616
1,500,200,50,750,1617
2,474,213,98,785,1617
3,463,242,139,844,1617
4,426,263,162,851,1617
5,436,293,179,908,1617
6,413,335,194,942,1617
7,412,351,214,977,1617
8,395,391,229,1015,1617
9,391,393,248,1032,1617
10,393,414,251,1058,1617
11,406,414,268,1088,1617
1,500,200,50,750,1618
2,455,230,101,786,1618
3,432,257,141,830,1618
4,414,275,175,864,1618
5,424,314,176,914,1618
6,419,344,216,979,1618
7,385,354,236,975,1618
8,374,374,246,994,1618
9,366,387,270,1023,1618
10,365,405,269,1039,1618
11,392,423,284,1099,1618
1,500,200,50,750,1619
2,465,232,97,794,1619
3,430,257,142,829,1619
4,436,265,176,877,1619
5,404,300,200,904,1619
6,414,335,216,965,1619
7,399,339,228,966,1619
8,415,363,233,1011,1619
9,419,357,257,1033,1619
10,395,371,263,1029,1619
11,402,405,264,1071,1619
1,500,200,50,750,1620
2,461,235,92,788,1620
3,440,272,118,830,1620
4,419,281,168,868,1620
5,399,309,192,900,1620
6,404,348,206,958,1620
7,396,337,254,987,1620
8,392,348,269,1009,1620
9,381,362,276,1019,1620
10,388,384,289,1061,1620
11,417,387,290,1094,1620
1,500,200,50,750,1621
2,454,225,104,783,1621
3,428,254,144,826,1621
4,409,283,172,864,1621
5,419,309,187,915,1621
6,422,327,206,955,1621
7,414,346,215,975,1621
8,397,377,230,1004,1621
9,414,402,232,1048,1621
10,404,425,234,1063,1621
11,390,411,276,1077,1621
1,500,200,50,750,1622
2,456,237,106,799,1622
3,438,262,125,825,1622
4,422,280,161,863,1622
5,396,316,191,903,1622
6,424,332,206,962,1622
7,411,349,225,985,1622
8,398,346,261,1005,1622
9,421,355,255,1031,1622
10,405,366,281,1052,1622
11,378,394,282,1054,1622
1,500,200,50,750,1623
2,456,231,102,789,1623
3,423,267,139,829,1623
4,405,271,183,859,1623
5,384,308,205,897,1623
6,389,337,235,961,1623
7,375,348,254,977,1623
8,383,343,273,999,1623
9,407,337,287,1031,1623
10,398,376,279,1053,1623
11,397,380,298,1075,1623
1,500,200,50,750,1624
2,473,229,90,792,1624
3,434,252,142,828,1624
4,419,282,172,873,1624
5,433,296,194,923,1624
6,405,338,211,954,1624
7,392,329,241,962,1624
8,412,337,262,1011,1624
9,387,366,266,1019,1624
10,366,402,273,1041,1624
11,395,409,295,1099,1624
1,500,200,50,750,1625
2,474,219,108,801,1625
3,433,254,137,824,1625
4,426,301,142,869,1625
5,403,314,172,889,1625
6,401,354,204,959,1625
7,386,364,223,973,1625
8,372,379,236,987,1625
9,391,394,262,1047,1625
10,372,404,275,1051,1625
11,400,404,284,1088,1625
1,500,200,50,750,1626
2,469,204,99,772,1626
3,460,233,135,828,1626
4,429,286,162,877,1626
5,394,301,207,902,1626
6,404,334,212,950,1626
7,404,360,221,985,1626
8,386,355,259,1000,1626
9,395,384,245,1024,1626
10,399,384,259,1042,1626
11,423,376,281,1080,1626
1,500,200,50,750,1627
2,460,207,112,779,1627
3,445,246,142,833,1627
4,428,283,154,865,1627
5,420,312,172,904,1627
6,422,322,195,939,1627
7,431,326,225,982,1627
8,400,361,250,1011,1627
9,401,356,275,1032,1627
10,393,387,284,1064,1627
11,389,396,284,1069,1627
1,500,200,50,750,1628
2,455,237,94,786,1628
3,427,258,133,818,1628
4,415,293,157,865,1628
5,401,331,177,909,1628
6,397,350,211,958,1628
7,395,376,221,992,1628
8,376,381,227,984,1628
9,411,396,254,1061,1628
10,382,407,263,1052,1628
11,406,402,279,1087,1628
1,500,200,50,750,1629
2,471,231,83,785,1629
3,458,257,121,836,1629
4,455,272,156,883,1629
5,450,278,192,920,1629
6,441,299,213,953,1629
7,414,329,232,975,1629
8,420,351,247,1018,1629
9,434,381,244,1059,1629
10,433,399,232,1064,1629
11,420,386,269,1075,1629
1,500,200,50,750,1630
2,469,238,88,795,1630
3,431,252,143,826,1630
4,406,289,185,880,1630
5,383,329,205,917,1630
6,375,369,220,964,1630
7,363,381,231,975,1630
8,359,402,240,1001,1630
9,365,410,246,1021,1630
10,391,408,271,1070,1630
11,385,414,282,1081,1630
1,500,200,50,750,1631
2,455,218,112,785,1631
3,447,245,142,834,1631
4,432,267,164,863,1631
5,439,301,166,906,1631
6,460,331,183,974,1631
7,425,347,199,971,1631
8,419,379,196,994,1631
9,417,393,229,1039,1631
10,401,371,282,1054,1631
11,411,387,290,1088,1631
1,500,200,50,750,1632
2,471,219,94,784,1632
3,440,256,132,828,1632
4,416,275,164,855,1632
5,402,317,179,898,1632
6,442,320,200,962,1632
7,424,351,206,981,1632
8,414,364,225,1003,1632
9,403,371,258,1032,1632
10,385,363,282,1030,1632
11,422,378,277,1077,1632
1,500,200,50,750,1633
2,463,240,86,789,1633
3,420,269,139,828,1633
4,406,284,163,853,1633
5,384,306,211,901,1633
6,400,328,237,965,1633
7,406,337,244,987,1633
8,381,360,268,1009,1633
9,367,388,266,1021,1633
10,378,429,255,1062,1633
11,386,433,268,1087,1633
1,500,200,50,750,1634
2,467,227,92,786,1634
3,435,269,123,827,1634
4,423,276,176,875,1634
5,401,310,201,912,1634
6,433,345,200,978,1634
7,408,352,232,992,1634
8,405,347,248,1000,1634
9,407,380,242,1029,1634
10,393,376,269,1038,1634
11,407,396,271,1074,1634
1,500,200,50,750,1635
2,453,239,95,787,1635
3,426,266,120,812,1635
4,434,273,171,878,1635
5,435,298,194,927,1635
6,427,317,220,964,1635
7,392,356,239,987,1635
8,405,349,246,1000,1635
9,404,382,263,1049,1635
10,405,375,279,1059,1635
11,405,401,274,1080,1635
1,500,200,50,750,1636
2,449,250,95,794,1636
3,415,288,144,847,1636
4,392,297,172,861,1636
5,399,309,209,917,1636
6,407,336,215,958,1636
7,386,371,225,982,1636
8,393,354,253,1000,1636
9,389,392,251,1032,1636
10,389,406,263,1058,1636
11,389,393,288,1070,1636
1,500,200,50,750,1637
2,489,228,83,800,1637
3,442,248,131,821,1637
4,435,287,158,880,1637
5,429,321,182,932,1637
6,411,335,210,956,1637
7,384,371,227,982,1637
8,406,369,230,1005,1637
9,404,379,256,1039,1637
10,398,383,262,1043,1637
11,417,424,243,1084,1637
1,500,200,50,750,1638
2,466,214,99,779,1638
3,458,233,140,831,1638
4,423,281,168,872,1638
5,407,317,174,898,1638
6,442,349,185,976,1638
7,409,359,218,986,1638
8,379,387,245,1011,1638
9,364,422,259,1045,1638
10,356,429,264,1049,1638
11,376,419,281,1076,1638
1,500,200,50,750,1639
2,462,237,95,794,1639
3,438,257,119,814,1639
4,424,292,150,866,1639
5,422,293,193,908,1639
6,427,337,197,961,1639
7,393,351,235,979,1639
8,402,372,237,1011,1639
9,383,369,268,1020,1639
10,381,386,273,1040,1639
11,393,385,302,1080,1639
1,500,200,50,750,1640
2,457,222,102,781,1640
3,458,244,130,832,1640
4,443,267,174,884,1640
5,426,306,178,910,1640
6,424,338,193,955,1640
7,400,357,210,967,1640
8,416,376,204,996,1640
9,414,368,241,1023,1640
10,409,381,257,1047,1640
11,422,385,271,1078,1640
1,500,200,50,750,1641
2,473,221,94,788,1641
3,447,251,135,833,1641
4,434,270,159,863,1641
5,437,321,159,917,1641
6,413,329,212,954,1641
7,405,352,228,985,1641
8,386,396,225,1007,1641
9,378,396,249,1023,1641
10,378,406,271,1055,1641
11,390,413,275,1078,1641
1,500,200,50,750,1642
2,468,241,97,806,1642
3,436,260,127,823,1642
4,439,266,163,868,1642
5,445,291,184,920,1642
6,426,315,213,954,1642
7,416,332,221,969,1642
8,410,342,250,1002,1642
9,395,363,255,1013,1642
10,406,375,274,1055,1642
11,412,377,300,1089,1642
1,500,200,50,750,1643
2,464,228,101,793,1643
3,462,233,140,835,1643
4,427,293,155,875,1643
5,424,311,185,920,1643
6,419,342,214,975,1643
7,401,357,218,976,1643
8,386,400,209,995,1643
9,389,416,237,1042,1643
10,394,414,240,1048,1643
11,382,408,287,1077,1643
1,500,200,50,750,1644
2,461,226,97,784,1644
3,436,262,129,827,1644
4,426,265,173,864,1644
5,425,295,198,918,1644
6,421,318,202,941,1644
7,413,340,233,986,1644
8,405,378,231,1014,1644
9,396,364,267,1027,1644
10,386,376,297,1059,1644
11,394,371,315,1080,1644
1,500,200,50,750,1645
2,459,238,90,787,1645
3,433,274,124,831,1645
4,403,301,164,868,1645
5,384,329,170,883,1645
6,410,368,187,965,1645
7,397,368,209,974,1645
8,395,382,231,1008,1645
9,413,390,239,1042,1645
10,417,394,251,1062,1645
11,435,407,261,1103,1645
1,500,200,50,750,1646
2,459,231,94,784,1646
3,415,274,124,813,1646
4,434,285,157,876,1646
5,424,303,181,908,1646
6,428,329,208,965,1646
7,431,323,229,983,1646
8,410,367,232,1009,1646
9,399,382,248,1029,1646
10,400,401,248,1049,1646
11,421,399,249,1069,1646
1,500,200,50,750,1647
2,452,225,104,781,1647
3,423,252,144,819,1647
4,388,292,167,847,1647
5,399,320,188,907,1647
6,393,350,202,945,1647
7,406,365,204,975,1647
8,390,397,217,1004,1647
9,399,394,237,1030,1647
10,395,412,255,1062,1647
11,389,440,263,1092,1647
1,500,200,50,750,1648
2,430,245,109,784,1648
3,401,272,146,819,1648
4,408,286,165,859,1648
5,403,310,199,912,1648
6,403,342,205,950,1648
7,410,371,204,985,1648
8,399,376,229,1004,1648
9,374,407,238,1019,1648
10,359,407,266,1032,1648
11,385,421,278,1084,1648
1,500,200,50,750,1649
2,419,246,112,777,1649
3,404,270,144,818,1649
4,397,308,174,879,1649
5,394,331,196,921,1649
6,392,328,227,947,1649
7,385,354,246,985,1649
8,389,363,253,1005,1649
9,385,387,254,1026,1649
10,369,402,278,1049,1649
11,384,439,279,1102,1649
1,500,200,50,750,1650
2,457,237,112,806,1650
3,427,248,143,818,1650
4,402,289,155,846,1650
5,414,314,184,912,1650
6,420,341,197,958,1650
7,411,363,219,993,1650
8,392,370,247,1009,1650
9,377,395,261,1033,1650
10,388,401,275,1064,1650
11,381,414,283,1078,1650
1,500,200,50,750,1651
2,472,216,93,781,1651
3,448,239,139,826,1651
4,429,274,163,866,1651
5,425,307,183,915,1651
6,423,337,189,949,1651
7,423,350,216,989,1651
8,412,348,253,1013,1651
9,419,357,255,1031,1651
10,412,380,257,1049,1651
11,415,419,252,1086,1651
1,500,200,50,750,1652
2,454,231,99,784,1652
3,446,247,136,829,1652
4,434,282,154,870,1652
5,423,311,179,913,1652
6,416,349,206,971,1652
7,389,373,223,985,1652
8,386,400,237,1023,1652
9,384,403,242,1029,1652
10,407,401,261,1069,1652
11,390,400,293,1083,1652
1,500,200,50,750,1653
2,455,222,102,779,1653
3,432,250,131,813,1653
4,427,287,152,866,1653
5,417,290,189,896,1653
6,416,318,218,952,1653
7,418,341,231,990,1653
8,374,378,249,1001,1653
9,394,401,255,1050,1653
10,387,404,257,1048,1653
11,393,418,266,1077,1653
1,500,200,50,750,1654
2,435,237,106,778,1654
3,433,267,151,851,1654
4,404,286,179,869,1654
5,379,305,216,900,1654
6,379,321,242,942,1654
7,380,353,239,972,1654
8,401,359,245,1005,1654
9,409,351,268,1028,1654
10,401,378,290,1069,1654
11,378,406,290,1074,1654
1,500,200,50,750,1655
2,452,227,93,772,1655
3,445,251,121,817,1655
4,414,287,164,865,1655
5,407,333,181,921,1655
6,416,339,207,962,1655
7,383,374,222,979,1655
8,399,386,232,1017,1655
9,384,389,257,1030,1655
10,411,395,269,1075,1655
11,416,389,272,1077,1655
1,500,200,50,750,1656
2,478,234,87,799,1656
3,435,274,124,833,1656
4,435,295,140,870,1656
5,425,328,158,911,1656
6,434,324,205,963,1656
7,419,341,218,978,1656
8,391,372,249,1012,1656
9,376,382,268,1026,1656
10,377,405,272,1054,1656
11,376,417,283,1076,1656
1,500,200,50,750,1657
2,462,248,92,802,1657
3,436,252,148,836,1657
4,424,290,162,876,1657
5,402,307,198,907,1657
6,401,356,209,966,1657
7,398,352,225,975,1657
8,399,374,233,1006,1657
9,393,373,264,1030,1657
10,404,380,259,1043,1657
11,428,398,268,1094,1657
1,500,200,50,750,1658
2,469,220,107,796,1658
3,426,249,147,822,1658
4,423,270,167,860,1658
5,408,324,182,914,1658
6,419,334,194,947,1658
7,409,348,213,970,1658
8,417,360,241,1018,1658
9,433,370,227,1030,1658
10,426,377,251,1054,1658
11,426,401,264,1091,1658
1,500,200,50,750,1659
2,444,225,107,776,1659
3,444,250,138,832,1659
4,401,291,168,860,1659
5,405,302,192,899,1659
6,417,332,209,958,1659
7,407,351,224,982,1659
8,395,371,228,994,1659
9,396,375,249,1020,1659
10,428,389,249,1066,1659
11,415,376,299,1090,1659
1,500,200,50,750,1660
2,472,225,95,792,1660
3,456,240,125,821,1660
4,442,281,149,872,1660
5,432,312,173,917,1660
6,411,345,194,950,1660
7,396,355,220,971,1660
8,404,367,232,1003,1660
9,396,399,240,1035,1660
10,385,396,267,1048,1660
11,411,400,266,1077,1660
1,500,200,50,750,1661
2,456,227,108,791,1661
3,428,262,136,826,1661
4,387,296,173,856,1661
5,407,318,200,925,1661
6,396,339,222,957,1661
7,398,352,231,981,1661
8,393,389,233,1015,1661
9,386,383,255,1024,1661
10,394,401,282,1077,1661
11,400,421,268,1089,1661
1,500,200,50,750,1662
2,468,220,98,786,1662
3,434,271,130,835,1662
4,422,310,156,888,1662
5,424,312,187,923,1662
6,421,309,210,940,1662
7,405,342,236,983,1662
8,399,353,257,1009,1662
9,376,371,269,1016,1662
10,384,390,288,1062,1662
11,384,403,304,1091,1662
1,500,200,50,750,1663
2,463,209,108,780,1663
3,439,254,145,838,1663
4,411,293,184,888,1663
5,382,295,219,896,1663
6,396,330,237,963,1663
7,380,339,252,971,1663
8,372,350,271,993,1663
9,398,386,256,1040,1663
10,385,380,286,1051,1663
11,399,421,260,1080,1663
1,500,200,50,750,1664
2,449,229,107,785,1664
3,439,255,137,831,1664
4,433,281,152,866,1664
5,429,298,186,913,1664
6,418,316,209,943,1664
7,404,356,228,988,1664
8,409,379,228,1016,1664
9,415,357,265,1037,1664
10,409,363,285,1057,1664
11,406,396,277,1079,1664
1,500,200,50,750,1665
2,457,226,104,787,1665
3,418,261,135,814,1665
4,398,297,162,857,1665
5,406,312,201,919,1665
6,395,320,246,961,1665
7,382,343,257,982,1665
8,363,387,247,997,1665
9,382,408,241,1031,1665
10,397,413,251,1061,1665
11,407,428,265,1100,1665
1,500,200,50,750,1666
2,442,256,95,793,1666
3,430,273,135,838,1666
4,408,295,169,872,1666
5,407,300,201,908,1666
6,404,321,221,946,1666
7,399,361,221,981,1666
8,401,370,250,1021,1666
9,376,387,253,1016,1666
10,390,407,271,1068,1666
11,398,401,282,1081,1666
1,500,200,50,750,1667
2,460,231,91,782,1667
3,441,275,116,832,1667
4,422,288,161,871,1667
5,433,302,170,905,1667
6,419,335,189,943,1667
7,404,361,229,994,1667
8,404,384,234,1022,1667
9,381,393,254,1028,1667
10,376,418,261,1055,1667
11,376,432,265,1073,1667
1,500,200,50,750,1668
2,446,235,97,778,1668
3,421,271,123,815,1668
4,413,305,162,880,1668
5,412,343,174,929,1668
6,406,347,197,950,1668
7,428,359,211,998,1668
8,425,369,222,1016,1668
9,411,383,249,1043,1668
10,400,382,272,1054,1668
11,410,408,267,1085,1668
1,500,200,50,750,1669
2,446,237,100,783,1669
3,420,267,138,825,1669
4,425,315,153,893,1669
5,391,349,164,904,1669
6,393,346,200,939,1669
7,392,387,205,984,1669
8,406,383,218,1007,1669
9,399,388,226,1013,1669
10,420,404,251,1075,1669
11,419,397,265,1081,1669
1,500,200,50,750,1670
2,471,229,99,799,1670
3,428,270,131,829,1670
4,422,287,159,868,1670
5,410,306,186,902,1670
6,396,350,204,950,1670
7,395,345,242,982,1670
8,390,366,250,1006,1670
9,390,370,278,1038,1670
10,388,393,280,1061,1670
11,403,407,274,1084,1670
1,500,200,50,750,1671
2,462,226,93,781,1671
3,443,246,136,825,1671
4,425,289,164,878,1671
5,402,321,191,914,1671
6,392,340,219,951,1671
7,385,356,231,972,1671
8,414,359,249,1022,1671
9,406,362,262,1030,1671
10,396,407,249,1052,1671
11,398,434,265,1097,1671
1,500,200,50,750,1672
2,463,228,97,788,1672
3,440,246,134,820,1672
4,429,275,169,873,1672
5,425,309,186,920,1672
6,422,330,207,959,1672
7,441,338,196,975,1672
8,435,354,216,1005,1672
9,435,357,248,1040,1672
10,406,391,255,1052,1672
11,397,416,257,1070,1672
1,500,200,50,750,1673
2,474,219,106,799,1673
3,455,250,129,834,1673
4,418,282,167,867,1673
5,415,307,197,919,1673
6,416,328,205,949,1673
7,424,325,232,981,1673
8,394,354,239,987,1673
9,413,361,249,1023,1673
10,420,388,242,1050,1673
11,417,390,253,1060,1673
1,500,200,50,750,1674
2,458,216,103,777,1674
3,423,273,135,831,1674
4,417,309,159,885,1674
5,377,326,203,906,1674
6,386,356,223,965,1674
7,376,354,235,965,1674
8,379,392,242,1013,1674
9,373,403,253,1029,1674
10,390,386,267,1043,1674
11,407,417,272,1096,1674
1,500,200,50,750,1675
2,470,225,97,792,1675
3,446,251,133,830,1675
4,426,294,144,864,1675
5,432,315,164,911,1675
6,432,345,197,974,1675
7,398,358,220,976,1675
8,384,383,236,1003,1675
9,383,395,259,1037,1675
10,404,403,269,1076,1675
11,390,431,265,1086,1675
1,500,200,50,750,1676
2,468,228,98,794,1676
3,439,250,123,812,1676
4,436,282,156,874,1676
5,421,303,190,914,1676
6,399,342,216,957,1676
7,400,348,239,987,1676
8,375,360,268,1003,1676
9,366,391,284,1041,1676
10,366,403,280,1049,1676
11,388,422,292,1102,1676
1,500,200,50,750,1677
2,452,230,112,794,1677
3,428,247,143,818,1677
4,413,290,176,879,1677
5,388,312,204,904,1677
6,405,330,235,970,1677
7,397,345,245,987,1677
8,390,371,244,1005,1677
9,389,364,275,1028,1677
10,376,393,283,1052,1677
11,381,413,292,1086,1677
1,500,200,50,750,1678
2,467,219,103,789,1678
3,407,248,150,805,1678
4,408,282,171,861,1678
5,414,298,199,911,1678
6,417,332,224,973,1678
7,387,335,262,984,1678
8,401,369,237,1007,1678
9,394,372,258,1024,1678
10,400,389,252,1041,1678
11,408,380,277,1065,1678
1,500,200,50,750,1679
2,473,239,82,794,1679
3,434,273,118,825,1679
4,415,288,170,873,1679
5,399,308,203,910,1679
6,396,331,225,952,1679
7,398,343,248,989,1679
8,382,371,246,999,1679
9,406,381,236,1023,1679
10,410,410,247,1067,1679
11,413,430,250,1093,1679
1,500,200,50,750,1680
2,477,214,103,794,1680
3,442,257,134,833,1680
4,425,274,181,880,1680
5,408,299,220,927,1680
6,383,346,225,954,1680
7,375,360,249,984,1680
8,368,385,241,994,1680
9,368,402,253,1023,1680
10,404,385,268,1057,1680
11,402,416,275,1093,1680
1,500,200,50,750,1681
2,465,229,103,797,1681
3,416,267,135,818,1681
4,420,286,159,865,1681
5,409,293,204,906,1681
6,422,320,214,956,1681
7,419,336,233,988,1681
8,413,366,237,1016,1681
9,412,353,275,1040,1681
10,397,385,275,1057,1681
11,383,392,310,1085,1681
1,500,200,50,750,1682
2,476,229,86,791,1682
3,442,243,134,819,1682
4,410,279,174,863,1682
5,417,301,199,917,1682
6,386,368,199,953,1682
7,365,373,226,964,1682
8,375,384,252,1011,1682
9,355,368,296,1019,1682
10,368,398,281,1047,1682
11,364,405,309,1078,1682
1,500,200,50,750,1683
2,448,241,101,790,1683
3,406,270,141,817,1683
4,385,280,188,853,1683
5,399,322,202,923,1683
6,391,358,204,953,1683
7,382,351,248,981,1683
8,371,386,244,1001,1683
9,391,380,261,1032,1683
10,383,391,266,1040,1683
11,385,422,281,1088,1683
1,500,200,50,750,1684
2,467,227,103,797,1684
3,437,248,139,824,1684
4,405,282,174,861,1684
5,419,315,186,920,1684
6,424,334,201,959,1684
7,400,361,232,993,1684
8,418,362,251,1031,1684
9,416,358,268,1042,1684
10,407,389,263,1059,1684
11,409,420,277,1106,1684
1,500,200,50,750,1685
2,462,225,98,785,1685
3,454,249,131,834,1685
4,437,275,150,862,1685
5,434,295,178,907,1685
6,426,357,182,965,1685
7,397,381,202,980,1685
8,384,401,224,1009,1685
9,372,397,249,1018,1685
10,380,398,269,1047,1685
11,384,410,280,1074,1685
1,500,200,50,750,1686
2,471,220,98,789,1686
3,454,247,124,825,1686
4,424,286,157,867,1686
5,412,342,152,906,1686
6,408,341,193,942,1686
7,388,348,242,978,1686
8,398,360,249,1007,1686
9,391,393,239,1023,1686
10,395,415,253,1063,1686
11,397,419,272,1088,1686
1,500,200,50,750,1687
2,462,223,121,806,1687
3,411,252,153,816,1687
4,378,307,178,863,1687
5,376,330,210,916,1687
6,366,349,240,955,1687
7,382,351,247,980,1687
8,377,359,272,1008,1687
9,383,366,281,1030,1687
10,414,381,270,1065,1687
11,400,403,275,1078,1687
1,500,200,50,750,1688
2,457,227,105,789,1688
3,424,259,136,819,1688
4,419,302,149,870,1688
5,421,319,183,923,1688
6,405,346,202,953,1688
7,391,382,208,981,1688
8,384,387,228,999,1688
9,390,386,252,1028,1688
10,401,412,250,1063,1688
11,397,414,271,1082,1688
1,500,200,50,750,1689
2,452,239,88,779,1689
3,430,262,131,823,1689
4,414,310,147,871,1689
5,395,320,195,910,1689
6,416,341,219,976,1689
7,388,353,236,977,1689
8,373,350,263,986,1689
9,403,407,224,1034,1689
10,395,425,245,1065,1689
11,407,416,269,1092,1689
1,500,200,50,750,1690
2,447,238,100,785,1690
3,454,250,136,840,1690
4,423,280,166,869,1690
5,396,336,170,902,1690
6,411,355,202,968,1690
7,393,372,220,985,1690
8,392,378,235,1005,1690
9,410,374,256,1040,1690
10,416,374,270,1060,1690
11,435,394,275,1104,1690
1,500,200,50,750,1691
2,450,229,116,795,1691
3,407,273,149,829,1691
4,392,298,180,870,1691
5,372,320,211,903,1691
6,375,332,225,932,1691
7,380,381,217,978,1691
8,370,412,217,999,1691
9,370,442,221,1033,1691
10,362,438,254,1054,1691
11,359,440,286,1085,1691
1,500,200,50,750,1692
2,462,234,98,794,1692
3,426,268,130,824,1692
4,402,291,175,868,1692
5,379,336,197,912,1692
6,384,362,206,952,1692
7,373,396,212,981,1692
8,367,402,223,992,1692
9,382,418,236,1036,1692
10,372,410,267,1049,1692
11,397,404,286,1087,1692
1,500,200,50,750,1693
2,459,219,98,776,1693
3,427,259,147,833,1693
4,398,296,164,858,1693
5,383,337,201,921,1693
6,390,366,201,957,1693
7,423,344,223,990,1693
8,390,362,260,1012,1693
9,396,369,264,1029,1693
10,391,379,288,1058,1693
11,397,410,276,1083,1693
1,500,200,50,750,1694
2,455,240,104,799,1694
3,415,284,118,817,1694
4,421,311,163,895,1694
5,396,327,181,904,1694
6,399,350,195,944,1694
7,413,381,200,994,1694
8,395,386,215,996,1694
9,410,390,238,1038,1694
10,431,398,243,1072,1694
11,405,414,262,1081,1694
1,500,200,50,750,1695
2,457,215,95,767,1695
3,430,259,123,812,1695
4,415,290,151,856,1695
5,423,340,165,928,1695
6,413,338,200,951,1695
7,397,338,239,974,1695
8,404,361,247,1012,1695
9,392,381,264,1037,1695
10,390,398,263,1051,1695
11,419,424,272,1115,1695
1,500,200,50,750,1696
2,470,225,100,795,1696
3,436,262,131,829,1696
4,419,304,154,877,1696
5,420,324,172,916,1696
6,410,344,198,952,1696
7,411,357,199,967,1696
8,409,362,230,1001,1696
9,402,378,253,1033,1696
10,399,395,266,1060,1696
11,382,426,260,1068,1696
1,500,200,50,750,1697
2,444,230,111,785,1697
3,431,261,150,842,1697
4,409,291,176,876,1697
5,398,318,212,928,1697
6,383,340,220,943,1697
7,377,351,235,963,1697
8,397,368,246,1011,1697
9,397,385,243,1025,1697
10,397,405,249,1051,1697
11,404,408,269,1081,1697
1,500,200,50,750,1698
2,444,248,97,789,1698
3,425,261,139,825,1698
4,401,305,156,862,1698
5,400,311,200,911,1698
6,406,327,231,964,1698
7,398,342,240,980,1698
8,395,376,239,1010,1698
9,363,389,262,1014,1698
10,377,406,268,1051,1698
11,388,430,269,1087,1698
1,500,200,50,750,1699
2,464,228,99,791,1699
3,447,255,120,822,1699
4,439,284,153,876,1699
5,413,297,186,896,1699
6,412,329,224,965,1699
7,405,340,232,977,1699
8,421,369,226,1016,1699
9,398,390,232,1020,1699
10,402,389,249,1040,1699
11,402,412,279,1093,1699
1,500,200,50,750,1700
2,446,257,87,790,1700
3,424,274,138,836,1700
4,413,305,160,878,1700
5,387,323,184,894,1700
6,393,356,200,949,1700
7,384,361,240,985,1700
8,393,384,244,1021,1700
9,376,390,261,1027,1700
10,400,381,258,1039,1700
11,402,397,270,1069,1700
1,500,200,50,750,1701
2,451,232,96,779,1701
3,422,275,131,828,1701
4,411,305,162,878,1701
5,397,328,190,915,1701
6,387,351,215,953,1701
7,376,371,232,979,1701
8,374,394,235,1003,1701
9,372,389,249,1010,1701
10,382,420,260,1062,1701
11,403,425,275,1103,1701
1,500,200,50,750,1702
2,461,208,115,784,1702
3,433,238,144,815,1702
4,435,271,179,885,1702
5,412,280,200,892,1702
6,420,333,209,962,1702
7,383,338,250,971,1702
8,387,356,246,989,1702
9,410,387,247,1044,1702
10,387,408,269,1064,1702
11,386,433,264,1083,1702
1,500,200,50,750,1703
2,461,218,108,787,1703
3,435,253,138,826,1703
4,412,282,171,865,1703
5,407,299,206,912,1703
6,393,335,225,953,1703
7,391,356,237,984,1703
8,404,379,237,1020,1703
9,394,374,258,1026,1703
10,405,385,271,1061,1703
11,407,409,283,1099,1703
1,500,200,50,750,1704
2,467,224,100,791,1704
3,435,253,141,829,1704
4,417,273,173,863,1704
5,430,301,198,929,1704
6,421,316,216,953,1704
7,396,352,235,983,1704
8,389,382,241,1012,1704
9,391,379,264,1034,1704
10,401,370,286,1057,1704
11,425,382,282,1089,1704
1,500,200,50,750,1705
2,481,226,98,805,1705
3,430,260,138,828,1705
4,425,298,153,876,1705
5,438,314,182,934,1705
6,431,308,218,957,1705
7,414,310,251,975,1705
8,418,347,245,1010,1705
9,418,359,255,1032,1705
10,416,382,252,1050,1705
11,428,417,246,1091,1705
1,500,200,50,750,1706
2,449,234,112,795,1706
3,417,274,133,824,1706
4,401,298,163,862,1706
5,391,324,194,909,1706
6,391,358,207,956,1706
7,359,392,224,975,1706
8,361,396,241,998,1706
9,363,426,249,1038,1706
10,375,403,286,1064,1706
11,379,426,286,1091,1706
1,500,200,50,750,1707
2,464,245,86,795,1707
3,424,276,118,818,1707
4,397,313,155,865,1707
5,397,323,185,905,1707
6,416,337,191,944,1707
7,408,368,207,983,1707
8,405,374,220,999,1707
9,420,363,255,1038,1707
10,421,361,270,1052,1707
11,421,400,270,1091,1707
1,500,200,50,750,1708
2,459,228,102,789,1708
3,439,267,124,830,1708
4,411,309,157,877,1708
5,391,315,187,893,1708
6,414,351,203,968,1708
7,401,354,235,990,1708
8,372,374,247,993,1708
9,371,415,247,1033,1708
10,354,432,283,1069,1708
11,369,438,290,1097,1708
1,500,200,50,750,1709
2,456,217,112,785,1709
3,429,258,156,843,1709
4,402,269,192,863,1709
5,425,274,211,910,1709
6,439,331,216,986,1709
7,400,335,236,971,1709
8,428,361,242,1031,1709
9,405,384,247,1036,1709
10,394,381,271,1046,1709
11,395,405,266,1066,1709
1,500,200,50,750,1710
2,479,212,94,785,1710
3,431,264,144,839,1710
4,385,289,188,862,1710
5,385,335,196,916,1710
6,380,359,208,947,1710
7,395,361,227,983,1710
8,392,377,231,1000,1710
9,382,406,249,1037,1710
10,396,386,264,1046,1710
11,417,415,255,1087,1710
1,500,200,50,750,1711
2,455,221,101,777,1711
3,424,253,138,815,1711
4,425,272,175,872,1711
5,398,297,200,895,1711
6,416,321,221,958,1711
7,406,350,221,977,1711
8,395,350,249,994,1711
9,394,362,254,1010,1711
10,410,401,265,1076,1711
11,423,388,266,1077,1711
1,500,200,50,750,1712
2,456,234,110,800,1712
3,418,272,140,830,1712
4,392,294,174,860,1712
5,397,310,209,916,1712
6,393,344,215,952,1712
7,390,374,234,998,1712
8,373,391,237,1001,1712
9,372,384,271,1027,1712
10,377,389,286,1052,1712
11,386,416,280,1082,1712
1,500,200,50,750,1713
2,467,219,104,790,1713
3,418,251,144,813,1713
4,399,287,178,864,1713
5,391,338,193,922,1713
6,399,344,212,955,1713
7,398,353,223,974,1713
8,405,372,241,1018,1713
9,411,366,261,1038,1713
10,411,382,266,1059,1713
11,422,382,265,1069,1713
1,500,200,50,750,1714
2,436,248,97,781,1714
3,429,275,133,837,1714
4,434,289,147,870,1714
5,409,323,173,905,1714
6,419,358,186,963,1714
7,407,380,197,984,1714
8,409,375,239,1023,1714
9,396,382,255,1033,1714
10,400,417,254,1071,1714
11,408,419,265,1092,1714
1,500,200,50,750,1715
2,434,236,107,777,1715
3,411,272,142,825,1715
4,416,301,176,893,1715
5,389,328,193,910,1715
6,386,352,221,959,1715
7,390,363,228,981,1715
8,373,378,243,994,1715
9,383,389,256,1028,1715
10,402,366,286,1054,1715
11,427,375,287,1089,1715
1,500,200,50,750,1716
2,458,220,96,774,1716
3,444,263,127,834,1716
4,421,296,164,881,1716
5,433,310,186,929,1716
6,404,334,218,956,1716
7,423,340,223,986,1716
8,404,360,244,1008,1716
9,406,383,250,1039,1716
10,403,398,247,1048,1716
11,404,417,264,1085,1716
1,500,200,50,750,1717
2,457,244,109,810,1717
3,420,266,133,819,1717
4,386,299,169,854,1717
5,399,311,219,929,1717
6,403,326,229,958,1717
7,401,342,242,985,1717
8,390,338,272,1000,1717
9,384,361,288,1033,1717
10,392,384,283,1059,1717
11,374,430,284,1088,1717
1,500,200,50,750,1718
2,462,235,90,787,1718
3,446,236,143,825,1718
4,437,276,155,868,1718
5,428,308,183,919,1718
6,413,345,208,966,1718
7,400,357,222,979,1718
8,386,377,236,999,1718
9,375,410,243,1028,1718
10,388,403,272,1063,1718
11,391,400,289,1080,1718
1,500,200,50,750,1719
2,440,256,95,791,1719
3,408,272,133,813,1719
4,421,301,156,878,1719
5,406,327,195,928,1719
6,397,352,211,960,1719
7,396,350,234,980,1719
8,406,357,243,1006,1719
9,417,339,264,1020,1719
10,433,373,265,1071,1719
11,408,403,280,1091,1719
1,500,200,50,750,1720
2,464,224,104,792,1720
3,453,246,130,829,1720
4,428,301,144,873,1720
5,408,310,178,896,1720
6,434,315,206,955,1720
7,423,337,223,983,1720
8,426,341,235,1002,1720
9,432,355,238,1025,1720
10,415,372,255,1042,1720
11,431,403,276,1110,1720
1,500,200,50,750,1721
2,451,246,89,786,1721
3,428,272,125,825,1721
4,396,315,146,857,1721
5,397,319,197,913,1721
6,388,341,203,932,1721
7,395,361,228,984,1721
8,398,388,238,1024,1721
9,382,388,263,1033,1721
10,389,407,281,1077,1721
11,390,421,270,1081,1721
1,500,200,50,750,1722
2,444,230,105,779,1722
3,430,266,134,830,1722
4,400,297,160,857,1722
5,395,322,188,905,1722
6,397,369,218,984,1722
7,373,375,228,976,1722
8,376,396,223,995,1722
9,401,400,243,1044,1722
10,406,404,246,1056,1722
11,421,410,253,1084,1722
1,500,200,50,750,1723
2,449,233,101,783,1723
3,419,265,159,843,1723
4,396,279,196,871,1723
5,390,304,221,915,1723
6,402,340,232,974,1723
7,379,349,247,975,1723
8,377,385,248,1010,1723
9,363,388,276,1027,1723
10,387,407,265,1059,1723
11,416,418,273,1107,1723
1,500,200,50,750,1724
2,455,231,102,788,1724
3,464,262,120,846,1724
4,429,276,158,863,1724
5,425,290,192,907,1724
6,420,323,197,940,1724
7,406,358,217,981,1724
8,407,367,235,1009,1724
9,396,372,261,1029,1724
10,398,404,245,1047,1724
11,407,414,265,1086,1724
1,500,200,50,750,1725
2,456,231,101,788,1725
3,426,258,141,825,1725
4,423,273,176,872,1725
5,407,293,199,899,1725
6,400,337,216,953,1725
7,401,335,245,981,1725
8,399,367,247,1013,1725
9,400,373,261,1034,1725
10,409,377,279,1065,1725
11,411,400,276,1087,1725
1,500,200,50,750,1726
2,468,231,90,789,1726
3,433,261,122,816,1726
4,423,302,145,870,1726
5,418,336,160,914,1726
6,402,352,188,942,1726
7,402,386,210,998,1726
8,375,397,233,1005,1726
9,376,418,250,1044,1726
10,384,399,294,1077,1726
11,389,416,291,1096,1726
1,500,200,50,750,1727
2,461,235,102,798,1727
3,434,245,149,828,1727
4,413,276,178,867,1727
5,420,313,187,920,1727
6,403,336,212,951,1727
7,402,338,250,990,1727
8,401,373,240,1014,1727
9,384,388,250,1022,1727
10,395,428,240,1063,1727
11,387,447,243,1077,1727
1,500,200,50,750,1728
2,452,234,112,798,1728
3,400,260,160,820,1728
4,384,302,175,861,1728
5,390,334,206,930,1728
6,391,361,203,955,1728
7,374,373,238,985,1728
8,372,394,252,1018,1728
9,368,402,257,1027,1728
10,375,433,264,1072,1728
11,361,427,284,1072,1728
1,500,200,50,750,1729
2,460,226,99,785,1729
3,430,248,132,810,1729
4,434,263,164,861,1729
5,421,314,181,916,1729
6,422,327,201,950,1729
7,424,354,211,989,1729
8,405,375,214,994,1729
9,378,367,240,985,1729
10,399,389,257,1045,1729
11,388,411,275,1074,1729
1,500,200,50,750,1730
2,458,242,85,785,1730
3,437,256,142,835,1730
4,397,285,183,865,1730
5,405,298,190,893,1730
6,423,323,209,955,1730
7,420,326,229,975,1730
8,413,353,246,1012,1730
9,406,372,245,1023,1730
10,413,418,229,1060,1730
11,429,433,236,1098,1730
1,500,200,50,750,1731
2,439,229,109,777,1731
3,409,260,160,829,1731
4,404,302,170,876,1731
5,418,327,158,903,1731
6,413,351,176,940,1731
7,423,368,206,997,1731
8,383,374,240,997,1731
9,390,397,250,1037,1731
10,409,401,257,1067,1731
11,395,430,250,1075,1731
1,500,200,50,750,1732
2,464,227,100,791,1732
3,449,247,141,837,1732
4,416,301,142,859,1732
5,409,313,172,894,1732
6,418,352,206,976,1732
7,387,373,234,994,1732
8,376,386,251,1013,1732
9,355,386,275,1016,1732
10,349,392,297,1038,1732
11,361,417,284,1062,1732
1,500,200,50,750,1733
2,448,233,110,791,1733
3,399,270,145,814,1733
4,399,277,185,861,1733
5,405,291,209,905,1733
6,419,327,208,954,1733
7,407,344,234,985,1733
8,386,360,237,983,1733
9,391,415,235,1041,1733
10,372,415,266,1053,1733
11,389,430,270,1089,1733
1,500,200,50,750,1734
2,481,205,106,792,1734
3,451,255,128,834,1734
4,421,291,164,876,1734
5,408,318,191,917,1734
6,423,315,204,942,1734
7,437,324,229,990,1734
8,429,341,233,1003,1734
9,430,389,236,1055,1734
10,400,410,259,1069,1734
11,424,377,291,1092,1734
1,500,200,50,750,1735
2,477,225,98,800,1735
3,456,255,122,833,1735
4,431,272,163,866,1735
5,428,283,192,903,1735
6,427,349,201,977,1735
7,381,364,226,971,1735
8,407,380,239,1026,1735
9,399,385,261,1045,1735
10,393,404,271,1068,1735
11,390,389,296,1075,1735
1,500,200,50,750,1736
2,459,215,113,787,1736
3,427,261,134,822,1736
4,399,319,147,865,1736
5,382,343,196,921,1736
6,382,357,210,949,1736
7,368,367,238,973,1736
8,377,360,256,993,1736
9,404,357,273,1034,1736
10,395,396,268,1059,1736
11,393,414,279,1086,1736
1,500,200,50,750,1737
2,477,225,79,781,1737
3,436,272,122,830,1737
4,417,299,158,874,1737
5,399,321,196,916,1737
6,398,338,218,954,1737
7,385,344,245,974,1737
8,417,352,241,1010,1737
9,410,364,251,1025,1737
10,407,392,253,1052,1737
11,419,424,258,1101,1737
1,500,200,50,750,1738
2,468,216,104,788,1738
3,425,247,147,819,1738
4,422,291,165,878,1738
5,402,324,181,907,1738
6,412,351,200,963,1738
7,412,353,222,987,1738
8,401,366,245,1012,1738
9,411,382,254,1047,1738
10,395,401,266,1062,1738
11,402,394,284,1080,1738
1,500,200,50,750,1739
2,456,229,101,786,1739
3,439,252,127,818,1739
4,428,294,151,873,1739
5,422,300,181,903,1739
6,407,337,194,938,1739
7,430,359,199,988,1739
8,428,342,234,1004,1739
9,437,376,229,1042,1739
10,453,384,216,1053,1739
11,437,398,252,1087,1739
1,500,200,50,750,1740
2,455,240,82,777,1740
3,444,294,107,845,1740
4,426,292,155,873,1740
5,433,309,175,917,1740
6,418,308,231,957,1740
7,415,329,243,987,1740
8,403,340,253,996,1740
9,411,350,274,1035,1740
10,420,346,288,1054,1740
11,426,377,284,1087,1740
1,500,200,50,750,1741
2,462,212,106,780,1741
3,456,246,135,837,1741
4,433,264,159,856,1741
5,424,312,180,916,1741
6,414,363,189,966,1741
7,400,363,212,975,1741
8,400,379,225,1004,1741
9,385,406,241,1032,1741
10,411,409,244,1064,1741
11,412,431,251,1094,1741
1,500,200,50,750,1742
2,451,239,95,785,1742
3,424,259,133,816,1742
4,419,303,154,876,1742
5,413,314,189,916,1742
6,403,342,212,957,1742
7,391,374,218,983,1742
8,388,380,250,1018,1742
9,380,380,277,1037,1742
10,372,403,283,1058,1742
11,379,412,289,1080,1742
1,500,200,50,750,1743
2,470,223,105,798,1743
3,431,229,164,824,1743
4,415,274,181,870,1743
5,379,317,206,902,1743
6,406,340,224,970,1743
7,398,332,248,978,1743
8,394,353,246,993,1743
9,430,354,239,1023,1743
10,434,362,251,1047,1743
11,434,372,277,1083,1743
1,500,200,50,750,1744
2,459,248,89,796,1744
3,414,268,133,815,1744
4,408,285,171,864,1744
5,393,292,205,890,1744
6,396,321,218,935,1744
7,410,356,224,990,1744
8,384,380,223,987,1744
9,388,392,258,1038,1744
10,392,414,261,1067,1744
11,406,414,266,1086,1744
1,500,200,50,750,1745
2,458,233,100,791,1745
3,421,271,144,836,1745
4,400,277,185,862,1745
5,374,315,198,887,1745
6,394,309,225,928,1745
7,389,336,235,960,1745
8,387,374,248,1009,1745
9,378,411,244,1033,1745
10,365,428,261,1054,1745
11,375,430,262,1067,1745
1,500,200,50,750,1746
2,462,229,94,785,1746
3,454,267,112,833,1746
4,430,295,142,867,1746
5,416,318,184,918,1746
6,412,326,218,956,1746
7,402,364,228,994,1746
8,378,391,234,1003,1746
9,377,400,259,1036,1746
10,393,395,268,1056,1746
11,383,423,268,1074,1746
1,500,200,50,750,1747
2,456,228,108,792,1747
3,427,250,152,829,1747
4,402,277,178,857,1747
5,400,306,197,903,1747
6,401,342,219,962,1747
7,393,350,242,985,1747
8,376,369,251,996,1747
9,392,389,258,1039,1747
10,385,388,279,1052,1747
11,386,397,290,1073,1747
1,500,200,50,750,1748
2,451,227,101,779,1748
3,421,270,145,836,1748
4,392,310,166,868,1748
5,402,313,184,899,1748
6,405,347,200,952,1748
7,405,332,231,968,1748
8,413,365,254,1032,1748
9,382,386,257,1025,1748
10,388,374,283,1045,1748
11,407,395,277,1079,1748
1,500,200,50,750,1749
2,445,240,104,789,1749
3,426,262,136,824,1749
4,424,288,162,874,1749
5,401,320,183,904,1749
6,422,335,198,955,1749
7,422,334,219,975,1749
8,416,347,251,1014,1749
9,405,367,252,1024,1749
10,412,357,282,1051,1749
11,415,371,293,1079,1749
1,500,200,50,750,1750
2,461,240,80,781,1750
3,418,274,130,822,1750
4,386,294,173,853,1750
5,389,327,215,931,1750
6,370,346,244,960,1750
7,342,374,261,977,1750
8,361,388,269,1018,1750
9,346,401,287,1034,1750
10,343,420,291,1054,1750
11,359,432,285,1076,1750
1,500,200,50,750,1751
2,458,214,113,785,1751
3,438,237,138,813,1751
4,391,279,182,852,1751
5,404,312,209,925,1751
6,396,356,213,965,1751
7,381,342,243,966,1751
8,383,373,248,1004,1751
9,394,386,249,1029,1751
10,407,388,271,1066,1751
11,399,402,289,1090,1751
1,500,200,50,750,1752
2,472,220,104,796,1752
3,422,270,135,827,1752
4,409,275,172,856,1752
5,428,299,186,913,1752
6,438,313,212,963,1752
7,417,332,235,984,1752
8,406,350,253,1009,1752
9,375,374,267,1016,1752
10,384,393,280,1057,1752
11,382,411,271,1064,1752
1,500,200,50,750,1753
2,458,234,98,790,1753
3,433,275,129,837,1753
4,396,304,166,866,1753
5,397,307,205,909,1753
6,405,343,212,960,1753
7,414,351,228,993,1753
8,389,352,261,1002,1753
9,379,369,278,1026,1753
10,366,380,298,1044,1753
11,382,398,298,1078,1753
1,500,200,50,750,1754
2,453,235,102,790,1754
3,434,258,141,833,1754
4,408,295,160,863,1754
5,400,321,192,913,1754
6,404,356,209,969,1754
7,401,346,231,978,1754
8,404,349,249,1002,1754
9,404,375,251,1030,1754
10,421,410,240,1071,1754
11,387,416,270,1073,1754
1,500,200,50,750,1755
2,463,229,104,796,1755
3,431,254,154,839,1755
4,415,265,175,855,1755
5,419,306,189,914,1755
6,416,344,208,968,1755
7,387,359,240,986,1755
8,384,377,248,1009,1755
9,378,383,261,1022,1755
10,397,403,264,1064,1755
11,411,400,266,1077,1755
1,500,200,50,750,1756
2,456,239,99,794,1756
3,408,270,142,820,1756
4,414,289,174,877,1756
5,389,332,188,909,1756
6,381,345,217,943,1756
7,393,376,219,988,1756
8,402,379,233,1014,1756
9,396,377,254,1027,1756
10,380,393,277,1050,1756
11,407,413,271,1091,1756
1,500,200,50,750,1757
2,461,225,97,783,1757
3,449,253,123,825,1757
4,422,297,160,879,1757
5,417,300,191,908,1757
6,419,344,202,965,1757
7,391,351,225,967,1757
8,388,375,243,1006,1757
9,374,397,262,1033,1757
10,398,409,256,1063,1757
11,397,406,276,1079,1757
1,500,200,50,750,1758
2,462,230,97,789,1758
3,446,262,138,846,1758
4,409,272,185,866,1758
5,400,312,210,922,1758
6,404,299,235,938,1758
7,415,301,253,969,1758
8,426,328,260,1014,1758
9,409,344,276,1029,1758
10,400,362,290,1052,1758
11,406,370,297,1073,1758
1,500,200,50,750,1759
2,440,224,116,780,1759
3,422,245,155,822,1759
4,426,264,187,877,1759
5,398,293,214,905,1759
6,417,332,217,966,1759
7,408,346,239,993,1759
8,406,353,247,1006,1759
9,417,352,257,1026,1759
10,414,393,263,1070,1759
11,419,402,269,1090,1759
1,500,200,50,750,1760
2,437,239,99,775,1760
3,408,271,137,816,1760
4,397,287,170,854,1760
5,398,328,184,910,1760
6,394,345,197,936,1760
7,401,375,221,997,1760
8,389,376,237,1002,1760
9,393,405,242,1040,1760
10,413,409,247,1069,1760
11,397,414,250,1061,1760
1,500,200,50,750,1761
2,453,215,114,782,1761
3,422,249,151,822,1761
4,401,286,183,870,1761
5,390,318,197,905,1761
6,386,333,237,956,1761
7,376,360,244,980,1761
8,357,360,267,984,1761
9,377,407,264,1048,1761
10,380,403,269,1052,1761
11,382,427,276,1085,1761
1,500,200,50,750,1762
2,437,250,102,789,1762
3,399,292,136,827,1762
4,389,315,176,880,1762
5,374,332,198,904,1762
6,380,365,203,948,1762
7,399,356,225,980,1762
8,394,351,265,1010,1762
9,371,396,259,1026,1762
10,358,417,288,1063,1762
11,354,425,300,1079,1762
1,500,200,50,750,1763
2,462,218,107,787,1763
3,437,252,138,827,1763
4,425,263,176,864,1763
5,410,296,203,909,1763
6,426,318,220,964,1763
7,407,337,239,983,1763
8,393,347,260,1000,1763
9,398,359,268,1025,1763
10,403,386,270,1059,1763
11,414,392,274,1080,1763
1,500,200,50,750,1764
2,463,226,103,792,1764
3,438,252,135,825,1764
4,427,264,166,857,1764
5,423,317,178,918,1764
6,402,331,225,958,1764
7,402,337,233,972,1764
8,402,363,241,1006,1764
9,409,378,246,1033,1764
10,399,397,247,1043,1764
11,401,412,265,1078,1764
1,500,200,50,750,1765
2,466,225,96,787,1765
3,425,261,131,817,1765
4,414,290,155,859,1765
5,394,312,184,890,1765
6,400,321,228,949,1765
7,393,370,232,995,1765
8,405,354,249,1008,1765
9,409,371,262,1042,1765
10,372,424,275,1071,1765
11,398,426,261,1085,1765
1,500,200,50,750,1766
2,453,256,90,799,1766
3,422,253,140,815,1766
4,415,286,162,863,1766
5,420,305,183,908,1766
6,431,337,194,962,1766
7,439,343,213,995,1766
8,415,345,240,1000,1766
9,415,367,240,1022,1766
10,403,383,252,1038,1766
11,398,424,265,1087,1766
1,500,200,50,750,1767
2,467,222,98,787,1767
3,450,267,124,841,1767
4,423,291,165,879,1767
5,417,303,190,910,1767
6,403,334,199,936,1767
7,398,359,216,973,1767
8,399,368,228,995,1767
9,402,383,244,1029,1767
10,405,406,257,1068,1767
11,391,408,280,1079,1767
1,500,200,50,750,1768
2,450,236,102,788,1768
3,423,276,147,846,1768
4,384,291,182,857,1768
5,389,329,191,909,1768
6,392,359,203,954,1768
7,374,392,219,985,1768
8,365,379,251,995,1768
9,393,384,254,1031,1768
10,409,384,253,1046,1768
11,416,412,264,1092,1768
1,500,200,50,750,1769
2,459,240,93,792,1769
3,437,278,126,841,1769
4,413,280,168,861,1769
5,389,308,215,912,1769
6,391,342,239,972,1769
7,393,353,243,989,1769
8,396,353,250,999,1769
9,395,400,263,1058,1769
10,371,425,260,1056,1769
11,367,410,281,1058,1769
1,500,200,50,750,1770
2,455,227,97,779,1770
3,435,246,149,830,1770
4,399,295,174,868,1770
5,382,324,209,915,1770
6,387,342,225,954,1770
7,396,346,251,993,1770
8,383,368,240,991,1770
9,385,392,252,1029,1770
10,379,389,277,1045,1770
11,384,398,295,1077,1770
1,500,200,50,750,1771
2,453,240,87,780,1771
3,427,263,124,814,1771
4,432,291,152,875,1771
5,398,314,170,882,1771
6,405,345,193,943,1771
7,407,346,237,990,1771
8,403,355,246,1004,1771
9,400,391,242,1033,1771
10,398,408,252,1058,1771
11,429,398,276,1103,1771
1,500,200,50,750,1772
2,461,240,97,798,1772
3,447,266,118,831,1772
4,423,293,153,869,1772
5,412,323,183,918,1772
6,404,335,206,945,1772
7,410,356,213,979,1772
8,409,368,229,1006,1772
9,408,393,240,1041,1772
10,412,394,248,1054,1772
11,397,438,254,1089,1772
1,500,200,50,750,1773
2,464,227,93,784,1773
3,452,259,125,836,1773
4,395,293,170,858,1773
5,402,318,187,907,1773
6,414,317,225,956,1773
7,413,364,208,985,1773
8,408,353,245,1006,1773
9,390,371,271,1032,1773
10,409,362,300,1071,1773
11,427,390,275,1092,1773
1,500,200,50,750,1774
2,470,225,86,781,1774
3,463,244,124,831,1774
4,435,285,157,877,1774
5,424,327,168,919,1774
6,420,356,194,970,1774
7,376,395,195,966,1774
8,375,397,214,986,1774
9,392,407,238,1037,1774
10,400,413,243,1056,1774
11,402,418,262,1082,1774
1,500,200,50,750,1775
2,458,227,109,794,1775
3,411,262,156,829,1775
4,403,292,181,876,1775
5,410,322,195,927,1775
6,388,343,218,949,1775
7,382,346,254,982,1775
8,397,353,270,1020,1775
9,389,375,276,1040,1775
10,386,380,291,1057,1775
11,376,403,302,1081,1775
1,500,200,50,750,1776
2,481,223,82,786,1776
3,456,247,124,827,1776
4,445,280,158,883,1776
5,427,304,168,899,1776
6,440,330,190,960,1776
7,432,358,206,996,1776
8,432,365,210,1007,1776
9,408,383,239,1030,1776
10,407,392,264,1063,1776
11,405,388,289,1082,1776
1,500,200,50,750,1777
2,456,234,107,797,1777
3,418,262,149,829,1777
4,399,291,184,874,1777
5,387,332,197,916,1777
6,404,352,218,974,1777
7,391,362,233,986,1777
8,399,379,242,1020,1777
9,390,389,262,1041,1777
10,408,406,260,1074,1777
11,400,415,265,1080,1777
1,500,200,50,750,1778
2,469,238,78,785,1778
3,449,260,126,835,1778
4,412,282,160,854,1778
5,412,315,176,903,1778
6,410,324,214,948,1778
7,396,345,234,975,1778
8,398,382,228,1008,1778
9,396,381,264,1041,1778
10,385,380,271,1036,1778
11,388,395,279,1062,1778
1,500,200,50,750,1779
2,463,217,99,779,1779
3,437,270,121,828,1779
4,424,295,163,882,1779
5,396,316,188,900,1779
6,395,348,202,945,1779
7,410,356,217,983,1779
8,397,365,248,1010,1779
9,409,401,247,1057,1779
10,379,411,262,1052,1779
11,394,406,298,1098,1779
1,500,200,50,750,1780
2,456,244,93,793,1780
3,419,279,125,823,1780
4,396,297,180,873,1780
5,373,331,201,905,1780
6,380,344,231,955,1780
7,378,361,236,975,1780
8,392,377,234,1003,1780
9,410,385,231,1026,1780
10,417,396,249,1062,1780
11,405,413,255,1073,1780
1,500,200,50,750,1781
2,462,228,100,790,1781
3,440,248,137,825,1781
4,423,259,179,861,1781
5,407,295,206,908,1781
6,408,323,228,959,1781
7,399,350,229,978,1781
8,402,371,246,1019,1781
9,421,380,247,1048,1781
10,395,397,273,1065,1781
11,399,406,280,1085,1781
1,500,200,50,750,1782
2,453,241,88,782,1782
3,415,249,160,824,1782
4,409,271,184,864,1782
5,413,311,192,916,1782
6,412,348,199,959,1782
7,397,373,218,988,1782
8,391,388,232,1011,1782
9,381,376,263,1020,1782
10,415,415,250,1080,1782
11,393,439,255,1087,1782
1,500,200,50,750,1783
2,448,236,99,783,1783
3,419,258,135,812,1783
4,404,314,154,872,1783
5,407,341,167,915,1783
6,423,345,183,951,1783
7,405,362,224,991,1783
8,399,355,259,1013,1783
9,390,368,263,1021,1783
10,388,379,284,1051,1783
11,412,384,297,1093,1783
1,500,200,50,750,1784
2,481,230,82,793,1784
3,470,263,117,850,1784
4,449,282,147,878,1784
5,412,309,176,897,1784
6,410,342,197,949,1784
7,416,338,232,986,1784
8,388,367,265,1020,1784
9,379,372,274,1025,1784
10,393,386,284,1063,1784
11,404,381,300,1085,1784
1,500,200,50,750,1785
2,456,230,87,773,1785
3,433,271,127,831,1785
4,401,289,156,846,1785
5,400,318,179,897,1785
6,430,333,199,962,1785
7,421,348,212,981,1785
8,411,364,226,1001,1785
9,424,367,258,1049,1785
10,405,390,246,1041,1785
11,384,421,272,1077,1785
1,500,200,50,750,1786
2,475,213,88,776,1786
3,456,243,129,828,1786
4,425,267,159,851,1786
5,397,332,185,914,1786
6,390,352,212,954,1786
7,389,349,235,973,1786
8,391,370,248,1009,1786
9,394,390,261,1045,1786
10,382,385,270,1037,1786
11,373,421,259,1053,1786
1,500,200,50,750,1787
2,451,218,112,781,1787
3,436,242,151,829,1787
4,429,277,159,865,1787
5,423,292,171,886,1787
6,439,315,199,953,1787
7,439,352,199,990,1787
8,417,352,232,1001,1787
9,419,369,248,1036,1787
10,390,387,287,1064,1787
11,378,427,284,1089,1787
1,500,200,50,750,1788
2,466,236,84,786,1788
3,455,249,119,823,1788
4,446,260,155,861,1788
5,439,303,161,903,1788
6,419,322,201,942,1788
7,389,341,234,964,1788
8,401,362,245,1008,1788
9,390,397,243,1030,1788
10,403,387,267,1057,1788
11,428,411,241,1080,1788
1,500,200,50,750,1789
2,442,245,101,788,1789
3,400,262,153,815,1789
4,386,292,182,860,1789
5,405,326,199,930,1789
6,374,349,226,949,1789
7,369,373,235,977,1789
8,377,363,254,994,1789
9,386,384,259,1029,1789
10,375,416,261,1052,1789
11,387,409,286,1082,1789
1,500,200,50,750,1790
2,467,235,96,798,1790
3,443,254,126,823,1790
4,440,276,160,876,1790
5,423,293,184,900,1790
6,440,320,207,967,1790
7,419,338,229,986,1790
8,418,338,248,1004,1790
9,417,374,260,1051,1790
10,387,399,273,1059,1790
11,429,390,278,1097,1790
1,500,200,50,750,1791
2,461,225,102,788,1791
3,448,262,135,845,1791
4,419,296,150,865,1791
5,409,320,187,916,1791
6,420,331,207,958,1791
7,401,360,214,975,1791
8,419,376,233,1028,1791
9,391,370,262,1023,1791
10,388,389,284,1061,1791
11,411,407,262,1080,1791
1,500,200,50,750,1792
2,462,218,111,791,1792
3,431,260,133,824,1792
4,428,289,144,861,1792
5,407,302,188,897,1792
6,427,336,210,973,1792
7,395,348,225,968,1792
8,407,381,222,1010,1792
9,399,369,249,1017,1792
10,415,377,270,1062,1792
11,415,395,262,1072,1792
1,500,200,50,750,1793
2,461,221,109,791,1793
3,441,258,137,836,1793
4,424,283,161,868,1793
5,412,332,176,920,1793
6,410,325,214,949,1793
7,427,342,227,996,1793
8,422,354,235,1011,1793
9,408,388,237,1033,1793
10,429,380,241,1050,1793
11,413,398,260,1071,1793
1,500,200,50,750,1794
2,451,224,110,785,1794
3,415,259,158,832,1794
4,407,276,173,856,1794
5,404,317,199,920,1794
6,394,346,225,965,1794
7,370,363,241,974,1794
8,391,374,245,1010,1794
9,387,380,271,1038,1794
10,403,374,283,1060,1794
11,417,382,293,1092,1794
1,500,200,50,750,1795
2,461,214,112,787,1795
3,436,254,132,822,1795
4,441,288,148,877,1795
5,408,312,191,911,1795
6,422,331,195,948,1795
7,422,340,224,986,1795
8,406,371,230,1007,1795
9,406,410,234,1050,1795
10,393,396,265,1054,1795
11,425,401,277,1103,1795
1,500,200,50,750,1796
2,439,251,95,785,1796
3,429,269,124,822,1796
4,418,286,161,865,1796
5,391,313,192,896,1796
6,409,330,214,953,1796
7,428,347,220,995,1796
8,414,346,248,1008,1796
9,397,392,247,1036,1796
10,413,423,227,1063,1796
11,393,439,264,1096,1796
1,500,200,50,750,1797
2,459,229,91,779,1797
3,444,251,136,831,1797
4,423,276,164,863,1797
5,408,312,193,913,1797
6,389,334,221,944,1797
7,381,346,239,966,1797
8,388,348,267,1003,1797
9,398,373,278,1049,1797
10,395,397,272,1064,1797
11,395,401,291,1087,1797
1,500,200,50,750,1798
2,444,247,85,776,1798
3,436,279,105,820,1798
4,434,298,140,872,1798
5,404,318,180,902,1798
6,386,341,195,922,1798
7,388,369,208,965,1798
8,404,377,239,1020,1798
9,418,353,260,1031,1798
10,438,358,273,1069,1798
11,425,380,269,1074,1798
1,500,200,50,750,1799
2,443,232,107,782,1799
3,412,257,160,829,1799
4,391,294,176,861,1799
5,398,307,208,913,1799
6,415,332,221,968,1799
7,393,353,229,975,1799
8,376,373,251,1000,1799
9,366,388,265,1019,1799
10,376,401,280,1057,1799
11,370,414,291,1075,1799
1,500,200,50,750,1800
2,460,239,92,791,1800
3,430,246,149,825,1800
4,432,279,177,888,1800
5,437,289,192,918,1800
6,422,326,205,953,1800
7,406,334,225,965,1800
8,396,374,229,999,1800
9,391,414,242,1047,1800
10,383,415,264,1062,1800
11,384,405,276,1065,1800
1,500,200,50,750,1801
2,456,232,104,792,1801
3,423,254,144,821,1801
4,411,290,162,863,1801
5,400,325,192,917,1801
6,408,327,221,956,1801
7,416,362,216,994,1801
8,419,360,234,1013,1801
9,405,397,232,1034,1801
10,408,381,250,1039,1801
11,409,385,275,1069,1801
1,500,200,50,750,1802
2,463,237,92,792,1802
3,444,260,129,833,1802
4,425,277,163,865,1802
5,419,285,198,902,1802
6,419,320,214,953,1802
7,409,360,204,973,1802
8,422,370,227,1019,1802
9,402,368,248,1018,1802
10,389,404,245,1038,1802
11,420,402,262,1084,1802
1,500,200,50,750,1803
2,466,227,112,805,1803
3,426,255,145,826,1803
4,399,305,167,871,1803
5,401,303,210,914,1803
6,396,343,218,957,1803
7,400,363,229,992,1803
8,386,380,241,1007,1803
9,379,377,260,1016,1803
10,403,401,265,1069,1803
11,399,385,283,1067,1803
1,500,200,50,750,1804
2,443,250,87,780,1804
3,421,271,141,833,1804
4,387,293,179,859,1804
5,396,304,216,916,1804
6,387,330,227,944,1804
7,396,341,245,982,1804
8,403,346,252,1001,1804
9,404,378,249,1031,1804
10,398,377,275,1050,1804
11,391,403,281,1075,1804
1,500,200,50,750,1805
2,471,223,91,785,1805
3,448,248,148,844,1805
4,412,288,168,868,1805
5,410,322,184,916,1805
6,409,327,222,958,1805
7,386,340,245,971,1805
8,390,351,262,1003,1805
9,389,367,268,1024,1805
10,395,394,270,1059,1805
11,407,419,258,1084,1805
1,500,200,50,750,1806
2,442,230,103,775,1806
3,417,250,150,817,1806
4,422,293,167,882,1806
5,414,311,190,915,1806
6,399,326,226,951,1806
7,385,364,226,975,1806
8,398,363,259,1020,1806
9,402,367,265,1034,1806
10,384,406,265,1055,1806
11,394,411,273,1078,1806
1,500,200,50,750,1807
2,459,221,101,781,1807
3,445,254,128,827,1807
4,397,283,153,833,1807
5,412,308,179,899,1807
6,398,370,207,975,1807
7,376,375,238,989,1807
8,338,402,259,999,1807
9,360,404,279,1043,1807
10,384,390,284,1058,1807
11,407,389,288,1084,1807
1,500,200,50,750,1808
2,445,235,110,790,1808
3,395,261,155,811,1808
4,397,297,170,864,1808
5,423,305,192,920,1808
6,429,311,220,960,1808
7,395,343,240,978,1808
8,399,388,238,1025,1808
9,384,392,253,1029,1808
10,388,416,260,1064,1808
11,395,421,271,1087,1808
1,500,200,50,750,1809
2,461,239,87,787,1809
3,418,276,117,811,1809
4,412,296,161,869,1809
5,408,332,174,914,1809
6,427,336,200,963,1809
7,414,352,215,981,1809
8,415,372,227,1014,1809
9,403,389,245,1037,1809
10,385,410,272,1067,1809
11,396,423,265,1084,1809
1,500,200,50,750,1810
2,449,224,107,780,1810
3,421,260,149,830,1810
4,403,300,166,869,1810
5,387,340,191,918,1810
6,376,347,215,938,1810
7,386,399,214,999,1810
8,376,401,238,1015,1810
9,373,382,262,1017,1810
10,410,393,270,1073,1810
11,401,387,282,1070,1810
1,500,200,50,750,1811
2,456,228,96,780,1811
3,438,271,113,822,1811
4,424,285,145,854,1811
5,425,304,170,899,1811
6,415,344,192,951,1811
7,413,368,198,979,1811
8,428,364,214,1006,1811
9,423,378,227,1028,1811
10,440,378,265,1083,1811
11,406,406,265,1077,1811
1,500,200,50,750,1812
2,444,235,108,787,1812
3,417,271,129,817,1812
4,397,307,156,860,1812
5,385,315,187,887,1812
6,395,344,217,956,1812
7,383,351,237,971,1812
8,410,350,242,1002,1812
9,409,365,252,1026,1812
10,407,387,263,1057,1812
11,416,391,284,1091,1812
1,500,200,50,750,1813
2,452,224,111,787,1813
3,436,249,150,835,1813
4,413,266,171,850,1813
5,410,309,185,904,1813
6,423,322,227,972,1813
7,391,348,236,975,1813
8,390,363,245,998,1813
9,382,386,281,1049,1813
10,374,392,298,1064,1813
11,390,419,296,1105,1813
1,500,200,50,750,1814
2,442,245,89,776,1814
3,415,266,123,804,1814
4,424,296,165,885,1814
5,413,310,196,919,1814
6,425,348,204,977,1814
7,412,339,226,977,1814
8,411,369,227,1007,1814
9,402,383,249,1034,1814
10,396,388,270,1054,1814
11,406,379,281,1066,1814
1,500,200,50,750,1815
2,464,233,92,789,1815
3,417,266,122,805,1815
4,426,283,152,861,1815
5,420,298,167,885,1815
6,414,341,192,947,1815
7,408,351,216,975,1815
8,416,363,237,1016,1815
9,401,366,266,1033,1815
10,411,391,253,1055,1815
11,392,415,282,1089,1815
1,500,200,50,750,1816
2,471,220,85,776,1816
3,426,251,133,810,1816
4,439,275,162,876,1816
5,412,308,199,919,1816
6,401,327,230,958,1816
7,387,340,248,975,1816
8,373,354,265,992,1816
9,389,383,268,1040,1816
10,390,395,265,1050,1816
11,394,398,289,1081,1816
1,500,200,50,750,1817
2,460,239,97,796,1817
3,415,275,129,819,1817
4,376,331,152,859,1817
5,395,348,165,908,1817
6,397,349,205,951,1817
7,379,365,221,965,1817
8,375,387,245,1007,1817
9,393,382,247,1022,1817
10,402,416,232,1050,1817
11,390,427,241,1058,1817
1,500,200,50,750,1818
2,452,243,87,782,1818
3,431,262,126,819,1818
4,423,268,175,866,1818
5,421,307,188,916,1818
6,399,344,217,960,1818
7,382,357,221,960,1818
8,403,373,235,1011,1818
9,405,393,240,1038,1818
10,409,409,238,1056,1818
11,415,403,273,1091,1818
1,500,200,50,750,1819
2,454,228,112,794,1819
3,451,250,134,835,1819
4,436,269,146,851,1819
5,447,288,183,918,1819
6,439,319,198,956,1819
7,417,340,227,984,1819
8,400,362,245,1007,1819
9,395,371,260,1026,1819
10,404,400,264,1068,1819
11,393,399,291,1083,1819
1,500,200,50,750,1820
2,453,214,99,766,1820
3,416,255,140,811,1820
4,412,307,161,880,1820
5,395,317,189,901,1820
6,417,332,200,949,1820
7,431,322,239,992,1820
8,411,351,257,1019,1820
9,397,366,250,1013,1820
10,415,398,247,1060,1820
11,411,422,251,1084,1820
1,500,200,50,750,1821
2,457,242,90,789,1821
3,445,266,116,827,1821
4,424,285,144,853,1821
5,405,320,186,911,1821
6,411,335,210,956,1821
7,373,378,235,986,1821
8,369,410,221,1000,1821
9,389,415,241,1045,1821
10,378,400,282,1060,1821
11,394,436,276,1106,1821
1,500,200,50,750,1822
2,452,236,101,789,1822
3,431,278,117,826,1822
4,425,289,151,865,1822
5,413,327,185,925,1822
6,414,338,219,971,1822
7,405,366,223,994,1822
8,391,356,245,992,1822
9,411,385,240,1036,1822
10,402,390,251,1043,1822
11,411,397,261,1069,1822
1,500,200,50,750,1823
2,476,227,88,791,1823
3,454,264,116,834,1823
4,442,267,165,874,1823
5,410,296,191,897,1823
6,439,319,202,960,1823
7,419,344,228,991,1823
8,395,353,251,999,1823
9,396,380,251,1027,1823
10,398,416,240,1054,1823
11,395,417,276,1088,1823
1,500,200,50,750,1824
2,475,216,96,787,1824
3,430,242,153,825,1824
4,426,285,168,879,1824
5,417,303,194,914,1824
6,405,328,216,949,1824
7,404,357,225,986,1824
8,413,365,235,1013,1824
9,396,387,235,1018,1824
10,399,393,267,1059,1824
11,391,395,285,1071,1824
1,500,200,50,750,1825
2,459,219,94,772,1825
3,442,257,135,834,1825
4,435,295,157,887,1825
5,409,314,185,908,1825
6,410,323,197,930,1825
7,400,363,218,981,1825
8,394,394,203,991,1825
9,400,409,218,1027,1825
10,398,401,247,1046,1825
11,391,423,280,1094,1825
1,500,200,50,750,1826
2,456,247,86,789,1826
3,429,266,134,829,1826
4,416,277,177,870,1826
5,430,295,181,906,1826
6,429,318,214,961,1826
7,421,333,217,971,1826
8,437,353,224,1014,1826
9,401,365,268,1034,1826
10,390,395,271,1056,1826
11,397,424,259,1080,1826
1,500,200,50,750,1827
2,441,241,99,781,1827
3,419,290,115,824,1827
4,406,309,162,877,1827
5,371,338,188,897,1827
6,395,344,212,951,1827
7,399,363,240,1002,1827
8,368,367,252,987,1827
9,378,397,256,1031,1827
10,391,392,289,1072,1827
11,394,379,303,1076,1827
1,500,200,50,750,1828
2,441,246,98,785,1828
3,435,267,130,832,1828
4,416,291,167,874,1828
5,413,324,179,916,1828
6,419,319,215,953,1828
7,411,339,226,976,1828
8,393,341,270,1004,1828
9,408,358,271,1037,1828
10,409,389,261,1059,1828
11,408,398,265,1071,1828
1,500,200,50,750,1829
2,447,235,106,788,1829
3,417,269,146,832,1829
4,405,290,171,866,1829
5,383,321,196,900,1829
6,400,324,221,945,1829
7,400,336,233,969,1829
8,419,355,246,1020,1829
9,416,371,248,1035,1829
10,389,381,280,1050,1829
11,425,404,265,1094,1829
1,500,200,50,750,1830
2,475,243,89,807,1830
3,406,278,132,816,1830
4,391,307,165,863,1830
5,399,305,196,900,1830
6,393,340,215,948,1830
7,391,376,221,988,1830
8,363,395,240,998,1830
9,381,416,246,1043,1830
10,381,401,269,1051,1830
11,400,436,277,1113,1830
1,500,200,50,750,1831
2,451,230,98,779,1831
3,436,261,126,823,1831
4,414,295,153,862,1831
5,401,331,166,898,1831
6,420,370,186,976,1831
7,394,352,225,971,1831
8,382,370,260,1012,1831
9,385,373,267,1025,1831
10,411,393,265,1069,1831
11,393,394,285,1072,1831
1,500,200,50,750,1832
2,473,223,95,791,1832
3,428,269,125,822,1832
4,411,279,165,855,1832
5,401,301,212,914,1832
6,390,324,245,959,1832
7,373,360,256,989,1832
8,381,354,264,999,1832
9,384,396,258,1038,1832
10,408,393,263,1064,1832
11,417,398,255,1070,1832
1,500,200,50,750,1833
2,457,212,109,778,1833
3,433,274,124,831,1833
4,431,274,162,867,1833
5,409,311,194,914,1833
6,410,350,205,965,1833
7,409,338,230,977,1833
8,415,378,235,1028,1833
9,386,379,262,1027,1833
10,407,382,275,1064,1833
11,405,415,274,1094,1833
1,500,200,50,750,1834
2,462,244,91,797,1834
3,438,267,126,831,1834
4,432,298,144,874,1834
5,446,312,171,929,1834
6,434,343,196,973,1834
7,418,354,213,985,1834
8,408,363,249,1020,1834
9,397,391,247,1035,1834
10,384,394,275,1053,1834
11,392,432,270,1094,1834
1,500,200,50,750,1835
2,465,230,94,789,1835
3,438,257,144,839,1835
4,403,268,174,845,1835
5,403,301,205,909,1835
6,434,308,214,956,1835
7,419,327,235,981,1835
8,424,345,251,1020,1835
9,390,372,263,1025,1835
10,390,389,273,1052,1835
11,394,393,287,1074,1835
1,500,200,50,750,1836
2,472,232,96,800,1836
3,448,251,133,832,1836
4,423,280,156,859,1836
5,394,324,183,901,1836
6,405,317,229,951,1836
7,374,363,238,975,1836
8,356,391,256,1003,1836
9,360,404,269,1033,1836
10,358,423,280,1061,1836
11,374,431,295,1100,1836
1,500,200,50,750,1837
2,453,238,103,794,1837
3,417,261,137,815,1837
4,404,284,167,855,1837
5,408,315,194,917,1837
6,412,321,225,958,1837
7,409,336,239,984,1837
8,403,362,254,1019,1837
9,393,371,266,1030,1837
10,388,374,298,1060,1837
11,417,378,282,1077,1837
1,500,200,50,750,1838
2,451,233,107,791,1838
3,445,260,139,844,1838
4,435,274,160,869,1838
5,423,322,179,924,1838
6,414,343,202,959,1838
7,393,338,238,969,1838
8,415,353,246,1014,1838
9,390,390,261,1041,1838
10,362,389,288,1039,1838
11,406,378,283,1067,1838
1,500,200,50,750,1839
2,464,223,107,794,1839
3,434,262,148,844,1839
4,432,286,157,875,1839
5,381,325,192,898,1839
6,385,346,211,942,1839
7,398,353,229,980,1839
8,389,375,234,998,1839
9,400,375,247,1022,1839
10,416,363,285,1064,1839
11,427,391,282,1100,1839
1,500,200,50,750,1840
2,458,239,92,789,1840
3,458,262,117,837,1840
4,445,290,152,887,1840
5,400,300,195,895,1840
6,399,351,212,962,1840
7,391,380,208,979,1840
8,419,359,231,1009,1840
9,393,389,253,1035,1840
10,384,400,278,1062,1840
11,391,402,297,1090,1840
1,500,200,50,750,1841
2,446,256,99,801,1841
3,402,289,142,833,1841
4,391,301,172,864,1841
5,402,318,204,924,1841
6,409,336,211,956,1841
7,413,364,219,996,1841
8,394,381,229,1004,1841
9,414,368,267,1049,1841
10,408,397,251,1056,1841
11,440,393,267,1100,1841
1,500,200,50,750,1842
2,459,220,104,783,1842
3,445,266,128,839,1842
4,436,285,145,866,1842
5,437,324,154,915,1842
6,425,352,187,964,1842
7,410,365,207,982,1842
8,404,371,226,1001,1842
9,428,345,258,1031,1842
10,395,390,259,1044,1842
11,410,397,283,1090,1842
1,500,200,50,750,1843
2,463,226,95,784,1843
3,444,265,135,844,1843
4,435,275,163,873,1843
5,402,334,183,919,1843
6,398,354,195,947,1843
7,394,368,215,977,1843
8,384,365,244,993,1843
9,391,397,254,1042,1843
10,377,374,287,1038,1843
11,404,389,288,1081,1843
1,500,200,50,750,1844
2,475,219,102,796,1844
3,440,244,131,815,1844
4,416,282,162,860,1844
5,399,312,199,910,1844
6,379,344,213,936,1844
7,391,373,229,993,1844
8,393,368,252,1013,1844
9,406,384,247,1037,1844
10,397,401,260,1058,1844
11,396,403,270,1069,1844
1,500,200,50,750,1845
2,454,233,100,787,1845
3,422,284,114,820,1845
4,421,314,151,886,1845
5,392,331,183,906,1845
6,394,351,208,953,1845
7,368,361,219,948,1845
8,384,389,246,1019,1845
9,355,396,279,1030,1845
10,356,416,275,1047,1845
11,385,405,285,1075,1845
1,500,200,50,750,1846
2,441,231,116,788,1846
3,408,232,166,806,1846
4,403,276,187,866,1846
5,404,320,201,925,1846
6,395,327,227,949,1846
7,393,335,247,975,1846
8,391,362,251,1004,1846
9,376,391,261,1028,1846
10,368,416,283,1067,1846
11,365,430,291,1086,1846
1,500,200,50,750,1847
2,462,236,93,791,1847
3,417,259,132,808,1847
4,419,280,163,862,1847
5,430,310,182,922,1847
6,443,297,236,976,1847
7,420,327,237,984,1847
8,411,347,249,1007,1847
9,408,369,259,1036,1847
10,415,377,266,1058,1847
11,389,392,292,1073,1847
1,500,200,50,750,1848
2,462,219,105,786,1848
3,420,269,141,830,1848
4,410,293,171,874,1848
5,407,312,200,919,1848
6,400,349,208,957,1848
7,399,341,227,967,1848
8,404,350,238,992,1848
9,422,375,254,1051,1848
10,396,391,266,1053,1848
11,404,415,263,1082,1848
1,500,200,50,750,1849
2,446,228,99,773,1849
3,432,278,133,843,1849
4,405,302,155,862,1849
5,389,344,173,906,1849
6,419,363,195,977,1849
7,382,394,211,987,1849
8,369,396,250,1015,1849
9,370,410,259,1039,1849
10,383,415,264,1062,1849
11,385,414,278,1077,1849
1,500,200,50,750,1850
2,475,220,94,789,1850
3,436,265,124,825,1850
4,413,303,163,879,1850
5,405,320,182,907,1850
6,375,363,218,956,1850
7,370,391,228,989,1850
8,356,391,256,1003,1850
9,346,414,279,1039,1850
10,339,400,301,1040,1850
11,369,417,298,1084,1850
1,500,200,50,750,1851
2,475,209,101,785,1851
3,456,233,127,816,1851
4,463,258,152,873,1851
5,456,303,179,938,1851
6,437,313,205,955,1851
7,423,346,221,990,1851
8,377,392,234,1003,1851
9,368,416,254,1038,1851
10,359,424,279,1062,1851
11,371,432,276,1079,1851
1,500,200,50,750,1852
2,457,232,99,788,1852
3,423,254,140,817,1852
4,454,274,158,886,1852
5,421,303,184,908,1852
6,406,339,199,944,1852
7,415,360,207,982,1852
8,401,364,241,1006,1852
9,376,397,247,1020,1852
10,398,391,260,1049,1852
11,407,412,272,1091,1852
1,500,200,50,750,1853
2,436,240,102,778,1853
3,413,263,137,813,1853
4,404,274,185,863,1853
5,433,293,191,917,1853
6,426,306,215,947,1853
7,432,343,215,990,1853
8,412,371,238,1021,1853
9,405,374,257,1036,1853
10,404,383,252,1039,1853
11,429,417,249,1095,1853
1,500,200,50,750,1854
2,455,236,98,789,1854
3,425,250,145,820,1854
4,413,283,176,872,1854
5,406,316,194,916,1854
6,408,326,225,959,1854
7,404,334,246,984,1854
8,396,356,246,998,1854
9,395,387,256,1038,1854
10,397,399,249,1045,1854
11,403,414,255,1072,1854
1,500,200,50,750,1855
2,447,250,108,805,1855
3,410,287,124,821,1855
4,420,269,179,868,1855
5,409,306,200,915,1855
6,413,327,237,977,1855
7,407,360,219,986,1855
8,402,346,246,994,1855
9,398,361,257,1016,1855
10,398,381,275,1054,1855
11,406,420,271,1097,1855
1,500,200,50,750,1856
2,448,231,92,771,1856
3,427,252,142,821,1856
4,425,251,171,847,1856
5,433,302,192,927,1856
6,410,325,231,966,1856
7,400,328,247,975,1856
8,388,370,250,1008,1856
9,381,403,241,1025,1856
10,406,428,244,1078,1856
11,387,436,249,1072,1856
1,500,200,50,750,1857
2,457,246,96,799,1857
3,441,261,138,840,1857
4,410,305,146,861,1857
5,423,330,179,932,1857
6,420,351,194,965,1857
7,412,360,218,990,1857
8,411,348,250,1009,1857
9,378,363,267,1008,1857
10,407,400,256,1063,1857
11,418,423,256,1097,1857
1,500,200,50,750,1858
2,457,225,102,784,1858
3,410,281,130,821,1858
4,410,297,164,871,1858
5,401,314,193,908,1858
6,414,323,222,959,1858
7,389,353,247,989,1858
8,378,371,249,998,1858
9,377,394,271,1042,1858
10,389,394,277,1060,1858
11,396,420,274,1090,1858
1,500,200,50,750,1859
2,457,217,115,789,1859
3,425,265,142,832,1859
4,396,298,179,873,1859
5,392,316,198,906,1859
6,401,350,215,966,1859
7,395,356,231,982,1859
8,393,363,264,1020,1859
9,383,355,295,1033,1859
10,376,387,286,1049,1859
11,380,387,302,1069,1859
1,500,200,50,750,1860
2,447,241,95,783,1860
3,455,264,113,832,1860
4,414,298,146,858,1860
5,414,318,173,905,1860
6,422,324,208,954,1860
7,416,345,223,984,1860
8,397,379,227,1003,1860
9,408,389,247,1044,1860
10,401,412,255,1068,1860
11,394,407,281,1082,1860
1,500,200,50,750,1861
2,470,209,99,778,1861
3,446,230,129,805,1861
4,451,272,156,879,1861
5,397,294,208,899,1861
6,426,324,223,973,1861
7,387,354,228,969,1861
8,398,354,254,1006,1861
9,379,385,260,1024,1861
10,395,392,266,1053,1861
11,409,403,275,1087,1861
1,500,200,50,750,1862
2,458,228,104,790,1862
3,440,249,138,827,1862
4,421,304,155,880,1862
5,417,319,177,913,1862
6,412,344,205,961,1862
7,386,369,228,983,1862
8,385,396,226,1007,1862
9,395,418,217,1030,1862
10,423,409,240,1072,1862
11,421,427,237,1085,1862
1,500,200,50,750,1863
2,478,209,104,791,1863
3,429,254,137,820,1863
4,416,275,178,869,1863
5,402,295,203,900,1863
6,417,307,240,964,1863
7,378,330,262,970,1863
8,405,351,258,1014,1863
9,419,354,246,1019,1863
10,444,390,232,1066,1863
11,430,381,262,1073,1863
1,500,200,50,750,1864
2,440,234,105,779,1864
3,416,257,147,820,1864
4,402,288,176,866,1864
5,392,320,194,906,1864
6,393,331,222,946,1864
7,388,336,258,982,1864
8,417,359,239,1015,1864
9,389,372,246,1007,1864
10,427,401,242,1070,1864
11,417,401,271,1089,1864
1,500,200,50,750,1865
2,443,239,105,787,1865
3,426,250,151,827,1865
4,383,305,188,876,1865
5,382,327,199,908,1865
6,396,316,235,947,1865
7,389,342,243,974,1865
8,411,348,261,1020,1865
9,391,386,262,1039,1865
10,394,381,285,1060,1865
11,408,410,271,1089,1865
1,500,200,50,750,1866
2,481,224,93,798,1866
3,455,237,129,821,1866
4,447,278,158,883,1866
5,443,299,179,921,1866
6,428,333,208,969,1866
7,421,345,234,1000,1866
8,394,362,242,998,1866
9,392,396,251,1039,1866
10,384,393,262,1039,1866
11,400,394,282,1076,1866
1,500,200,50,750,1867
2,463,228,98,789,1867
3,418,284,130,832,1867
4,409,309,166,884,1867
5,383,334,191,908,1867
6,364,369,203,936,1867
7,366,375,229,970,1867
8,379,390,225,994,1867
9,396,383,254,1033,1867
10,404,411,250,1065,1867
11,405,393,278,1076,1867
1,500,200,50,750,1868
2,450,246,95,791,1868
3,409,286,127,822,1868
4,408,288,188,884,1868
5,392,313,194,899,1868
6,414,356,204,974,1868
7,404,363,227,994,1868
8,405,379,229,1013,1868
9,402,393,252,1047,1868
10,381,413,262,1056,1868
11,406,420,275,1101,1868
1,500,200,50,750,1869
2,451,230,114,795,1869
3,419,250,149,818,1869
4,398,279,187,864,1869
5,397,312,194,903,1869
6,412,313,219,944,1869
7,424,339,212,975,1869
8,433,348,246,1027,1869
9,410,376,246,1032,1869
10,410,402,259,1071,1869
11,392,419,264,1075,1869
1,500,200,50,750,1870
2,474,226,96,796,1870
3,427,264,141,832,1870
4,409,284,157,850,1870
5,397,314,199,910,1870
6,397,323,230,950,1870
7,375,342,246,963,1870
8,402,353,259,1014,1870
9,403,357,269,1029,1870
10,409,380,263,1052,1870
11,413,401,268,1082,1870
1,500,200,50,750,1871
2,448,237,105,790,1871
3,428,254,136,818,1871
4,426,277,172,875,1871
5,433,304,188,925,1871
6,423,348,187,958,1871
7,403,369,205,977,1871
8,384,392,226,1002,1871
9,405,378,248,1031,1871
10,407,371,264,1042,1871
11,432,376,283,1091,1871
1,500,200,50,750,1872
2,465,239,102,806,1872
3,432,267,129,828,1872
4,423,289,162,874,1872
5,425,316,175,916,1872
6,398,350,196,944,1872
7,399,357,226,982,1872
8,404,349,252,1005,1872
9,385,359,276,1020,1872
10,401,384,273,1058,1872
11,407,393,291,1091,1872
1,500,200,50,750,1873
2,452,249,82,783,1873
3,423,277,130,830,1873
4,411,301,156,868,1873
5,419,311,172,902,1873
6,431,325,200,956,1873
7,430,326,224,980,1873
8,435,342,240,1017,1873
9,422,355,262,1039,1873
10,396,396,276,1068,1873
11,372,417,283,1072,1873
1,500,200,50,750,1874
2,468,227,93,788,1874
3,431,257,144,832,1874
4,411,292,167,870,1874
5,413,313,195,921,1874
6,399,335,212,946,1874
7,394,359,228,981,1874
8,402,358,235,995,1874
9,389,382,245,1016,1874
10,397,409,246,1052,1874
11,411,417,259,1087,1874
1,500,200,50,750,1875
2,443,232,110,785,1875
3,432,275,124,831,1875
4,398,311,161,870,1875
5,380,307,204,891,1875
6,403,353,213,969,1875
7,392,366,230,988,1875
8,374,383,245,1002,1875
9,387,403,243,1033,1875
10,396,413,249,1058,1875
11,397,422,263,1082,1875
1,500,200,50,750,1876
2,476,225,96,797,1876
3,437,242,137,816,1876
4,415,279,173,867,1876
5,414,307,185,906,1876
6,412,323,234,969,1876
7,394,358,229,981,1876
8,372,379,243,994,1876
9,379,405,252,1036,1876
10,389,402,255,1046,1876
11,392,413,256,1061,1876
1,500,200,50,750,1877
2,473,226,91,790,1877
3,450,256,135,841,1877
4,431,273,163,867,1877
5,407,299,196,902,1877
6,401,338,220,959,1877
7,389,354,233,976,1877
8,404,374,238,1016,1877
9,383,365,273,1021,1877
10,391,389,273,1053,1877
11,387,415,276,1078,1877
1,500,200,50,750,1878
2,443,243,101,787,1878
3,419,256,144,819,1878
4,420,279,167,866,1878
5,420,315,183,918,1878
6,405,342,216,963,1878
7,388,356,225,969,1878
8,373,387,236,996,1878
9,385,369,278,1032,1878
10,394,364,282,1040,1878
11,412,391,283,1086,1878
1,500,200,50,750,1879
2,469,224,101,794,1879
3,429,268,142,839,1879
4,398,277,183,858,1879
5,405,320,194,919,1879
6,434,319,202,955,1879
7,420,349,216,985,1879
8,414,348,247,1009,1879
9,415,373,249,1037,1879
10,431,379,261,1071,1879
11,416,411,270,1097,1879
1,500,200,50,750,1880
2,451,228,111,790,1880
3,416,263,160,839,1880
4,399,285,179,863,1880
5,401,313,197,911,1880
6,405,360,207,972,1880
7,392,364,222,978,1880
8,373,373,249,995,1880
9,367,380,275,1022,1880
10,373,392,290,1055,1880
11,358,402,315,1075,1880
1,500,200,50,750,1881
2,480,219,87,786,1881
3,446,255,125,826,1881
4,434,270,155,859,1881
5,435,316,187,938,1881
6,420,327,208,955,1881
7,418,355,213,986,1881
8,420,371,222,1013,1881
9,434,357,239,1030,1881
10,443,372,248,1063,1881
11,443,380,253,1076,1881
1,500,200,50,750,1882
2,471,225,92,788,1882
3,439,245,134,818,1882
4,410,288,177,875,1882
5,411,285,199,895,1882
6,430,328,216,974,1882
7,407,328,240,975,1882
8,405,348,257,1010,1882
9,400,390,247,1037,1882
10,386,389,272,1047,1882
11,393,423,268,1084,1882
1,500,200,50,750,1883
2,460,247,93,800,1883
3,442,252,125,819,1883
4,416,290,154,860,1883
5,405,330,174,909,1883
6,397,366,200,963,1883
7,395,363,228,986,1883
8,394,374,247,1015,1883
9,385,413,233,1031,1883
10,400,426,252,1078,1883
11,418,426,264,1108,1883
1,500,200,50,750,1884
2,469,221,104,794,1884
3,445,250,133,828,1884
4,443,270,154,867,1884
5,424,297,180,901,1884
6,447,337,187,971,1884
7,393,380,202,975,1884
8,366,410,232,1008,1884
9,386,400,245,1031,1884
10,416,409,252,1077,1884
11,403,416,264,1083,1884
1,500,200,50,750,1885
2,457,230,110,797,1885
3,429,258,142,829,1885
4,412,267,178,857,1885
5,432,301,190,923,1885
6,415,321,224,960,1885
7,397,344,230,971,1885
8,406,341,246,993,1885
9,425,370,240,1035,1885
10,418,369,253,1040,1885
11,440,395,261,1096,1885
1,500,200,50,750,1886
2,442,228,100,770,1886
3,421,265,135,821,1886
4,419,299,176,894,1886
5,378,317,203,898,1886
6,406,327,230,963,1886
7,387,336,240,963,1886
8,392,368,252,1012,1886
9,390,365,266,1021,1886
10,392,379,292,1063,1886
11,385,402,299,1086,1886
1,500,200,50,750,1887
2,466,242,97,805,1887
3,443,249,125,817,1887
4,431,296,160,887,1887
5,390,327,186,903,1887
6,415,345,198,958,1887
7,421,352,230,1003,1887
8,397,344,263,1004,1887
9,392,374,270,1036,1887
10,389,407,261,1057,1887
11,406,399,277,1082,1887
1,500,200,50,750,1888
2,461,224,103,788,1888
3,432,257,133,822,1888
4,425,284,173,882,1888
5,397,294,197,888,1888
6,424,329,213,966,1888
7,419,355,225,999,1888
8,407,363,233,1003,1888
9,412,374,245,1031,1888
10,395,388,268,1051,1888
11,414,376,288,1078,1888
1,500,200,50,750,1889
2,456,247,95,798,1889
3,421,260,148,829,1889
4,400,307,159,866,1889
5,387,333,191,911,1889
6,409,351,208,968,1889
7,397,359,234,990,1889
8,412,352,245,1009,1889
9,400,363,271,1034,1889
10,399,397,282,1078,1889
11,387,376,318,1081,1889
1,500,200,50,750,1890
2,459,222,102,783,1890
3,441,249,134,824,1890
4,424,285,153,862,1890
5,424,311,186,921,1890
6,437,334,191,962,1890
7,415,369,200,984,1890
8,395,372,236,1003,1890
9,396,388,252,1036,1890
10,396,393,265,1054,1890
11,378,403,290,1071,1890
1,500,200,50,750,1891
2,442,246,95,783,1891
3,429,286,132,847,1891
4,406,307,153,866,1891
5,395,326,168,889,1891
6,421,337,212,970,1891
7,387,361,225,973,1891
8,388,364,235,987,1891
9,384,368,266,1018,1891
10,393,388,279,1060,1891
11,408,406,274,1088,1891
1,500,200,50,750,1892
2,468,227,96,791,1892
3,443,244,130,817,1892
4,416,293,154,863,1892
5,403,311,186,900,1892
6,387,357,215,959,1892
7,387,349,234,970,1892
8,403,377,236,1016,1892
9,404,384,249,1037,1892
10,410,389,248,1047,1892
11,433,397,262,1092,1892
1,500,200,50,750,1893
2,462,242,92,796,1893
3,421,265,137,823,1893
4,408,309,160,877,1893
5,401,325,199,925,1893
6,400,334,219,953,1893
7,390,357,236,983,1893
8,373,388,233,994,1893
9,402,385,233,1020,1893
10,412,405,241,1058,1893
11,415,422,245,1082,1893
1,500,200,50,750,1894
2,466,242,88,796,1894
3,422,282,119,823,1894
4,397,281,172,850,1894
5,409,301,196,906,1894
6,421,308,223,952,1894
7,412,333,230,975,1894
8,394,354,248,996,1894
9,407,380,251,1038,1894
10,407,386,262,1055,1894
11,391,420,273,1084,1894
1,500,200,50,750,1895
2,465,239,85,789,1895
3,432,270,134,836,1895
4,405,292,167,864,1895
5,422,297,185,904,1895
6,396,337,221,954,1895
7,404,352,236,992,1895
8,390,365,259,1014,1895
9,392,396,241,1029,1895
10,408,403,246,1057,1895
11,425,385,267,1077,1895
1,500,200,50,750,1896
2,456,229,99,784,1896
3,430,263,122,815,1896
4,409,296,154,859,1896
5,406,311,187,904,1896
6,411,336,213,960,1896
7,410,352,217,979,1896
8,397,391,233,1021,1896
9,375,404,244,1023,1896
10,399,397,263,1059,1896
11,393,432,262,1087,1896
1,500,200,50,750,1897
2,432,250,101,783,1897
3,410,268,145,823,1897
4,383,305,168,856,1897
5,389,316,199,904,1897
6,402,332,229,963,1897
7,393,368,230,991,1897
8,383,382,256,1021,1897
9,375,390,271,1036,1897
10,370,396,277,1043,1897
11,400,406,284,1090,1897
1,500,200,50,750,1898
2,450,237,105,792,1898
3,419,272,137,828,1898
4,406,288,164,858,1898
5,393,317,192,902,1898
6,400,332,219,951,1898
7,396,343,250,989,1898
8,392,349,258,999,1898
9,382,365,279,1026,1898
10,382,385,285,1052,1898
11,403,399,273,1075,1898
1,500,200,50,750,1899
2,465,230,104,799,1899
3,440,259,138,837,1899
4,427,295,160,882,1899
5,399,305,204,908,1899
6,428,331,219,978,1899
7,384,357,232,973,1899
8,403,376,239,1018,1899
9,419,403,229,1051,1899
10,413,413,241,1067,1899
11,404,411,263,1078,1899
1,500,200,50,750,1900
2,459,248,83,790,1900
3,428,274,129,831,1900
4,424,277,163,864,1900
5,420,291,203,914,1900
6,410,328,217,955,1900
7,407,352,225,984,1900
8,406,373,239,1018,1900
9,420,390,250,1060,1900
10,402,398,254,1054,1900
11,399,411,272,1082,1900
1,500,200,50,750,1901
2,465,215,100,780,1901
3,429,272,133,834,1901
4,405,273,167,845,1901
5,433,296,188,917,1901
6,446,321,204,971,1901
7,429,346,202,977,1901
8,438,365,210,1013,1901
9,419,377,236,1032,1901
10,453,385,225,1063,1901
11,466,395,231,1092,1901
1,500,200,50,750,1902
2,449,226,106,781,1902
3,400,259,147,806,1902
4,420,289,175,884,1902
5,408,318,197,923,1902
6,390,339,226,955,1902
7,370,352,260,982,1902
8,365,368,265,998,1902
9,355,406,269,1030,1902
10,378,423,257,1058,1902
11,384,453,268,1105,1902
1,500,200,50,750,1903
2,460,231,90,781,1903
3,435,262,124,821,1903
4,424,277,162,863,1903
5,427,314,168,909,1903
6,414,363,189,966,1903
7,401,374,208,983,1903
8,390,376,234,1000,1903
9,383,395,235,1013,1903
10,431,403,249,1083,1903
11,406,422,257,1085,1903
1,500,200,50,750,1904
2,466,234,101,801,1904
3,416,257,142,815,1904
4,414,289,176,879,1904
5,418,297,208,923,1904
6,406,347,213,966,1904
7,411,380,205,996,1904
8,395,373,226,994,1904
9,395,385,259,1039,1904
10,386,410,264,1060,1904
11,394,408,288,1090,1904
1,500,200,50,750,1905
2,471,240,92,803,1905
3,446,259,131,836,1905
4,436,289,159,884,1905
5,463,287,173,923,1905
6,446,303,200,949,1905
7,446,314,214,974,1905
8,424,341,231,996,1905
9,423,364,252,1039,1905
10,401,378,262,1041,1905
11,419,374,291,1084,1905
1,500,200,50,750,1906
2,460,244,95,799,1906
3,406,288,131,825,1906
4,425,309,151,885,1906
5,410,316,186,912,1906
6,399,347,206,952,1906
7,388,364,228,980,1906
8,399,374,224,997,1906
9,395,378,256,1029,1906
10,430,379,260,1069,1906
11,409,400,280,1089,1906
1,500,200,50,750,1907
2,470,223,102,795,1907
3,442,239,141,822,1907
4,431,246,192,869,1907
5,435,280,196,911,1907
6,432,321,210,963,1907
7,430,342,211,983,1907
8,396,376,241,1013,1907
9,376,402,246,1024,1907
10,406,420,245,1071,1907
11,414,422,259,1095,1907
1,500,200,50,750,1908
2,449,227,94,770,1908
3,448,264,119,831,1908
4,408,308,143,859,1908
5,421,303,187,911,1908
6,424,330,215,969,1908
7,398,367,224,989,1908
8,396,400,213,1009,1908
9,378,413,237,1028,1908
10,387,423,255,1065,1908
11,383,436,268,1087,1908
1,500,200,50,750,1909
2,455,229,91,775,1909
3,452,260,129,841,1909
4,433,296,142,871,1909
5,409,324,177,910,1909
6,390,362,205,957,1909
7,382,364,233,979,1909
8,392,372,233,997,1909
9,386,391,243,1020,1909
10,411,415,236,1062,1909
11,394,419,258,1071,1909
1,500,200,50,750,1910
2,453,233,100,786,1910
3,432,266,131,829,1910
4,418,290,168,876,1910
5,391,316,194,901,1910
6,396,329,237,962,1910
7,389,347,232,968,1910
8,381,363,249,993,1910
9,395,372,256,1023,1910
10,425,373,272,1070,1910
11,406,369,301,1076,1910
1,500,200,50,750,1911
2,465,233,102,800,1911
3,431,261,138,830,1911
4,407,292,165,864,1911
5,414,328,179,921,1911
6,417,341,198,956,1911
7,404,344,227,975,1911
8,402,361,241,1004,1911
9,404,380,262,1046,1911
10,391,406,260,1057,1911
11,394,414,272,1080,1911
1,500,200,50,750,1912
2,448,228,103,779,1912
3,437,277,128,842,1912
4,411,282,173,866,1912
5,421,296,210,927,1912
6,394,336,225,955,1912
7,395,355,232,982,1912
8,399,379,235,1013,1912
9,387,382,252,1021,1912
10,370,399,276,1045,1912
11,381,392,283,1056,1912
1,500,200,50,750,1913
2,471,211,123,805,1913
3,397,253,166,816,1913
4,370,309,193,872,1913
5,377,340,192,909,1913
6,370,368,210,948,1913
7,363,381,246,990,1913
8,381,396,236,1013,1913
9,382,411,256,1049,1913
10,379,413,275,1067,1913
11,375,418,276,1069,1913
1,500,200,50,750,1914
2,466,237,93,796,1914
3,408,275,136,819,1914
4,402,305,161,868,1914
5,398,322,190,910,1914
6,389,363,215,967,1914
7,384,364,235,983,1914
8,376,389,240,1005,1914
9,363,405,267,1035,1914
10,397,409,257,1063,1914
11,397,407,278,1082,1914
1,500,200,50,750,1915
2,453,237,115,805,1915
3,414,258,160,832,1915
4,416,301,142,859,1915
5,414,321,186,921,1915
6,413,332,214,959,1915
7,401,354,231,986,1915
8,370,368,275,1013,1915
9,358,393,265,1016,1915
10,411,383,275,1069,1915
11,399,375,301,1075,1915
1,500,200,50,750,1916
2,467,222,94,783,1916
3,437,278,113,828,1916
4,423,297,139,859,1916
5,435,304,182,921,1916
6,431,332,210,973,1916
7,402,353,219,974,1916
8,403,389,232,1024,1916
9,387,371,279,1037,1916
10,375,362,314,1051,1916
11,390,394,296,1080,1916
1,500,200,50,750,1917
2,441,228,112,781,1917
3,413,255,144,812,1917
4,428,276,161,865,1917
5,404,318,181,903,1917
6,400,357,191,948,1917
7,387,374,221,982,1917
8,383,379,251,1013,1917
9,370,369,281,1020,1917
10,378,397,279,1054,1917
11,396,395,285,1076,1917
1,500,200,50,750,1918
2,455,237,93,785,1918
3,422,251,149,822,1918
4,383,309,169,861,1918
5,387,342,173,902,1918
6,407,361,205,973,1918
7,395,373,221,989,1918
8,409,374,232,1015,1918
9,389,385,251,1025,1918
10,392,390,269,1051,1918
11,404,399,282,1085,1918
1,500,200,50,750,1919
2,447,237,98,782,1919
3,432,270,126,828,1919
4,408,297,161,866,1919
5,407,303,191,901,1919
6,406,317,230,953,1919
7,407,346,237,990,1919
8,416,348,259,1023,1919
9,388,353,273,1014,1919
10,392,392,268,1052,1919
11,403,417,286,1106,1919
1,500,200,50,750,1920
2,462,227,98,787,1920
3,424,259,139,822,1920
4,431,295,159,885,1920
5,416,315,189,920,1920
6,407,337,210,954,1920
7,412,368,205,985,1920
8,387,373,237,997,1920
9,390,378,270,1038,1920
10,380,386,272,1038,1920
11,389,406,272,1067,1920
1,500,200,50,750,1921
2,459,227,96,782,1921
3,444,263,130,837,1921
4,433,282,171,886,1921
5,394,304,217,915,1921
6,413,325,223,961,1921
7,405,340,239,984,1921
8,394,358,239,991,1921
9,388,398,240,1026,1921
10,404,398,266,1068,1921
11,393,427,266,1086,1921
1,500,200,50,750,1922
2,468,215,106,789,1922
3,432,243,158,833,1922
4,412,298,168,878,1922
5,406,337,184,927,1922
6,406,340,202,948,1922
7,417,349,225,991,1922
8,401,370,249,1020,1922
9,401,387,249,1037,1922
10,408,393,269,1070,1922
11,400,422,269,1091,1922
1,500,200,50,750,1923
2,446,247,92,785,1923
3,428,285,114,827,1923
4,423,296,152,871,1923
5,412,304,192,908,1923
6,415,320,205,940,1923
7,420,345,212,977,1923
8,398,377,222,997,1923
9,397,396,232,1025,1923
10,423,428,221,1072,1923
11,423,395,269,1087,1923
1,500,200,50,750,1924
2,436,242,114,792,1924
3,407,275,140,822,1924
4,395,280,184,859,1924
5,398,299,203,900,1924
6,426,321,205,952,1924
7,424,334,234,992,1924
8,402,366,232,1000,1924
9,396,372,254,1022,1924
10,379,410,259,1048,1924
11,419,398,277,1094,1924
1,500,200,50,750,1925
2,469,218,103,790,1925
3,407,261,142,810,1925
4,398,306,167,871,1925
5,408,328,189,925,1925
6,385,364,215,964,1925
7,364,367,240,971,1925
8,370,391,242,1003,1925
9,381,396,241,1018,1925
10,386,413,259,1058,1925
11,378,425,275,1078,1925
1,500,200,50,750,1926
2,445,222,106,773,1926
3,431,257,151,839,1926
4,428,280,174,882,1926
5,410,307,192,909,1926
6,401,332,205,938,1926
7,402,372,215,989,1926
8,383,387,234,1004,1926
9,400,386,258,1044,1926
10,382,401,270,1053,1926
11,386,408,291,1085,1926
1,500,200,50,750,1927
2,444,237,90,771,1927
3,402,267,141,810,1927
4,396,303,177,876,1927
5,372,353,193,918,1927
6,385,343,231,959,1927
7,378,364,245,987,1927
8,384,360,261,1005,1927
9,386,389,252,1027,1927
10,379,407,270,1056,1927
11,383,413,289,1085,1927
1,500,200,50,750,1928
2,444,239,102,785,1928
3,429,273,148,850,1928
4,377,321,160,858,1928
5,391,350,174,915,1928
6,387,345,203,935,1928
7,420,358,222,1000,1928
8,385,394,226,1005,1928
9,398,400,245,1043,1928
10,414,399,258,1071,1928
11,404,389,282,1075,1928
1,500,200,50,750,1929
2,465,243,85,793,1929
3,427,278,116,821,1929
4,414,288,152,854,1929
5,418,299,183,900,1929
6,443,314,204,961,1929
7,424,335,223,982,1929
8,421,341,247,1009,1929
9,429,385,249,1063,1929
10,384,409,256,1049,1929
11,409,412,259,1080,1929
1,500,200,50,750,1930
2,452,241,102,795,1930
3,424,254,156,834,1930
4,420,259,171,850,1930
5,421,290,194,905,1930
6,430,334,198,962,1930
7,423,356,208,987,1930
8,412,375,219,1006,1930
9,415,373,242,1030,1930
10,399,386,281,1066,1930
11,413,404,276,1093,1930
1,500,200,50,750,1931
2,445,253,88,786,1931
3,426,276,129,831,1931
4,405,304,159,868,1931
5,390,344,167,901,1931
6,396,347,195,938,1931
7,378,379,220,977,1931
8,377,399,235,1011,1931
9,383,396,269,1048,1931
10,366,412,272,1050,1931
11,387,431,271,1089,1931
1,500,200,50,750,1932
2,463,234,92,789,1932
3,436,272,121,829,1932
4,397,280,172,849,1932
5,398,315,188,901,1932
6,400,329,216,945,1932
7,399,358,218,975,1932
8,391,388,242,1021,1932
9,397,393,259,1049,1932
10,372,408,269,1049,1932
11,365,417,279,1061,1932
1,500,200,50,750,1933
2,476,233,87,796,1933
3,443,266,120,829,1933
4,411,279,160,850,1933
5,403,306,211,920,1933
6,383,343,232,958,1933
7,381,354,247,982,1933
8,388,371,255,1014,1933
9,391,395,255,1041,1933
10,389,410,269,1068,1933
11,410,394,280,1084,1933
1,500,200,50,750,1934
2,457,221,101,779,1934
3,428,263,138,829,1934
4,414,296,156,866,1934
5,407,315,186,908,1934
6,399,332,212,943,1934
7,408,329,234,971,1934
8,407,344,250,1001,1934
9,416,377,239,1032,1934
10,425,386,247,1058,1934
11,423,406,260,1089,1934
1,500,200,50,750,1935
2,467,228,94,789,1935
3,444,255,133,832,1935
4,429,282,160,871,1935
5,407,332,175,914,1935
6,405,338,203,946,1935
7,411,348,228,987,1935
8,402,359,247,1008,1935
9,391,375,255,1021,1935
10,377,365,296,1038,1935
11,415,364,318,1097,1935
1,500,200,50,750,1936
2,475,229,95,799,1936
3,441,247,130,818,1936
4,415,278,162,855,1936
5,432,313,171,916,1936
6,424,324,204,952,1936
7,445,341,207,993,1936
8,412,357,236,1005,1936
9,401,377,266,1044,1936
10,399,379,269,1047,1936
11,399,372,290,1061,1936
1,500,200,50,750,1937
2,441,250,98,789,1937
3,412,269,138,819,1937
4,412,310,161,883,1937
5,397,338,187,922,1937
6,415,351,206,972,1937
7,393,351,230,974,1937
8,405,350,260,1015,1937
9,389,381,265,1035,1937
10,409,391,266,1066,1937
11,402,388,288,1078,1937
1,500,200,50,750,1938
2,456,247,83,786,1938
3,427,243,136,806,1938
4,418,280,177,875,1938
5,425,317,188,930,1938
6,404,343,197,944,1938
7,405,335,238,978,1938
8,399,372,219,990,1938
9,405,369,250,1024,1938
10,435,367,257,1059,1938
11,410,393,268,1071,1938
1,500,200,50,750,1939
2,457,243,91,791,1939
3,414,291,131,836,1939
4,408,303,157,868,1939
5,406,321,171,898,1939
6,414,326,214,954,1939
7,407,360,233,1000,1939
8,373,364,255,992,1939
9,381,383,259,1023,1939
10,362,428,267,1057,1939
11,382,418,286,1086,1939
1,500,200,50,750,1940
2,459,216,108,783,1940
3,442,241,141,824,1940
4,414,281,168,863,1940
5,429,299,180,908,1940
6,422,321,199,942,1940
7,404,351,224,979,1940
8,405,368,243,1016,1940
9,396,373,256,1025,1940
10,410,386,252,1048,1940
11,425,420,258,1103,1940
1,500,200,50,750,1941
2,461,227,94,782,1941
3,436,259,132,827,1941
4,428,281,187,896,1941
5,420,284,213,917,1941
6,405,330,229,964,1941
7,395,347,235,977,1941
8,396,368,244,1008,1941
9,389,379,269,1037,1941
10,411,394,259,1064,1941
11,402,400,270,1072,1941
1,500,200,50,750,1942
2,450,246,92,788,1942
3,417,261,149,827,1942
4,408,281,170,859,1942
5,426,300,186,912,1942
6,413,310,214,937,1942
7,436,344,212,992,1942
8,416,360,232,1008,1942
9,421,367,252,1040,1942
10,407,382,244,1033,1942
11,404,395,267,1066,1942
1,500,200,50,750,1943
2,452,225,106,783,1943
3,445,252,139,836,1943
4,441,273,160,874,1943
5,427,302,176,905,1943
6,432,317,216,965,1943
7,415,333,236,984,1943
8,411,335,271,1017,1943
9,411,352,270,1033,1943
10,397,374,276,1047,1943
11,401,399,275,1075,1943
1,500,200,50,750,1944
2,460,234,91,785,1944
3,417,285,119,821,1944
4,412,284,172,868,1944
5,380,338,196,914,1944
6,378,341,224,943,1944
7,386,363,236,985,1944
8,364,387,254,1005,1944
9,373,394,277,1044,1944
10,362,399,298,1059,1944
11,395,397,288,1080,1944
1,500,200,50,750,1945
2,458,236,106,800,1945
3,443,249,142,834,1945
4,431,282,159,872,1945
5,419,306,189,914,1945
6,411,334,207,952,1945
7,402,351,224,977,1945
8,409,357,227,993,1945
9,424,391,231,1046,1945
10,406,389,254,1049,1945
11,412,407,268,1087,1945
1,500,200,50,750,1946
2,463,218,98,779,1946
3,428,255,146,829,1946
4,420,298,157,875,1946
5,426,311,185,922,1946
6,412,323,215,950,1946
7,403,346,238,987,1946
8,402,376,234,1012,1946
9,385,394,239,1018,1946
10,417,413,247,1077,1946
11,399,408,268,1075,1946
1,500,200,50,750,1947
2,470,228,91,789,1947
3,446,262,113,821,1947
4,451,271,142,864,1947
5,446,300,160,906,1947
6,443,329,199,971,1947
7,409,367,204,980,1947
8,408,366,221,995,1947
9,435,361,235,1031,1947
10,430,382,258,1070,1947
11,413,400,264,1077,1947
1,500,200,50,750,1948
2,458,237,97,792,1948
3,427,274,129,830,1948
4,405,289,173,867,1948
5,398,309,188,895,1948
6,427,333,210,970,1948
7,399,354,232,985,1948
8,393,362,252,1007,1948
9,403,376,255,1034,1948
10,404,399,260,1063,1948
11,420,420,250,1090,1948
1,500,200,50,750,1949
2,466,239,97,802,1949
3,439,240,141,820,1949
4,433,289,161,883,1949
5,409,299,180,888,1949
6,423,332,180,935,1949
7,428,348,213,989,1949
8,408,334,256,998,1949
9,387,377,268,1032,1949
10,376,398,275,1049,1949
11,362,414,293,1069,1949
1,500,200,50,750,1950
2,446,214,122,782,1950
3,410,247,153,810,1950
4,399,296,172,867,1950
5,388,317,213,918,1950
6,407,331,221,959,1950
7,376,353,244,973,1950
8,394,361,248,1003,1950
9,376,404,253,1033,1950
10,394,400,262,1056,1950
11,395,419,269,1083,1950
1,500,200,50,750,1951
2,452,217,116,785,1951
3,419,242,150,811,1951
4,420,292,164,876,1951
5,386,339,178,903,1951
6,398,377,190,965,1951
7,388,367,231,986,1951
8,380,388,239,1007,1951
9,395,388,263,1046,1951
10,373,399,265,1037,1951
11,389,403,297,1089,1951
1,500,200,50,750,1952
2,474,226,85,785,1952
3,447,249,138,834,1952
4,407,264,192,863,1952
5,391,320,215,926,1952
6,399,329,221,949,1952
7,393,352,234,979,1952
8,395,355,250,1000,1952
9,393,392,241,1026,1952
10,401,403,263,1067,1952
11,394,408,280,1082,1952
1,500,200,50,750,1953
2,446,238,102,786,1953
3,408,274,139,821,1953
4,412,309,155,876,1953
5,402,332,189,923,1953
6,405,313,225,943,1953
7,392,354,233,979,1953
8,382,361,264,1007,1953
9,380,394,267,1041,1953
10,373,395,269,1037,1953
11,372,426,279,1077,1953
1,500,200,50,750,1954
2,484,230,89,803,1954
3,433,258,131,822,1954
4,417,297,162,876,1954
5,404,314,188,906,1954
6,384,325,228,937,1954
7,371,354,236,961,1954
8,382,388,245,1015,1954
9,365,377,284,1026,1954
10,379,401,285,1065,1954
11,398,407,275,1080,1954
1,500,200,50,750,1955
2,456,227,111,794,1955
3,432,256,149,837,1955
4,403,318,164,885,1955
5,387,322,200,909,1955
6,407,358,201,966,1955
7,394,358,232,984,1955
8,401,364,250,1015,1955
9,372,389,267,1028,1955
10,387,408,269,1064,1955
11,384,412,284,1080,1955
1,500,200,50,750,1956
2,442,231,100,773,1956
3,427,276,123,826,1956
4,416,298,157,871,1956
5,414,323,181,918,1956
6,406,338,199,943,1956
7,410,352,228,990,1956
8,398,359,240,997,1956
9,387,391,250,1028,1956
10,396,411,247,1054,1956
11,368,435,260,1063,1956
1,500,200,50,750,1957
2,450,220,111,781,1957
3,438,250,156,844,1957
4,415,275,177,867,1957
5,401,321,186,908,1957
6,388,336,222,946,1957
7,391,342,248,981,1957
8,398,364,259,1021,1957
9,401,373,264,1038,1957
10,394,393,262,1049,1957
11,391,409,272,1072,1957
1,500,200,50,750,1958
2,462,221,103,786,1958
3,436,246,136,818,1958
4,433,267,158,858,1958
5,412,298,200,910,1958
6,425,317,221,963,1958
7,393,355,238,986,1958
8,405,355,241,1001,1958
9,407,375,265,1047,1958
10,424,394,255,1073,1958
11,426,396,266,1088,1958
1,500,200,50,750,1959
2,458,216,101,775,1959
3,444,257,123,824,1959
4,443,274,157,874,1959
5,429,302,185,916,1959
6,426,338,202,966,1959
7,424,357,217,998,1959
8,413,364,235,1012,1959
9,395,406,239,1040,1959
10,403,392,263,1058,1959
11,388,393,283,1064,1959
1,500,200,50,750,1960
2,449,236,90,775,1960
3,436,256,137,829,1960
4,412,276,171,859,1960
5,413,305,186,904,1960
6,398,345,212,955,1960
7,408,333,238,979,1960
8,398,336,259,993,1960
9,407,361,262,1030,1960
10,399,397,265,1061,1960
11,398,408,265,1071,1960
1,500,200,50,750,1961
2,471,239,90,800,1961
3,414,282,135,831,1961
4,391,309,161,861,1961
5,394,314,204,912,1961
6,399,340,214,953,1961
7,421,347,217,985,1961
8,421,345,243,1009,1961
9,409,378,248,1035,1961
10,399,387,272,1058,1961
11,399,404,287,1090,1961
1,500,200,50,750,1962
2,469,225,113,807,1962
3,419,268,149,836,1962
4,420,278,163,861,1962
5,411,323,176,910,1962
6,398,341,217,956,1962
7,401,339,240,980,1962
8,408,371,241,1020,1962
9,396,375,253,1024,1962
10,393,411,254,1058,1962
11,400,417,267,1084,1962
1,500,200,50,750,1963
2,456,246,94,796,1963
3,401,274,145,820,1963
4,387,297,180,864,1963
5,402,308,213,923,1963
6,416,321,226,963,1963
7,413,327,240,980,1963
8,401,349,256,1006,1963
9,393,368,264,1025,1963
10,373,405,270,1048,1963
11,388,406,289,1083,1963
1,500,200,50,750,1964
2,467,231,90,788,1964
3,442,247,139,828,1964
4,418,290,157,865,1964
5,388,313,201,902,1964
6,377,343,229,949,1964
7,386,355,243,984,1964
8,407,383,238,1028,1964
9,390,401,253,1044,1964
10,381,409,271,1061,1964
11,389,420,278,1087,1964
1,500,200,50,750,1965
2,455,236,102,793,1965
3,425,265,143,833,1965
4,421,277,172,870,1965
5,406,329,194,929,1965
6,393,367,196,956,1965
7,395,370,221,986,1965
8,398,369,245,1012,1965
9,397,378,250,1025,1965
10,418,368,268,1054,1965
11,438,407,263,1108,1965
1,500,200,50,750,1966
2,459,225,102,786,1966
3,441,266,135,842,1966
4,415,292,158,865,1966
5,394,324,193,911,1966
6,414,358,203,975,1966
7,412,355,221,988,1966
8,402,367,237,1006,1966
9,391,391,250,1032,1966
10,399,378,277,1054,1966
11,401,415,277,1093,1966
1,500,200,50,750,1967
2,462,221,100,783,1967
3,442,242,138,822,1967
4,413,267,181,861,1967
5,415,291,190,896,1967
6,424,326,231,981,1967
7,411,338,231,980,1967
8,406,343,253,1002,1967
9,415,357,267,1039,1967
10,421,371,272,1064,1967
11,411,392,269,1072,1967
1,500,200,50,750,1968
2,443,237,107,787,1968
3,406,267,148,821,1968
4,408,279,187,874,1968
5,415,300,201,916,1968
6,407,333,216,956,1968
7,420,327,241,988,1968
8,425,354,246,1025,1968
9,427,356,241,1024,1968
10,432,376,246,1054,1968
11,441,410,233,1084,1968
1,500,200,50,750,1969
2,456,233,92,781,1969
3,407,254,144,805,1969
4,409,296,160,865,1969
5,399,336,179,914,1969
6,373,353,224,950,1969
7,392,368,226,986,1969
8,383,411,226,1020,1969
9,401,414,230,1045,1969
10,382,427,253,1062,1969
11,396,427,267,1090,1969
1,500,200,50,750,1970
2,446,230,99,775,1970
3,424,253,137,814,1970
4,424,277,158,859,1970
5,440,286,180,906,1970
6,448,313,200,961,1970
7,422,336,209,967,1970
8,405,360,239,1004,1970
9,410,370,248,1028,1970
10,417,375,264,1056,1970
11,413,389,283,1085,1970
1,500,200,50,750,1971
2,491,234,83,808,1971
3,428,274,127,829,1971
4,416,291,153,860,1971
5,397,319,195,911,1971
6,440,324,219,983,1971
7,414,347,232,993,1971
8,394,343,254,991,1971
9,418,370,239,1027,1971
10,422,378,246,1046,1971
11,431,391,271,1093,1971
1,500,200,50,750,1972
2,457,239,91,787,1972
3,439,243,149,831,1972
4,416,282,166,864,1972
5,409,321,181,911,1972
6,390,351,204,945,1972
7,410,357,223,990,1972
8,375,381,243,999,1972
9,387,408,232,1027,1972
10,385,418,249,1052,1972
11,403,412,280,1095,1972
1,500,200,50,750,1973
2,462,234,101,797,1973
3,426,274,126,826,1973
4,430,283,157,870,1973
5,425,327,162,914,1973
6,422,359,186,967,1973
7,390,366,220,976,1973
8,391,366,246,1003,1973
9,408,399,239,1046,1973
10,405,394,258,1057,1973
11,402,387,283,1072,1973
1,500,200,50,750,1974
2,452,223,116,791,1974
3,434,259,146,839,1974
4,400,273,178,851,1974
5,414,317,186,917,1974
6,424,328,215,967,1974
7,392,350,241,983,1974
8,385,368,239,992,1974
9,414,377,251,1042,1974
10,408,400,254,1062,1974
11,411,421,268,1100,1974
1,500,200,50,750,1975
2,458,212,109,779,1975
3,432,251,139,822,1975
4,411,272,163,846,1975
5,432,291,200,923,1975
6,445,303,209,957,1975
7,433,323,224,980,1975
8,428,340,235,1003,1975
9,420,351,255,1026,1975
10,407,380,270,1057,1975
11,411,410,270,1091,1975
1,500,200,50,750,1976
2,459,224,100,783,1976
3,431,242,143,816,1976
4,420,277,168,865,1976
5,380,316,191,887,1976
6,412,340,212,964,1976
7,395,366,230,991,1976
8,381,358,261,1000,1976
9,384,383,257,1024,1976
10,402,389,277,1068,1976
11,401,413,271,1085,1976
1,500,200,50,750,1977
2,449,231,97,777,1977
3,459,264,124,847,1977
4,431,293,141,865,1977
5,409,308,194,911,1977
6,413,325,214,952,1977
7,409,350,230,989,1977
8,400,337,263,1000,1977
9,395,355,271,1021,1977
10,422,359,283,1064,1977
11,412,393,280,1085,1977
1,500,200,50,750,1978
2,460,223,93,776,1978
3,433,273,122,828,1978
4,417,289,164,870,1978
5,413,292,200,905,1978
6,397,346,210,953,1978
7,408,358,227,993,1978
8,405,373,214,992,1978
9,417,388,239,1044,1978
10,393,393,249,1035,1978
11,409,411,262,1082,1978
1,500,200,50,750,1979
2,457,234,100,791,1979
3,414,268,141,823,1979
4,411,282,173,866,1979
5,399,305,204,908,1979
6,405,331,228,964,1979
7,388,353,235,976,1979
8,362,403,260,1025,1979
9,332,405,287,1024,1979
10,358,438,270,1066,1979
11,365,426,280,1071,1979
1,500,200,50,750,1980
2,450,252,84,786,1980
3,443,267,120,830,1980
4,423,282,160,865,1980
5,425,289,186,900,1980
6,417,337,191,945,1980
7,406,357,217,980,1980
8,379,367,244,990,1980
9,411,364,269,1044,1980
10,417,354,290,1061,1980
11,428,379,281,1088,1980
1,500,200,50,750,1981
2,467,229,96,792,1981
3,448,254,127,829,1981
4,438,293,150,881,1981
5,417,313,169,899,1981
6,416,332,210,958,1981
7,401,339,239,979,1981
8,397,357,249,1003,1981
9,407,360,264,1031,1981
10,372,391,271,1034,1981
11,395,415,270,1080,1981
1,500,200,50,750,1982
2,461,223,95,779,1982
3,441,252,128,821,1982
4,430,290,155,875,1982
5,411,324,182,917,1982
6,418,328,214,960,1982
7,416,360,208,984,1982
8,389,343,242,974,1982
9,394,361,279,1034,1982
10,390,400,277,1067,1982
11,392,448,260,1100,1982
1,500,200,50,750,1983
2,458,250,89,797,1983
3,430,260,137,827,1983
4,404,295,165,864,1983
5,404,318,186,908,1983
6,396,357,192,945,1983
7,389,375,221,985,1983
8,409,376,235,1020,1983
9,382,404,258,1044,1983
10,364,405,282,1051,1983
11,386,387,314,1087,1983
1,500,200,50,750,1984
2,456,234,106,796,1984
3,432,263,135,830,1984
4,399,296,163,858,1984
5,401,310,200,911,1984
6,424,338,201,963,1984
7,415,355,222,992,1984
8,406,351,247,1004,1984
9,411,370,253,1034,1984
10,428,378,252,1058,1984
11,449,401,255,1105,1984
1,500,200,50,750,1985
2,465,241,87,793,1985
3,421,281,124,826,1985
4,424,304,144,872,1985
5,408,330,176,914,1985
6,415,334,208,957,1985
7,384,338,241,963,1985
8,390,367,255,1012,1985
9,396,375,254,1025,1985
10,417,406,256,1079,1985
11,393,425,265,1083,1985
1,500,200,50,750,1986
2,462,236,92,790,1986
3,439,252,129,820,1986
4,423,287,155,865,1986
5,404,300,207,911,1986
6,390,342,220,952,1986
7,380,378,235,993,1986
8,361,389,251,1001,1986
9,392,402,243,1037,1986
10,391,419,256,1066,1986
11,405,419,280,1104,1986
1,500,200,50,750,1987
2,455,233,89,777,1987
3,429,284,119,832,1987
4,423,294,157,874,1987
5,417,329,171,917,1987
6,416,367,193,976,1987
7,396,362,229,987,1987
8,393,371,244,1008,1987
9,379,392,247,1018,1987
10,378,426,263,1067,1987
11,374,449,267,1090,1987
1,500,200,50,750,1988
2,476,238,84,798,1988
3,431,270,125,826,1988
4,417,289,157,863,1988
5,409,314,176,899,1988
6,438,333,205,976,1988
7,435,337,215,987,1988
8,423,372,222,1017,1988
9,435,400,208,1043,1988
10,422,387,262,1071,1988
11,417,403,276,1096,1988
1,500,200,50,750,1989
2,439,247,98,784,1989
3,414,263,149,826,1989
4,396,297,169,862,1989
5,394,333,182,909,1989
6,413,345,205,963,1989
7,403,365,212,980,1989
8,412,385,224,1021,1989
9,401,402,245,1048,1989
10,384,401,253,1038,1989
11,424,435,258,1117,1989
1,500,200,50,750,1990
2,452,233,111,796,1990
3,419,256,149,824,1990
4,399,298,170,867,1990
5,384,337,192,913,1990
6,370,337,235,942,1990
7,392,355,259,1006,1990
8,374,393,248,1015,1990
9,372,401,256,1029,1990
10,373,395,276,1044,1990
11,394,414,287,1095,1990
1,500,200,50,750,1991
2,443,234,99,776,1991
3,450,253,137,840,1991
4,425,289,166,880,1991
5,430,306,182,918,1991
6,432,325,218,975,1991
7,395,353,235,983,1991
8,391,370,231,992,1991
9,404,403,236,1043,1991
10,363,428,263,1054,1991
11,353,442,279,1074,1991
1,500,200,50,750,1992
2,458,225,103,786,1992
3,436,243,147,826,1992
4,430,279,160,869,1992
5,416,324,155,895,1992
6,425,348,188,961,1992
7,416,347,222,985,1992
8,398,362,246,1006,1992
9,389,372,267,1028,1992
10,385,361,293,1039,1992
11,393,404,306,1103,1992
1,500,200,50,750,1993
2,449,239,100,788,1993
3,416,272,136,824,1993
4,395,304,176,875,1993
5,387,337,187,911,1993
6,382,365,210,957,1993
7,373,353,239,965,1993
8,375,373,243,991,1993
9,373,390,258,1021,1993
10,362,401,282,1045,1993
11,390,410,281,1081,1993
1,500,200,50,750,1994
2,476,220,95,791,1994
3,440,263,131,834,1994
4,415,291,160,866,1994
5,394,329,177,900,1994
6,413,344,210,967,1994
7,407,351,223,981,1994
8,410,359,240,1009,1994
9,430,383,238,1051,1994
10,406,380,261,1047,1994
11,371,417,291,1079,1994
1,500,200,50,750,1995
2,465,235,96,796,1995
3,415,263,135,813,1995
4,395,269,182,846,1995
5,425,296,200,921,1995
6,417,321,219,957,1995
7,396,345,229,970,1995
8,400,386,234,1020,1995
9,398,384,243,1025,1995
10,399,396,259,1054,1995
11,422,399,261,1082,1995
1,500,200,50,750,1996
2,450,243,99,792,1996
3,420,270,147,837,1996
4,387,302,176,865,1996
5,399,315,195,909,1996
6,381,361,221,963,1996
7,361,383,237,981,1996
8,367,378,258,1003,1996
9,363,380,293,1036,1996
10,375,413,266,1054,1996
11,372,448,259,1079,1996
1,500,200,50,750,1997
2,474,239,80,793,1997
3,448,240,136,824,1997
4,436,268,164,868,1997
5,426,308,175,909,1997
6,404,343,212,959,1997
7,408,373,214,995,1997
8,393,367,252,1012,1997
9,385,398,254,1037,1997
10,370,412,263,1045,1997
11,393,426,277,1096,1997
1,500,200,50,750,1998
2,472,215,105,792,1998
3,463,238,152,853,1998
4,417,285,163,865,1998
5,424,310,183,917,1998
6,419,328,213,960,1998
7,411,362,212,985,1998
8,396,382,237,1015,1998
9,395,381,258,1034,1998
10,376,412,267,1055,1998
11,364,436,274,1074,1998
1,500,200,50,750,1999
2,453,233,95,781,1999
3,450,235,147,832,1999
4,438,282,166,886,1999
5,432,290,185,907,1999
6,434,333,197,964,1999
7,395,342,222,959,1999
8,404,358,257,1019,1999
9,375,382,269,1026,1999
10,407,390,285,1082,1999
11,421,404,273,1098,1999
1,500,200,50,750,2000
2,477,244,83,804,2000
3,426,276,128,830,2000
4,422,280,164,866,2000
5,416,310,189,915,2000
6,416,329,218,963,2000
7,406,352,224,982,2000
8,419,352,237,1008,2000
9,394,380,252,1026,2000
10,399,386,259,1044,2000
11,430,420,253,1103,2000
1,500,200,50,750,2001
2,463,224,104,791,2001
3,440,264,125,829,2001
4,429,289,149,867,2001
5,412,319,177,908,2001
6,416,342,192,950,2001
7,424,370,208,1002,2001
8,403,394,214,1011,2001
9,395,400,242,1037,2001
10,416,392,265,1073,2001
11,409,375,294,1078,2001
1,500,200,50,750,2002
2,435,256,108,799,2002
3,425,259,137,821,2002
4,426,270,159,855,2002
5,415,319,174,908,2002
6,411,336,211,958,2002
7,397,353,222,972,2002
8,391,350,251,992,2002
9,418,370,255,1043,2002
10,412,372,276,1060,2002
11,411,405,271,1087,2002
1,500,200,50,750,2003
2,462,228,99,789,2003
3,448,252,131,831,2003
4,408,282,165,855,2003
5,399,324,182,905,2003
6,401,342,216,959,2003
7,378,343,251,972,2003
8,408,357,254,1019,2003
9,399,396,246,1041,2003
10,393,378,291,1062,2003
11,392,386,300,1078,2003
1,500,200,50,750,2004
2,462,239,100,801,2004
3,418,257,135,810,2004
4,416,279,158,853,2004
5,434,327,174,935,2004
6,407,321,217,945,2004
7,409,341,234,984,2004
8,410,354,253,1017,2004
9,412,354,276,1042,2004
10,415,397,247,1059,2004
11,402,408,257,1067,2004
1,500,200,50,750,2005
2,464,224,105,793,2005
3,436,268,128,832,2005
4,417,298,153,868,2005
5,395,318,199,912,2005
6,415,338,216,969,2005
7,396,342,229,967,2005
8,380,368,252,1000,2005
9,387,381,270,1038,2005
10,378,404,274,1056,2005
11,375,439,265,1079,2005
1,500,200,50,750,2006
2,453,228,106,787,2006
3,443,243,153,839,2006
4,414,280,172,866,2006
5,422,317,186,925,2006
6,407,347,200,954,2006
7,421,342,228,991,2006
8,407,350,246,1003,2006
9,420,360,263,1043,2006
10,427,369,258,1054,2006
11,436,409,246,1091,2006
1,500,200,50,750,2007
2,461,233,96,790,2007
3,413,267,148,828,2007
4,397,291,180,868,2007
5,384,337,193,914,2007
6,395,359,207,961,2007
7,391,359,235,985,2007
8,391,388,233,1012,2007
9,399,387,247,1033,2007
10,395,385,270,1050,2007
11,396,415,267,1078,2007
1,500,200,50,750,2008
2,453,231,100,784,2008
3,424,260,142,826,2008
4,408,310,162,880,2008
5,410,308,185,903,2008
6,409,331,209,949,2008
7,399,355,230,984,2008
8,394,391,219,1004,2008
9,392,401,244,1037,2008
10,379,415,263,1057,2008
11,389,424,272,1085,2008
1,500,200,50,750,2009
2,461,216,118,795,2009
3,426,263,137,826,2009
4,416,282,165,863,2009
5,411,312,180,903,2009
6,414,349,197,960,2009
7,397,370,215,982,2009
8,386,374,255,1015,2009
9,378,405,261,1044,2009
10,361,405,279,1045,2009
11,403,398,298,1099,2009
1,500,200,50,750,2010
2,456,239,92,787,2010
3,433,262,124,819,2010
4,409,300,162,871,2010
5,405,303,195,903,2010
6,428,341,213,982,2010
7,426,343,219,988,2010
8,417,386,204,1007,2010
9,418,389,224,1031,2010
10,411,389,243,1043,2010
11,427,402,251,1080,2010
1,500,200,50,750,2011
2,474,229,79,782,2011
3,474,252,117,843,2011
4,448,274,140,862,2011
5,452,290,176,918,2011
6,441,321,207,969,2011
7,421,346,216,983,2011
8,414,354,245,1013,2011
9,402,386,254,1042,2011
10,397,400,265,1062,2011
11,395,412,282,1089,2011
1,500,200,50,750,2012
2,458,235,95,788,2012
3,445,257,134,836,2012
4,413,284,158,855,2012
5,433,315,190,938,2012
6,415,321,224,960,2012
7,418,315,261,994,2012
8,420,363,250,1033,2012
9,405,365,258,1028,2012
10,380,360,300,1040,2012
11,393,382,298,1073,2012
1,500,200,50,750,2013
2,477,235,85,797,2013
3,428,264,132,824,2013
4,401,292,170,863,2013
5,419,327,183,929,2013
6,386,336,217,939,2013
7,367,389,219,975,2013
8,361,407,241,1009,2013
9,358,405,253,1016,2013
10,378,401,260,1039,2013
11,422,401,268,1091,2013
1,500,200,50,750,2014
2,441,253,95,789,2014
3,433,262,134,829,2014
4,416,278,171,865,2014
5,431,274,203,908,2014
6,442,318,210,970,2014
7,421,327,233,981,2014
8,408,366,228,1002,2014
9,410,355,272,1037,2014
10,403,391,270,1064,2014
11,435,379,289,1103,2014
1,500,200,50,750,2015
2,455,232,94,781,2015
3,445,264,127,836,2015
4,410,284,169,863,2015
5,402,318,196,916,2015
6,416,329,214,959,2015
7,404,340,226,970,2015
8,381,350,251,982,2015
9,387,364,261,1012,2015
10,388,387,271,1046,2015
11,403,404,278,1085,2015
1,500,200,50,750,2016
2,475,224,97,796,2016
3,449,238,133,820,2016
4,423,269,173,865,2016
5,404,305,202,911,2016
6,410,341,217,968,2016
7,410,334,241,985,2016
8,390,369,243,1002,2016
9,382,385,262,1029,2016
10,406,400,267,1073,2016
11,380,430,265,1075,2016
1,500,200,50,750,2017
2,458,242,94,794,2017
3,443,253,134,830,2017
4,420,279,173,872,2017
5,414,325,193,932,2017
6,412,348,205,965,2017
7,401,351,225,977,2017
8,429,345,243,1017,2017
9,427,349,255,1031,2017
10,415,368,279,1062,2017
11,397,395,277,1069,2017
1,500,200,50,750,2018
2,453,225,100,778,2018
3,405,259,141,805,2018
4,413,277,187,877,2018
5,394,295,205,894,2018
6,395,347,221,963,2018
7,366,390,231,987,2018
8,375,397,241,1013,2018
9,392,401,253,1046,2018
10,370,404,272,1046,2018
11,389,412,279,1080,2018
1,500,200,50,750,2019
2,462,223,99,784,2019
3,431,267,126,824,2019
4,426,281,160,867,2019
5,396,314,189,899,2019
6,404,340,211,955,2019
7,396,343,236,975,2019
8,396,367,248,1011,2019
9,397,370,263,1030,2019
10,398,393,260,1051,2019
11,403,399,287,1089,2019
1,500,200,50,750,2020
2,460,225,104,789,2020
3,432,242,137,811,2020
4,428,282,170,880,2020
5,412,324,182,918,2020
6,408,354,208,970,2020
7,396,366,213,975,2020
8,378,364,259,1001,2020
9,387,391,265,1043,2020
10,381,389,290,1060,2020
11,382,420,292,1094,2020
1,500,200,50,750,2021
2,461,224,101,786,2021
3,426,266,138,830,2021
4,410,293,166,869,2021
5,411,318,184,913,2021
6,429,324,202,955,2021
7,411,331,229,971,2021
8,390,374,236,1000,2021
9,396,373,267,1036,2021
10,394,383,279,1056,2021
11,385,400,303,1088,2021
1,500,200,50,750,2022
2,445,223,94,762,2022
3,429,245,146,820,2022
4,433,282,172,887,2022
5,399,305,199,903,2022
6,383,364,207,954,2022
7,405,368,219,992,2022
8,403,389,227,1019,2022
9,374,410,249,1033,2022
10,370,413,283,1066,2022
11,375,436,279,1090,2022
1,500,200,50,750,2023
2,442,237,108,787,2023
3,414,251,155,820,2023
4,408,283,189,880,2023
5,400,301,206,907,2023
6,396,338,229,963,2023
7,378,361,244,983,2023
8,381,388,252,1021,2023
9,377,386,262,1025,2023
10,411,401,256,1068,2023
11,387,435,259,1081,2023
1,500,200,50,750,2024
2,457,223,108,788,2024
3,438,246,149,833,2024
4,411,286,156,853,2024
5,437,302,184,923,2024
6,438,325,201,964,2024
7,452,327,216,995,2024
8,433,349,238,1020,2024
9,438,343,257,1038,2024
10,444,358,254,1056,2024
11,447,374,259,1080,2024
1,500,200,50,750,2025
2,457,214,114,785,2025
3,418,230,160,808,2025
4,401,275,179,855,2025
5,402,303,189,894,2025
6,420,320,206,946,2025
7,418,356,215,989,2025
8,410,370,231,1011,2025
9,381,364,280,1025,2025
10,407,382,258,1047,2025
11,390,380,293,1063,2025
1,500,200,50,750,2026
2,468,226,89,783,2026
3,436,256,123,815,2026
4,401,290,156,847,2026
5,393,307,205,905,2026
6,401,325,231,957,2026
7,393,333,249,975,2026
8,398,347,261,1006,2026
9,390,365,274,1029,2026
10,376,394,267,1037,2026
11,412,387,292,1091,2026
1,500,200,50,750,2027
2,465,223,103,791,2027
3,439,263,134,836,2027
4,412,295,168,875,2027
5,419,327,175,921,2027
6,427,337,194,958,2027
7,421,359,205,985,2027
8,413,389,216,1018,2027
9,398,401,238,1037,2027
10,424,397,243,1064,2027
11,416,373,273,1062,2027
1,500,200,50,750,2028
2,477,225,93,795,2028
3,433,246,144,823,2028
4,412,282,169,863,2028
5,395,300,197,892,2028
6,394,332,236,962,2028
7,377,347,246,970,2028
8,385,351,263,999,2028
9,380,375,276,1031,2028
10,367,381,294,1042,2028
11,401,380,304,1085,2028
1,500,200,50,750,2029
2,452,224,100,776,2029
3,433,243,150,826,2029
4,425,266,183,874,2029
5,417,292,200,909,2029
6,425,327,221,973,2029
7,399,345,245,989,2029
8,390,364,254,1008,2029
9,391,381,266,1038,2029
10,396,397,272,1065,2029
11,413,396,291,1100,2029
1,500,200,50,750,2030
2,442,244,98,784,2030
3,413,284,130,827,2030
4,399,316,155,870,2030
5,404,328,178,910,2030
6,395,362,197,954,2030
7,402,376,221,999,2030
8,402,366,247,1015,2030
9,396,393,248,1037,2030
10,387,414,262,1063,2030
11,373,421,260,1054,2030
1,500,200,50,750,2031
2,461,235,91,787,2031
3,443,262,121,826,2031
4,402,300,151,853,2031
5,394,325,189,908,2031
6,389,365,215,969,2031
7,366,361,254,981,2031
8,386,393,254,1033,2031
9,370,399,258,1027,2031
10,378,404,283,1065,2031
11,381,409,288,1078,2031
1,500,200,50,750,2032
2,470,236,92,798,2032
3,458,269,116,843,2032
4,419,287,164,870,2032
5,425,299,195,919,2032
6,394,340,225,959,2032
7,382,367,233,982,2032
8,392,370,249,1011,2032
9,381,356,276,1013,2032
10,412,387,271,1070,2032
11,410,401,274,1085,2032
1,500,200,50,750,2033
2,470,225,89,784,2033
3,440,236,140,816,2033
4,436,290,155,881,2033
5,385,313,197,895,2033
6,389,329,218,936,2033
7,396,342,245,983,2033
8,387,364,241,992,2033
9,410,383,244,1037,2033
10,398,390,256,1044,2033
11,420,421,257,1098,2033
1,500,200,50,750,2034
2,474,225,99,798,2034
3,448,257,127,832,2034
4,418,272,169,859,2034
5,420,300,182,902,2034
6,422,320,215,957,2034
7,394,347,233,974,2034
8,403,369,258,1030,2034
9,388,376,261,1025,2034
10,396,393,269,1058,2034
11,419,397,269,1085,2034
1,500,200,50,750,2035
2,461,238,93,792,2035
3,425,252,152,829,2035
4,413,287,161,861,2035
5,411,316,188,915,2035
6,405,346,223,974,2035
7,392,353,228,973,2035
8,402,373,226,1001,2035
9,391,396,228,1015,2035
10,409,397,252,1058,2035
11,400,433,256,1089,2035
1,500,200,50,750,2036
2,473,226,94,793,2036
3,437,258,134,829,2036
4,433,292,135,860,2036
5,416,319,174,909,2036
6,415,329,213,957,2036
7,406,345,227,978,2036
8,404,368,237,1009,2036
9,396,363,268,1027,2036
10,404,384,274,1062,2036
11,416,383,288,1087,2036
1,500,200,50,750,2037
2,475,237,88,800,2037
3,448,243,137,828,2037
4,441,280,165,886,2037
5,420,295,196,911,2037
6,427,326,207,960,2037
7,404,344,224,972,2037
8,390,364,251,1005,2037
9,406,354,273,1033,2037
10,416,369,267,1052,2037
11,424,371,274,1069,2037
1,500,200,50,750,2038
2,462,214,108,784,2038
3,452,243,143,838,2038
4,419,272,170,861,2038
5,429,304,180,913,2038
6,418,342,203,963,2038
7,384,375,207,966,2038
8,397,384,216,997,2038
9,410,397,234,1041,2038
10,400,397,256,1053,2038
11,416,416,256,1088,2038
1,500,200,50,750,2039
2,442,240,94,776,2039
3,420,265,144,829,2039
4,427,302,158,887,2039
5,410,315,187,912,2039
6,411,359,205,975,2039
7,403,368,213,984,2039
8,391,378,230,999,2039
9,420,379,243,1042,2039
10,407,396,257,1060,2039
11,403,398,268,1069,2039
1,500,200,50,750,2040
2,467,227,91,785,2040
3,440,264,133,837,2040
4,411,307,161,879,2040
5,398,342,187,927,2040
6,392,367,210,969,2040
7,373,385,218,976,2040
8,382,400,240,1022,2040
9,379,407,242,1028,2040
10,359,431,265,1055,2040
11,370,422,285,1077,2040
1,500,200,50,750,2041
2,481,250,72,803,2041
3,448,269,113,830,2041
4,425,299,136,860,2041
5,413,331,172,916,2041
6,414,357,191,962,2041
7,388,364,217,969,2041
8,398,369,239,1006,2041
9,406,359,261,1026,2041
10,422,382,248,1052,2041
11,439,407,232,1078,2041
1,500,200,50,750,2042
2,465,229,94,788,2042
3,428,262,134,824,2042
4,422,285,157,864,2042
5,399,301,202,902,2042
6,412,327,211,950,2042
7,414,347,216,977,2042
8,412,364,239,1015,2042
9,386,379,266,1031,2042
10,420,378,263,1061,2042
11,434,385,274,1093,2042
1,500,200,50,750,2043
2,433,245,90,768,2043
3,425,290,125,840,2043
4,387,318,167,872,2043
5,386,337,189,912,2043
6,402,351,201,954,2043
7,383,372,224,979,2043
8,396,380,234,1010,2043
9,366,414,247,1027,2043
10,382,413,265,1060,2043
11,379,389,290,1058,2043
1,500,200,50,750,2044
2,446,241,93,780,2044
3,456,266,122,844,2044
4,417,306,150,873,2044
5,430,327,166,923,2044
6,411,340,211,962,2044
7,404,358,227,989,2044
8,396,378,231,1005,2044
9,366,397,235,998,2044
10,390,416,249,1055,2044
11,400,408,269,1077,2044
1,500,200,50,750,2045
2,442,229,109,780,2045
3,405,272,134,811,2045
4,419,287,152,858,2045
5,416,343,164,923,2045
6,420,362,186,968,2045
7,400,375,218,993,2045
8,394,373,248,1015,2045
9,400,382,254,1036,2045
10,394,378,272,1044,2045
11,395,391,280,1066,2045
1,500,200,50,750,2046
2,440,229,112,781,2046
3,430,258,139,827,2046
4,408,270,182,860,2046
5,420,286,217,923,2046
6,413,316,228,957,2046
7,388,346,232,966,2046
8,378,376,247,1001,2046
9,413,380,250,1043,2046
10,420,397,255,1072,2046
11,412,416,265,1093,2046
1,500,200,50,750,2047
2,473,235,90,798,2047
3,440,262,125,827,2047
4,421,275,156,852,2047
5,431,307,188,926,2047
6,418,323,205,946,2047
7,421,336,217,974,2047
8,423,354,237,1014,2047
9,407,355,263,1025,2047
10,406,375,273,1054,2047
11,412,402,267,1081,2047
1,500,200,50,750,2048
2,450,232,103,785,2048
3,432,279,128,839,2048
4,400,317,152,869,2048
5,406,322,177,905,2048
6,389,361,196,946,2048
7,397,377,208,982,2048
8,388,359,248,995,2048
9,374,385,259,1018,2048
10,380,390,276,1046,2048
11,402,393,283,1078,2048
1,500,200,50,750,2049
2,454,232,97,783,2049
3,428,257,149,834,2049
4,393,290,176,859,2049
5,396,326,194,916,2049
6,408,334,214,956,2049
7,402,359,212,973,2049
8,394,385,232,1011,2049
9,389,386,247,1022,2049
10,394,402,262,1058,2049
11,394,433,259,1086,2049
1,500,200,50,750,2050
2,471,225,93,789,2050
3,424,260,146,830,2050
4,410,273,167,850,2050
5,420,303,191,914,2050
6,409,325,209,943,2050
7,423,355,222,1000,2050
8,397,365,239,1001,2050
9,402,362,264,1028,2050
10,411,376,265,1052,2050
11,381,431,248,1060,2050
1,500,200,50,750,2051
2,443,229,101,773,2051
3,441,264,134,839,2051
4,407,303,154,864,2051
5,409,329,176,914,2051
6,411,350,206,967,2051
7,370,367,231,968,2051
8,380,379,241,1000,2051
9,380,386,245,1011,2051
10,379,408,256,1043,2051
11,404,445,254,1103,2051
1,500,200,50,750,2052
2,472,226,100,798,2052
3,441,262,133,836,2052
4,431,305,139,875,2052
5,410,311,193,914,2052
6,385,351,222,958,2052
7,389,360,245,994,2052
8,362,369,265,996,2052
9,360,376,280,1016,2052
10,367,392,298,1057,2052
11,353,426,306,1085,2052
1,500,200,50,750,2053
2,447,238,97,782,2053
3,411,269,124,804,2053
4,416,297,152,865,2053
5,427,307,176,910,2053
6,429,324,206,959,2053
7,416,345,218,979,2053
8,406,371,228,1005,2053
9,408,406,230,1044,2053
10,403,406,251,1060,2053
11,412,413,280,1105,2053
1,500,200,50,750,2054
2,443,236,99,778,2054
3,410,276,144,830,2054
4,389,292,173,854,2054
5,399,304,198,901,2054
6,408,335,209,952,2054
7,412,350,212,974,2054
8,382,368,238,988,2054
9,427,352,253,1032,2054
10,409,370,261,1040,2054
11,408,408,262,1078,2054
1,500,200,50,750,2055
2,465,216,106,787,2055
3,459,235,138,832,2055
4,431,257,169,857,2055
5,419,295,177,891,2055
6,424,336,196,956,2055
7,391,366,215,972,2055
8,391,360,245,996,2055
9,412,363,255,1030,2055
10,444,378,252,1074,2055
11,421,395,267,1083,2055
1,500,200,50,750,2056
2,470,223,98,791,2056
3,445,265,125,835,2056
4,437,283,153,873,2056
5,410,321,167,898,2056
6,404,337,206,947,2056
7,426,338,225,989,2056
8,431,354,225,1010,2056
9,423,383,239,1045,2056
10,386,405,271,1062,2056
11,394,405,285,1084,2056
1,500,200,50,750,2057
2,463,227,95,785,2057
3,437,253,140,830,2057
4,449,293,143,885,2057
5,432,311,173,916,2057
6,435,339,188,962,2057
7,433,357,202,992,2057
8,411,382,214,1007,2057
9,370,399,242,1011,2057
10,380,402,260,1042,2057
11,427,409,261,1097,2057
1,500,200,50,750,2058
2,444,230,99,773,2058
3,421,273,141,835,2058
4,420,287,160,867,2058
5,396,317,171,884,2058
6,411,359,195,965,2058
7,408,370,215,993,2058
8,381,368,251,1000,2058
9,388,396,254,1038,2058
10,400,405,265,1070,2058
11,386,409,280,1075,2058
1,500,200,50,750,2059
2,448,249,99,796,2059
3,414,277,131,822,2059
4,399,305,156,860,2059
5,386,331,196,913,2059
6,402,359,215,976,2059
7,365,370,246,981,2059
8,373,373,258,1004,2059
9,389,387,280,1056,2059
10,383,403,261,1047,2059
11,393,398,298,1089,2059
1,500,200,50,750,2060
2,455,249,92,796,2060
3,406,264,138,808,2060
4,393,307,168,868,2060
5,409,309,198,916,2060
6,385,358,225,968,2060
7,376,355,248,979,2060
8,389,370,260,1019,2060
9,372,383,266,1021,2060
10,387,397,286,1070,2060
11,390,414,275,1079,2060
1,500,200,50,750,2061
2,469,221,99,789,2061
3,436,246,149,831,2061
4,427,266,176,869,2061
5,422,321,168,911,2061
6,412,316,219,947,2061
7,412,328,234,974,2061
8,416,361,227,1004,2061
9,411,376,240,1027,2061
10,420,373,272,1065,2061
11,394,375,290,1059,2061
1,500,200,50,750,2062
2,458,233,100,791,2062
3,433,268,141,842,2062
4,411,292,173,876,2062
5,396,326,201,923,2062
6,419,344,212,975,2062
7,402,351,243,996,2062
8,392,361,249,1002,2062
9,402,384,251,1037,2062
10,394,399,258,1051,2062
11,407,407,260,1074,2062
1,500,200,50,750,2063
2,467,225,93,785,2063
3,432,260,133,825,2063
4,411,304,157,872,2063
5,406,332,181,919,2063
6,385,357,200,942,2063
7,407,356,230,993,2063
8,402,362,245,1009,2063
9,399,389,253,1041,2063
10,413,399,249,1061,2063
11,399,406,275,1080,2063
1,500,200,50,750,2064
2,457,226,106,789,2064
3,436,250,147,833,2064
4,417,275,170,862,2064
5,410,296,203,909,2064
6,394,331,213,938,2064
7,394,361,226,981,2064
8,382,375,245,1002,2064
9,374,393,257,1024,2064
10,371,386,292,1049,2064
11,394,420,270,1084,2064
1,500,200,50,750,2065
2,449,234,91,774,2065
3,438,258,130,826,2065
4,416,284,158,858,2065
5,409,320,170,899,2065
6,423,342,206,971,2065
7,404,351,220,975,2065
8,400,376,228,1004,2065
9,391,393,243,1027,2065
10,394,412,243,1049,2065
11,399,415,254,1068,2065
1,500,200,50,750,2066
2,472,216,97,785,2066
3,422,262,137,821,2066
4,425,290,168,883,2066
5,402,310,191,903,2066
6,411,318,224,953,2066
7,399,365,228,992,2066
8,374,390,236,1000,2066
9,385,414,241,1040,2066
10,372,415,267,1054,2066
11,379,416,280,1075,2066
1,500,200,50,750,2067
2,454,240,84,778,2067
3,445,240,129,814,2067
4,404,278,161,843,2067
5,404,326,194,924,2067
6,392,354,217,963,2067
7,403,364,227,994,2067
8,379,376,244,999,2067
9,384,392,256,1032,2067
10,386,410,253,1049,2067
11,360,416,283,1059,2067
1,500,200,50,750,2068
2,453,235,94,782,2068
3,426,270,122,818,2068
4,421,290,150,861,2068
5,425,307,171,903,2068
6,442,325,200,967,2068
7,411,355,215,981,2068
8,387,357,241,985,2068
9,423,382,229,1034,2068
10,425,388,249,1062,2068
11,427,398,262,1087,2068
1,500,200,50,750,2069
2,462,228,97,787,2069
3,433,269,117,819,2069
4,417,302,154,873,2069
5,403,328,197,928,2069
6,399,327,233,959,2069
7,392,363,228,983,2069
8,381,384,240,1005,2069
9,387,380,257,1024,2069
10,413,388,267,1068,2069
11,416,385,270,1071,2069
1,500,200,50,750,2070
2,447,253,89,789,2070
3,427,264,144,835,2070
4,402,284,165,851,2070
5,420,302,190,912,2070
6,407,334,211,952,2070
7,391,360,224,975,2070
8,372,379,250,1001,2070
9,376,408,257,1041,2070
10,377,419,262,1058,2070
11,366,454,267,1087,2070
1,500,200,50,750,2071
2,457,250,88,795,2071
3,438,270,119,827,2071
4,418,312,145,875,2071
5,405,321,180,906,2071
6,405,342,199,946,2071
7,418,376,215,1009,2071
8,390,376,243,1009,2071
9,395,408,238,1041,2071
10,408,404,256,1068,2071
11,392,424,264,1080,2071
1,500,200,50,750,2072
2,467,226,101,794,2072
3,440,261,144,845,2072
4,438,277,168,883,2072
5,426,301,184,911,2072
6,435,321,199,955,2072
7,422,343,209,974,2072
8,410,362,223,995,2072
9,416,373,236,1025,2072
10,424,371,269,1064,2072
11,404,421,264,1089,2072
1,500,200,50,750,2073
2,468,225,99,792,2073
3,431,264,136,831,2073
4,414,283,160,857,2073
5,422,312,173,907,2073
6,417,339,196,952,2073
7,395,364,224,983,2073
8,396,393,228,1017,2073
9,388,388,244,1020,2073
10,400,388,259,1047,2073
11,396,402,268,1066,2073
1,500,200,50,750,2074
2,480,231,88,799,2074
3,448,265,121,834,2074
4,432,315,147,894,2074
5,414,333,172,919,2074
6,413,346,189,948,2074
7,400,362,205,967,2074
8,373,396,233,1002,2074
9,357,425,248,1030,2074
10,377,397,268,1042,2074
11,396,410,266,1072,2074
1,500,200,50,750,2075
2,474,225,92,791,2075
3,462,254,116,832,2075
4,420,285,163,868,2075
5,428,302,186,916,2075
6,407,355,198,960,2075
7,417,371,212,1000,2075
8,411,389,224,1024,2075
9,415,388,237,1040,2075
10,413,382,260,1055,2075
11,405,433,244,1082,2075
1,500,200,50,750,2076
2,462,220,98,780,2076
3,447,254,135,836,2076
4,412,296,162,870,2076
5,384,330,196,910,2076
6,376,371,196,943,2076
7,398,367,221,986,2076
8,393,380,241,1014,2076
9,417,373,249,1039,2076
10,416,369,263,1048,2076
11,398,388,274,1060,2076
1,500,200,50,750,2077
2,477,224,84,785,2077
3,443,252,135,830,2077
4,414,303,151,868,2077
5,409,325,189,923,2077
6,402,347,208,957,2077
7,396,352,224,972,2077
8,405,355,248,1008,2077
9,390,383,240,1013,2077
10,387,428,245,1060,2077
11,379,417,277,1073,2077
1,500,200,50,750,2078
2,448,233,103,784,2078
3,441,262,138,841,2078
4,424,295,152,871,2078
5,405,326,178,909,2078
6,402,345,203,950,2078
7,390,362,223,975,2078
8,390,374,244,1008,2078
9,382,394,252,1028,2078
10,379,416,267,1062,2078
11,376,423,266,1065,2078
1,500,200,50,750,2079
2,445,246,91,782,2079
3,410,290,134,834,2079
4,416,287,148,851,2079
5,408,315,171,894,2079
6,432,336,203,971,2079
7,410,335,234,979,2079
8,397,348,256,1001,2079
9,396,371,262,1029,2079
10,403,364,278,1045,2079
11,433,391,270,1094,2079
1,500,200,50,750,2080
2,469,214,99,782,2080
3,446,266,117,829,2080
4,416,275,178,869,2080
5,432,284,195,911,2080
6,404,331,203,938,2080
7,409,350,231,990,2080
8,395,366,245,1006,2080
9,389,372,237,998,2080
10,424,379,260,1063,2080
11,412,384,278,1074,2080
1,500,200,50,750,2081
2,446,240,96,782,2081
3,405,264,144,813,2081
4,400,278,177,855,2081
5,426,305,185,916,2081
6,412,316,214,942,2081
7,406,351,232,989,2081
8,404,370,231,1005,2081
9,411,357,250,1018,2081
10,407,377,259,1043,2081
11,414,403,275,1092,2081
1,500,200,50,750,2082
2,459,243,94,796,2082
3,414,266,142,822,2082
4,398,302,174,874,2082
5,375,304,221,900,2082
6,371,341,237,949,2082
7,381,346,259,986,2082
8,408,365,233,1006,2082
9,410,374,251,1035,2082
10,404,388,261,1053,2082
11,416,390,287,1093,2082
1,500,200,50,750,2083
2,476,233,83,792,2083
3,456,250,127,833,2083
4,439,278,158,875,2083
5,435,299,181,915,2083
6,425,328,212,965,2083
7,391,372,220,983,2083
8,379,396,227,1002,2083
9,384,406,228,1018,2083
10,395,411,250,1056,2083
11,417,395,275,1087,2083
1,500,200,50,750,2084
2,458,219,107,784,2084
3,411,256,142,809,2084
4,408,289,171,868,2084
5,416,312,194,922,2084
6,405,315,230,950,2084
7,408,331,244,983,2084
8,390,343,249,982,2084
9,384,397,250,1031,2084
10,372,420,264,1056,2084
11,393,417,272,1082,2084
1,500,200,50,750,2085
2,457,231,110,798,2085
3,414,251,151,816,2085
4,406,291,177,874,2085
5,403,316,194,913,2085
6,422,315,217,954,2085
7,383,359,221,963,2085
8,395,376,252,1023,2085
9,381,394,259,1034,2085
10,396,385,282,1063,2085
11,428,387,287,1102,2085
1,500,200,50,750,2086
2,476,239,81,796,2086
3,422,271,116,809,2086
4,417,301,158,876,2086
5,402,339,174,915,2086
6,425,343,185,953,2086
7,402,344,221,967,2086
8,415,367,234,1016,2086
9,404,390,239,1033,2086
10,399,395,257,1051,2086
11,417,377,284,1078,2086
1,500,200,50,750,2087
2,453,233,98,784,2087
3,422,264,146,832,2087
4,389,294,178,861,2087
5,396,331,198,925,2087
6,385,340,225,950,2087
7,383,358,241,982,2087
8,354,368,274,996,2087
9,356,385,283,1024,2087
10,346,412,294,1052,2087
11,380,410,290,1080,2087
1,500,200,50,750,2088
2,476,235,86,797,2088
3,453,257,118,828,2088
4,448,261,157,866,2088
5,426,299,179,904,2088
6,431,321,207,959,2088
7,410,349,228,987,2088
8,417,353,239,1009,2088
9,374,396,251,1021,2088
10,395,391,266,1052,2088
11,419,404,277,1100,2088
1,500,200,50,750,2089
2,463,233,94,790,2089
3,451,264,118,833,2089
4,412,299,152,863,2089
5,401,329,176,906,2089
6,397,339,197,933,2089
7,411,361,196,968,2089
8,404,362,240,1006,2089
9,385,379,247,1011,2089
10,416,408,245,1069,2089
11,409,408,250,1067,2089
1,500,200,50,750,2090
2,449,240,104,793,2090
3,424,277,134,835,2090
4,412,296,163,871,2090
5,386,325,187,898,2090
6,401,364,193,958,2090
7,390,360,225,975,2090
8,393,368,253,1014,2090
9,366,398,255,1019,2090
10,392,393,278,1063,2090
11,376,406,288,1070,2090
1,500,200,50,750,2091
2,450,240,102,792,2091
3,428,264,123,815,2091
4,431,291,156,878,2091
5,420,320,171,911,2091
6,396,366,206,968,2091
7,374,387,215,976,2091
8,379,388,247,1014,2091
9,372,377,278,1027,2091
10,372,421,271,1064,2091
11,367,410,312,1089,2091
1,500,200,50,750,2092
2,449,239,99,787,2092
3,406,267,150,823,2092
4,430,295,147,872,2092
5,419,314,181,914,2092
6,411,355,197,963,2092
7,405,340,223,968,2092
8,406,352,242,1000,2092
9,414,377,252,1043,2092
10,430,373,256,1059,2092
11,416,402,269,1087,2092
1,500,200,50,750,2093
2,461,239,94,794,2093
3,431,245,128,804,2093
4,433,287,147,867,2093
5,408,305,192,905,2093
6,416,329,207,952,2093
7,416,337,227,980,2093
8,417,347,250,1014,2093
9,404,338,284,1026,2093
10,386,372,284,1042,2093
11,390,373,302,1065,2093
1,500,200,50,750,2094
2,468,225,101,794,2094
3,448,231,152,831,2094
4,423,269,172,864,2094
5,431,297,207,935,2094
6,408,322,222,952,2094
7,381,360,236,977,2094
8,387,334,278,999,2094
9,381,364,273,1018,2094
10,416,388,268,1072,2094
11,400,405,270,1075,2094
1,500,200,50,750,2095
2,464,229,94,787,2095
3,460,249,127,836,2095
4,430,286,148,864,2095
5,391,305,208,904,2095
6,398,339,212,949,2095
7,364,359,252,975,2095
8,376,367,262,1005,2095
9,377,378,265,1020,2095
10,356,405,275,1036,2095
11,367,440,272,1079,2095
1,500,200,50,750,2096
2,467,211,107,785,2096
3,437,257,131,825,2096
4,428,289,168,885,2096
5,432,313,174,919,2096
6,408,332,208,948,2096
7,416,336,231,983,2096
8,425,351,246,1022,2096
9,391,373,266,1030,2096
10,375,415,256,1046,2096
11,378,430,260,1068,2096
1,500,200,50,750,2097
2,465,228,88,781,2097
3,428,261,133,822,2097
4,419,288,160,867,2097
5,421,337,187,945,2097
6,413,333,213,959,2097
7,384,361,229,974,2097
8,400,377,227,1004,2097
9,407,376,232,1015,2097
10,424,415,237,1076,2097
11,421,412,254,1087,2097
1,500,200,50,750,2098
2,459,232,108,799,2098
3,416,266,148,830,2098
4,409,306,176,891,2098
5,395,324,193,912,2098
6,400,362,208,970,2098
7,389,386,217,992,2098
8,384,396,243,1023,2098
9,382,396,249,1027,2098
10,394,384,278,1056,2098
11,395,400,281,1076,2098
1,500,200,50,750,2099
2,451,225,110,786,2099
3,408,276,139,823,2099
4,392,291,180,863,2099
5,381,307,219,907,2099
6,414,340,227,981,2099
7,395,367,232,994,2099
8,380,376,246,1002,2099
9,374,375,273,1022,2099
10,396,411,263,1070,2099
11,399,412,279,1090,2099
1,500,200,50,750,2100
2,452,232,98,782,2100
3,438,253,141,832,2100
4,413,277,171,861,2100
5,415,311,200,926,2100
6,394,332,219,945,2100
7,387,350,237,974,2100
8,393,366,244,1003,2100
9,400,369,261,1030,2100
10,394,380,276,1050,2100
11,408,375,293,1076,2100
1,500,200,50,750,2101
2,454,230,111,795,2101
3,414,264,152,830,2101
4,410,274,189,873,2101
5,398,327,203,928,2101
6,387,354,210,951,2101
7,386,360,230,976,2101
8,387,361,245,993,2101
9,400,373,271,1044,2101
10,386,379,275,1040,2101
11,410,397,275,1082,2101
1,500,200,50,750,2102
2,451,233,91,775,2102
3,442,263,131,836,2102
4,422,282,168,872,2102
5,400,302,194,896,2102
6,387,362,213,962,2102
7,362,364,242,968,2102
8,366,373,257,996,2102
9,386,378,277,1041,2102
10,396,389,277,1062,2102
11,398,371,315,1084,2102
1,500,200,50,750,2103
2,451,230,94,775,2103
3,435,238,143,816,2103
4,421,265,173,859,2103
5,413,306,186,905,2103
6,414,340,213,967,2103
7,396,336,253,985,2103
8,381,374,246,1001,2103
9,391,380,256,1027,2103
10,384,391,273,1048,2103
11,391,389,289,1069,2103
1,500,200,50,750,2104
2,447,238,102,787,2104
3,425,266,133,824,2104
4,431,289,163,883,2104
5,391,316,186,893,2104
6,412,340,216,968,2104
7,394,362,235,991,2104
8,379,390,250,1019,2104
9,366,382,280,1028,2104
10,368,405,295,1068,2104
11,380,394,302,1076,2104
1,500,200,50,750,2105
2,456,242,103,801,2105
3,421,274,138,833,2105
4,416,274,174,864,2105
5,384,312,204,900,2105
6,410,340,213,963,2105
7,397,350,234,981,2105
8,395,344,247,986,2105
9,418,363,241,1022,2105
10,416,397,245,1058,2105
11,431,391,267,1089,2105
1,500,200,50,750,2106
2,454,226,99,779,2106
3,450,255,140,845,2106
4,414,294,163,871,2106
5,415,319,179,913,2106
6,417,345,209,971,2106
7,405,349,225,979,2106
8,434,366,227,1027,2106
9,418,374,242,1034,2106
10,413,389,250,1052,2106
11,415,414,249,1078,2106
1,500,200,50,750,2107
2,460,219,106,785,2107
3,427,256,135,818,2107
4,410,268,163,841,2107
5,430,281,207,918,2107
6,421,290,238,949,2107
7,390,335,247,972,2107
8,416,365,259,1040,2107
9,403,367,267,1037,2107
10,399,369,277,1045,2107
11,416,411,253,1080,2107
1,500,200,50,750,2108
2,448,234,98,780,2108
3,417,272,136,825,2108
4,395,294,179,868,2108
5,397,307,209,913,2108
6,400,335,231,966,2108
7,380,370,236,986,2108
8,389,395,235,1019,2108
9,374,400,244,1018,2108
10,385,405,267,1057,2108
11,359,423,285,1067,2108
1,500,200,50,750,2109
2,461,239,100,800,2109
3,401,263,165,829,2109
4,404,306,176,886,2109
5,397,336,184,917,2109
6,392,369,206,967,2109
7,393,381,207,981,2109
8,377,386,220,983,2109
9,383,388,256,1027,2109
10,413,397,275,1085,2109
11,394,390,278,1062,2109
1,500,200,50,750,2110
2,457,235,108,800,2110
3,427,255,149,831,2110
4,445,257,171,873,2110
5,432,285,191,908,2110
6,430,308,209,947,2110
7,434,319,234,987,2110
8,410,338,249,997,2110
9,405,360,243,1008,2110
10,426,382,250,1058,2110
11,425,403,261,1089,2110
1,500,200,50,750,2111
2,473,236,94,803,2111
3,445,262,131,838,2111
4,424,295,140,859,2111
5,431,326,154,911,2111
6,427,326,198,951,2111
7,418,337,216,971,2111
8,406,376,228,1010,2111
9,406,376,233,1015,2111
10,410,387,257,1054,2111
11,399,411,272,1082,2111
1,500,200,50,750,2112
2,467,231,99,797,2112
3,433,256,144,833,2112
4,417,284,176,877,2112
5,410,305,188,903,2112
6,420,332,214,966,2112
7,407,330,240,977,2112
8,400,352,240,992,2112
9,415,371,257,1043,2112
10,426,375,262,1063,2112
11,405,398,271,1074,2112
1,500,200,50,750,2113
2,455,230,95,780,2113
3,416,280,133,829,2113
4,395,315,154,864,2113
5,412,335,183,930,2113
6,412,356,204,972,2113
7,400,358,229,987,2113
8,388,367,254,1009,2113
9,415,353,283,1051,2113
10,409,368,277,1054,2113
11,408,405,285,1098,2113
1,500,200,50,750,2114
2,458,222,98,778,2114
3,440,243,132,815,2114
4,417,293,158,868,2114
5,404,329,182,915,2114
6,399,363,188,950,2114
7,401,363,225,989,2114
8,389,375,247,1011,2114
9,399,378,252,1029,2114
10,375,425,257,1057,2114
11,401,422,258,1081,2114
1,500,200,50,750,2115
2,453,255,91,799,2115
3,413,279,132,824,2115
4,415,293,166,874,2115
5,408,286,207,901,2115
6,408,301,233,942,2115
7,397,345,246,988,2115
8,407,343,256,1006,2115
9,403,360,256,1019,2115
10,385,355,304,1044,2115
11,385,371,307,1063,2115
1,500,200,50,750,2116
2,434,258,76,768,2116
3,447,275,116,838,2116
4,427,297,153,877,2116
5,416,299,184,899,2116
6,429,319,211,959,2116
7,413,335,230,978,2116
8,408,352,239,999,2116
9,401,356,272,1029,2116
10,404,382,273,1059,2116
11,403,405,258,1066,2116
1,500,200,50,750,2117
2,450,229,104,783,2117
3,429,262,133,824,2117
4,408,273,175,856,2117
5,407,310,199,916,2117
6,420,319,236,975,2117
7,400,350,226,976,2117
8,413,360,232,1005,2117
9,409,390,246,1045,2117
10,415,371,272,1058,2117
11,415,383,290,1088,2117
1,500,200,50,750,2118
2,474,232,83,789,2118
3,432,283,123,838,2118
4,420,282,159,861,2118
5,397,309,193,899,2118
6,412,356,199,967,2118
7,397,356,228,981,2118
8,392,363,232,987,2118
9,385,399,231,1015,2118
10,420,399,257,1076,2118
11,412,400,266,1078,2118
1,500,200,50,750,2119
2,460,239,93,792,2119
3,422,270,134,826,2119
4,409,286,177,872,2119
5,414,310,183,907,2119
6,417,329,212,958,2119
7,426,340,230,996,2119
8,394,364,231,989,2119
9,393,376,252,1021,2119
10,422,402,240,1064,2119
11,423,427,227,1077,2119
1,500,200,50,750,2120
2,443,233,107,783,2120
3,414,265,146,825,2120
4,401,286,188,875,2120
5,399,308,201,908,2120
6,393,347,214,954,2120
7,399,353,226,978,2120
8,397,368,243,1008,2120
9,393,383,266,1042,2120
10,384,397,275,1056,2120
11,386,416,285,1087,2120
1,500,200,50,750,2121
2,447,237,99,783,2121
3,409,250,148,807,2121
4,392,311,166,869,2121
5,391,328,183,902,2121
6,393,343,209,945,2121
7,407,353,215,975,2121
8,395,365,236,996,2121
9,408,358,271,1037,2121
10,398,386,268,1052,2121
11,404,396,292,1092,2121
1,500,200,50,750,2122
2,459,225,97,781,2122
3,425,257,139,821,2122
4,398,287,176,861,2122
5,383,294,210,887,2122
6,407,323,228,958,2122
7,406,331,245,982,2122
8,411,362,246,1019,2122
9,400,352,273,1025,2122
10,396,394,249,1039,2122
11,403,420,266,1089,2122
1,500,200,50,750,2123
2,444,233,108,785,2123
3,425,261,154,840,2123
4,393,293,181,867,2123
5,380,334,189,903,2123
6,413,343,186,942,2123
7,387,363,215,965,2123
8,410,375,254,1039,2123
9,379,388,263,1030,2123
10,384,435,243,1062,2123
11,391,423,256,1070,2123
1,500,200,50,750,2124
2,453,231,106,790,2124
3,405,271,136,812,2124
4,388,313,179,880,2124
5,402,322,189,913,2124
6,399,341,218,958,2124
7,411,369,210,990,2124
8,400,351,254,1005,2124
9,410,367,273,1050,2124
10,403,372,287,1062,2124
11,403,374,311,1088,2124
1,500,200,50,750,2125
2,443,240,103,786,2125
3,414,279,137,830,2125
4,413,284,170,867,2125
5,400,324,182,906,2125
6,392,356,204,952,2125
7,384,386,210,980,2125
8,388,383,234,1005,2125
9,390,378,267,1035,2125
10,400,396,272,1068,2125
11,401,408,275,1084,2125
1,500,200,50,750,2126
2,453,232,93,778,2126
3,440,260,127,827,2126
4,414,291,149,854,2126
5,426,310,178,914,2126
6,433,312,213,958,2126
7,428,336,235,999,2126
8,402,367,231,1000,2126
9,390,391,250,1031,2126
10,398,400,262,1060,2126
11,408,397,275,1080,2126
1,500,200,50,750,2127
2,459,232,100,791,2127
3,444,253,137,834,2127
4,445,280,163,888,2127
5,412,313,170,895,2127
6,443,341,185,969,2127
7,419,351,212,982,2127
8,410,374,226,1010,2127
9,398,386,248,1032,2127
10,393,395,270,1058,2127
11,403,385,289,1077,2127
1,500,200,50,750,2128
2,481,219,87,787,2128
3,455,246,126,827,2128
4,438,271,152,861,2128
5,422,302,177,901,2128
6,414,338,188,940,2128
7,396,358,228,982,2128
8,398,394,238,1030,2128
9,390,379,266,1035,2128
10,401,402,252,1055,2128
11,411,406,277,1094,2128
1,500,200,50,750,2129
2,474,239,83,796,2129
3,438,246,125,809,2129
4,438,287,152,877,2129
5,447,293,174,914,2129
6,435,304,209,948,2129
7,422,341,223,986,2129
8,409,362,241,1012,2129
9,413,363,261,1037,2129
10,400,399,261,1060,2129
11,372,425,269,1066,2129
1,500,200,50,750,2130
2,452,235,94,781,2130
3,425,268,127,820,2130
4,395,305,146,846,2130
5,401,324,193,918,2130
6,407,336,208,951,2130
7,399,338,228,965,2130
8,402,356,239,997,2130
9,385,394,245,1024,2130
10,392,390,261,1043,2130
11,406,417,275,1098,2130
1,500,200,50,750,2131
2,474,228,89,791,2131
3,443,262,125,830,2131
4,413,291,157,861,2131
5,399,309,196,904,2131
6,421,325,235,981,2131
7,408,336,243,987,2131
8,413,350,259,1022,2131
9,403,378,257,1038,2131
10,399,411,252,1062,2131
11,406,398,283,1087,2131
1,500,200,50,750,2132
2,469,241,77,787,2132
3,438,263,124,825,2132
4,419,288,157,864,2132
5,418,322,167,907,2132
6,420,359,187,966,2132
7,403,368,203,974,2132
8,399,369,245,1013,2132
9,420,376,238,1034,2132
10,425,373,261,1059,2132
11,416,397,267,1080,2132
1,500,200,50,750,2133
2,464,220,100,784,2133
3,427,255,132,814,2133
4,421,294,159,874,2133
5,418,306,190,914,2133
6,416,330,211,957,2133
7,405,347,224,976,2133
8,404,352,235,991,2133
9,411,373,260,1044,2133
10,434,381,255,1070,2133
11,430,391,264,1085,2133
1,500,200,50,750,2134
2,457,236,92,785,2134
3,449,261,125,835,2134
4,430,286,156,872,2134
5,405,302,195,902,2134
6,414,321,213,948,2134
7,412,313,235,960,2134
8,432,361,230,1023,2134
9,423,371,231,1025,2134
10,411,380,247,1038,2134
11,401,393,279,1073,2134
1,500,200,50,750,2135
2,456,237,91,784,2135
3,445,265,122,832,2135
4,425,269,169,863,2135
5,432,325,176,933,2135
6,415,340,197,952,2135
7,411,357,225,993,2135
8,404,376,237,1017,2135
9,391,383,269,1043,2135
10,410,409,276,1095,2135
11,389,382,301,1072,2135
1,500,200,50,750,2136
2,444,241,101,786,2136
3,447,242,150,839,2136
4,412,288,167,867,2136
5,397,321,193,911,2136
6,407,356,198,961,2136
7,390,365,229,984,2136
8,384,364,265,1013,2136
9,377,403,267,1047,2136
10,371,412,275,1058,2136
11,397,418,275,1090,2136
1,500,200,50,750,2137
2,456,221,109,786,2137
3,447,269,120,836,2137
4,420,312,151,883,2137
5,402,323,184,909,2137
6,401,342,204,947,2137
7,389,344,243,976,2137
8,423,359,230,1012,2137
9,427,371,246,1044,2137
10,410,379,279,1068,2137
11,397,397,297,1091,2137
1,500,200,50,750,2138
2,469,228,94,791,2138
3,441,276,131,848,2138
4,411,310,149,870,2138
5,405,321,182,908,2138
6,396,355,203,954,2138
7,394,358,235,987,2138
8,389,365,262,1016,2138
9,382,393,261,1036,2138
10,399,408,253,1060,2138
11,401,396,285,1082,2138
1,500,200,50,750,2139
2,463,227,96,786,2139
3,404,271,130,805,2139
4,403,308,145,856,2139
5,411,335,173,919,2139
6,399,368,199,966,2139
7,384,374,218,976,2139
8,412,361,234,1007,2139
9,426,349,257,1032,2139
10,432,374,260,1066,2139
11,437,382,271,1090,2139
1,500,200,50,750,2140
2,456,229,98,783,2140
3,436,254,136,826,2140
4,417,284,181,882,2140
5,411,300,194,905,2140
6,413,314,231,958,2140
7,377,346,243,966,2140
8,392,368,246,1006,2140
9,368,385,262,1015,2140
10,397,401,262,1060,2140
11,398,410,270,1078,2140
1,500,200,50,750,2141
2,461,239,101,801,2141
3,447,266,125,838,2141
4,430,289,158,877,2141
5,407,331,181,919,2141
6,404,364,197,965,2141
7,406,363,212,981,2141
8,396,378,227,1001,2141
9,381,405,235,1021,2141
10,396,409,251,1056,2141
11,420,413,261,1094,2141
1,500,200,50,750,2142
2,481,223,92,796,2142
3,444,232,152,828,2142
4,427,260,186,873,2142
5,417,282,198,897,2142
6,419,316,214,949,2142
7,395,344,230,969,2142
8,397,376,244,1017,2142
9,407,375,264,1046,2142
10,398,406,260,1064,2142
11,392,422,273,1087,2142
1,500,200,50,750,2143
2,473,220,95,788,2143
3,437,251,132,820,2143
4,424,288,164,876,2143
5,421,308,184,913,2143
6,432,331,200,963,2143
7,392,361,220,973,2143
8,397,377,230,1004,2143
9,385,397,236,1018,2143
10,386,434,245,1065,2143
11,371,443,266,1080,2143
1,500,200,50,750,2144
2,466,217,98,781,2144
3,437,253,138,828,2144
4,432,272,182,886,2144
5,419,282,212,913,2144
6,417,303,239,959,2144
7,397,345,250,992,2144
8,363,397,240,1000,2144
9,391,411,249,1051,2144
10,390,402,269,1061,2144
11,386,406,273,1065,2144
1,500,200,50,750,2145
2,467,215,104,786,2145
3,424,264,139,827,2145
4,421,288,167,876,2145
5,396,327,186,909,2145
6,393,345,209,947,2145
7,377,359,235,971,2145
8,386,378,243,1007,2145
9,367,386,269,1022,2145
10,396,391,279,1066,2145
11,391,403,281,1075,2145
1,500,200,50,750,2146
2,448,232,92,772,2146
3,428,260,139,827,2146
4,399,274,191,864,2146
5,411,294,197,902,2146
6,399,339,213,951,2146
7,406,336,232,974,2146
8,393,361,245,999,2146
9,417,384,241,1042,2146
10,400,408,257,1065,2146
11,391,415,260,1066,2146
1,500,200,50,750,2147
2,469,233,92,794,2147
3,437,250,126,813,2147
4,430,270,170,870,2147
5,431,278,205,914,2147
6,411,322,215,948,2147
7,419,351,213,983,2147
8,406,364,232,1002,2147
9,432,345,266,1043,2147
10,386,377,279,1042,2147
11,402,410,268,1080,2147
1,500,200,50,750,2148
2,470,240,90,800,2148
3,438,259,119,816,2148
4,431,272,156,859,2148
5,410,300,188,898,2148
6,404,340,219,963,2148
7,401,330,247,978,2148
8,405,350,256,1011,2148
9,388,370,261,1019,2148
10,395,383,278,1056,2148
11,386,413,285,1084,2148
1,500,200,50,750,2149
2,460,222,98,780,2149
3,445,235,137,817,2149
4,440,257,175,872,2149
5,448,288,195,931,2149
6,438,311,218,967,2149
7,420,338,231,989,2149
8,404,369,236,1009,2149
9,393,384,250,1027,2149
10,394,419,261,1074,2149
11,393,406,269,1068,2149
1,500,200,50,750,2150
2,446,237,101,784,2150
3,426,272,133,831,2150
4,413,290,165,868,2150
5,410,330,182,922,2150
6,420,334,203,957,2150
7,394,350,222,966,2150
8,399,360,239,998,2150
9,400,361,262,1023,2150
10,409,366,272,1047,2150
11,422,391,266,1079,2150
1,500,200,50,750,2151
2,465,217,100,782,2151
3,453,240,144,837,2151
4,448,283,150,881,2151
5,438,300,187,925,2151
6,426,317,210,953,2151
7,419,343,215,977,2151
8,411,360,230,1001,2151
9,414,369,260,1043,2151
10,400,376,271,1047,2151
11,429,410,269,1108,2151
1,500,200,50,750,2152
2,459,229,95,783,2152
3,438,266,120,824,2152
4,420,288,165,873,2152
5,428,296,199,923,2152
6,436,311,222,969,2152
7,417,341,230,988,2152
8,392,365,256,1013,2152
9,369,378,270,1017,2152
10,411,405,275,1091,2152
11,397,414,275,1086,2152
1,500,200,50,750,2153
2,467,217,111,795,2153
3,434,255,135,824,2153
4,409,282,158,849,2153
5,422,323,178,923,2153
6,410,345,207,962,2153
7,401,328,250,979,2153
8,393,364,254,1011,2153
9,385,372,287,1044,2153
10,378,390,296,1064,2153
11,384,421,282,1087,2153
1,500,200,50,750,2154
2,463,225,92,780,2154
3,430,252,140,822,2154
4,418,280,168,866,2154
5,402,341,169,912,2154
6,430,341,201,972,2154
7,408,365,210,983,2154
8,401,377,234,1012,2154
9,400,393,246,1039,2154
10,376,406,265,1047,2154
11,403,400,267,1070,2154
1,500,200,50,750,2155
2,452,240,90,782,2155
3,428,266,124,818,2155
4,412,291,174,877,2155
5,408,301,186,895,2155
6,421,344,207,972,2155
7,382,366,236,984,2155
8,389,383,252,1024,2155
9,365,394,260,1019,2155
10,384,414,252,1050,2155
11,382,415,276,1073,2155
1,500,200,50,750,2156
2,474,231,89,794,2156
3,462,266,123,851,2156
4,424,285,160,869,2156
5,418,320,180,918,2156
6,406,349,196,951,2156
7,403,352,215,970,2156
8,426,367,220,1013,2156
9,418,377,240,1035,2156
10,421,397,246,1064,2156
11,418,421,254,1093,2156
1,500,200,50,750,2157
2,438,239,106,783,2157
3,408,271,141,820,2157
4,393,318,163,874,2157
5,363,342,204,909,2157
6,402,333,228,963,2157
7,371,373,229,973,2157
8,382,381,234,997,2157
9,403,386,251,1040,2157
10,393,402,263,1058,2157
11,370,423,284,1077,2157
1,500,200,50,750,2158
2,456,246,97,799,2158
3,414,295,115,824,2158
4,415,312,151,878,2158
5,412,336,180,928,2158
6,397,330,213,940,2158
7,392,357,225,974,2158
8,401,377,239,1017,2158
9,397,404,236,1037,2158
10,404,395,255,1054,2158
11,416,401,255,1072,2158
1,500,200,50,750,2159
2,464,224,100,788,2159
3,442,254,133,829,2159
4,412,313,140,865,2159
5,406,326,173,905,2159
6,410,354,198,962,2159
7,385,379,215,979,2159
8,366,385,249,1000,2159
9,397,381,271,1049,2159
10,383,378,278,1039,2159
11,400,416,284,1100,2159
1,500,200,50,750,2160
2,472,221,92,785,2160
3,426,256,137,819,2160
4,407,287,164,858,2160
5,387,327,200,914,2160
6,381,327,225,933,2160
7,385,345,249,979,2160
8,384,364,265,1013,2160
9,383,391,257,1031,2160
10,378,407,275,1060,2160
11,374,442,268,1084,2160
1,500,200,50,750,2161
2,458,220,108,786,2161
3,447,242,150,839,2161
4,419,281,157,857,2161
5,426,301,173,900,2161
6,421,316,201,938,2161
7,428,340,211,979,2161
8,419,352,238,1009,2161
9,434,372,237,1043,2161
10,437,365,261,1063,2161
11,433,373,283,1089,2161
1,500,200,50,750,2162
2,465,228,106,799,2162
3,435,260,144,839,2162
4,414,286,168,868,2162
5,418,318,179,915,2162
6,414,340,189,943,2162
7,418,363,198,979,2162
8,412,366,228,1006,2162
9,399,375,247,1021,2162
10,420,378,257,1055,2162
11,422,397,282,1101,2162
1,500,200,50,750,2163
2,471,232,96,799,2163
3,454,243,133,830,2163
4,413,287,159,859,2163
5,404,314,194,912,2163
6,395,339,215,949,2163
7,395,350,234,979,2163
8,392,365,234,991,2163
9,426,366,245,1037,2163
10,391,387,279,1057,2163
11,415,388,289,1092,2163
1,500,200,50,750,2164
2,446,228,108,782,2164
3,422,269,147,838,2164
4,392,302,166,860,2164
5,398,319,201,918,2164
6,393,341,219,953,2164
7,405,373,222,1000,2164
8,386,372,252,1010,2164
9,402,391,241,1034,2164
10,410,384,251,1045,2164
11,402,414,270,1086,2164
1,500,200,50,750,2165
2,446,239,100,785,2165
3,422,246,158,826,2165
4,423,263,191,877,2165
5,407,294,201,902,2165
6,391,333,233,957,2165
7,386,354,240,980,2165
8,384,379,254,1017,2165
9,377,401,266,1044,2165
10,385,414,254,1053,2165
11,395,420,268,1083,2165
1,500,200,50,750,2166
2,467,222,98,787,2166
3,462,246,130,838,2166
4,434,289,163,886,2166
5,425,304,181,910,2166
6,406,336,217,959,2166
7,411,338,238,987,2166
8,413,366,228,1007,2166
9,397,377,252,1026,2166
10,385,405,269,1059,2166
11,389,427,267,1083,2166
1,500,200,50,750,2167
2,474,227,94,795,2167
3,444,244,145,833,2167
4,394,292,163,849,2167
5,421,318,177,916,2167
6,403,330,206,939,2167
7,404,341,228,973,2167
8,402,347,244,993,2167
9,412,376,254,1042,2167
10,410,383,268,1061,2167
11,406,395,276,1077,2167
1,500,200,50,750,2168
2,465,239,106,810,2168
3,442,256,137,835,2168
4,413,289,173,875,2168
5,406,323,191,920,2168
6,411,337,210,958,2168
7,398,343,237,978,2168
8,406,345,257,1008,2168
9,422,367,264,1053,2168
10,424,375,272,1071,2168
11,396,383,301,1080,2168
1,500,200,50,750,2169
2,469,229,82,780,2169
3,430,283,121,834,2169
4,424,302,147,873,2169
5,438,305,180,923,2169
6,443,319,198,960,2169
7,426,331,227,984,2169
8,425,364,235,1024,2169
9,440,363,241,1044,2169
10,420,375,258,1053,2169
11,416,402,260,1078,2169
1,500,200,50,750,2170
2,453,227,100,780,2170
3,427,271,130,828,2170
4,406,304,160,870,2170
5,399,308,186,893,2170
6,433,337,216,986,2170
7,397,345,237,979,2170
8,382,368,244,994,2170
9,380,385,256,1021,2170
10,409,395,260,1064,2170
11,408,401,277,1086,2170
1,500,200,50,750,2171
2,469,218,100,787,2171
3,432,251,127,810,2171
4,422,277,166,865,2171
5,430,305,192,927,2171
6,420,335,219,974,2171
7,401,350,229,980,2171
8,394,345,258,997,2171
9,371,389,262,1022,2171
10,391,404,262,1057,2171
11,403,399,287,1089,2171
1,500,200,50,750,2172
2,459,234,99,792,2172
3,445,256,129,830,2172
4,437,255,174,866,2172
5,442,280,194,916,2172
6,433,328,196,957,2172
7,401,375,222,998,2172
8,373,371,262,1006,2172
9,391,394,248,1033,2172
10,401,396,260,1057,2172
11,402,411,264,1077,2172
1,500,200,50,750,2173
2,461,233,84,778,2173
3,441,260,127,828,2173
4,401,299,153,853,2173
5,410,319,194,923,2173
6,385,340,220,945,2173
7,394,360,229,983,2173
8,382,386,239,1007,2173
9,373,392,267,1032,2173
10,362,401,297,1060,2173
11,367,397,326,1090,2173
1,500,200,50,750,2174
2,479,233,83,795,2174
3,428,275,117,820,2174
4,431,289,158,878,2174
5,406,308,194,908,2174
6,413,346,198,957,2174
7,389,376,218,983,2174
8,384,381,236,1001,2174
9,389,381,254,1024,2174
10,414,361,266,1041,2174
11,407,377,289,1073,2174
1,500,200,50,750,2175
2,463,235,98,796,2175
3,425,272,120,817,2175
4,412,278,178,868,2175
5,413,300,211,924,2175
6,395,325,215,935,2175
7,391,371,227,989,2175
8,364,400,235,999,2175
9,380,402,258,1040,2175
10,379,419,266,1064,2175
11,387,424,268,1079,2175
1,500,200,50,750,2176
2,458,230,91,779,2176
3,443,281,120,844,2176
4,419,290,151,860,2176
5,424,312,169,905,2176
6,422,329,201,952,2176
7,401,332,243,976,2176
8,402,372,242,1016,2176
9,370,389,268,1027,2176
10,365,402,291,1058,2176
11,383,410,309,1102,2176
1,500,200,50,750,2177
2,440,239,99,778,2177
3,431,258,140,829,2177
4,409,279,157,845,2177
5,414,312,174,900,2177
6,440,324,207,971,2177
7,426,322,236,984,2177
8,432,360,213,1005,2177
9,440,351,230,1021,2177
10,416,380,264,1060,2177
11,417,401,265,1083,2177
1,500,200,50,750,2178
2,462,228,102,792,2178
3,412,276,127,815,2178
4,384,330,155,869,2178
5,372,348,186,906,2178
6,365,372,216,953,2178
7,377,388,223,988,2178
8,375,368,267,1010,2178
9,381,392,263,1036,2178
10,399,390,265,1054,2178
11,410,390,280,1080,2178
1,500,200,50,750,2179
2,457,233,99,789,2179
3,428,258,149,835,2179
4,414,276,175,865,2179
5,413,311,191,915,2179
6,419,315,221,955,2179
7,412,340,232,984,2179
8,399,360,252,1011,2179
9,392,378,265,1035,2179
10,404,389,271,1064,2179
11,404,390,271,1065,2179
1,500,200,50,750,2180
2,462,230,96,788,2180
3,428,253,141,822,2180
4,409,292,164,865,2180
5,408,311,200,919,2180
6,436,291,229,956,2180
7,409,332,230,971,2180
8,406,351,235,992,2180
9,411,361,245,1017,2180
10,432,381,248,1061,2180
11,450,385,268,1103,2180
1,500,200,50,750,2181
2,472,232,83,787,2181
3,442,249,126,817,2181
4,429,289,145,863,2181
5,421,302,184,907,2181
6,416,341,205,962,2181
7,407,354,221,982,2181
8,422,360,238,1020,2181
9,406,380,238,1024,2181
10,418,370,265,1053,2181
11,419,394,283,1096,2181
1,500,200,50,750,2182
2,451,233,110,794,2182
3,413,250,146,809,2182
4,416,297,161,874,2182
5,407,314,180,901,2182
6,429,345,203,977,2182
7,398,352,216,966,2182
8,386,384,224,994,2182
9,400,394,237,1031,2182
10,414,380,276,1070,2182
11,400,389,277,1066,2182
1,500,200,50,750,2183
2,455,218,119,792,2183
3,434,240,149,823,2183
4,395,271,181,847,2183
5,403,297,203,903,2183
6,408,334,226,968,2183
7,394,345,231,970,2183
8,397,375,239,1011,2183
9,391,378,253,1022,2183
10,391,379,271,1041,2183
11,389,401,284,1074,2183
1,500,200,50,750,2184
2,441,245,97,783,2184
3,433,267,144,844,2184
4,405,288,176,869,2184
5,397,308,199,904,2184
6,411,331,207,949,2184
7,419,343,230,992,2184
8,372,379,248,999,2184
9,392,376,262,1030,2184
10,402,395,275,1072,2184
11,384,400,295,1079,2184
1,500,200,50,750,2185
2,467,217,108,792,2185
3,435,257,139,831,2185
4,436,261,182,879,2185
5,417,300,187,904,2185
6,422,301,211,934,2185
7,431,352,213,996,2185
8,412,358,225,995,2185
9,423,397,217,1037,2185
10,425,416,219,1060,2185
11,413,406,269,1088,2185
1,500,200,50,750,2186
2,456,237,102,795,2186
3,420,276,131,827,2186
4,380,303,161,844,2186
5,410,309,185,904,2186
6,414,332,207,953,2186
7,405,351,215,971,2186
8,397,353,259,1009,2186
9,403,367,265,1035,2186
10,409,383,275,1067,2186
11,401,390,290,1081,2186
1,500,200,50,750,2187
2,461,229,110,800,2187
3,436,273,123,832,2187
4,415,299,143,857,2187
5,426,322,172,920,2187
6,415,352,191,958,2187
7,413,368,195,976,2187
8,427,374,199,1000,2187
9,419,393,213,1025,2187
10,415,417,231,1063,2187
11,418,409,256,1083,2187
1,500,200,50,750,2188
2,470,232,91,793,2188
3,431,261,136,828,2188
4,395,317,154,866,2188
5,390,343,190,923,2188
6,386,349,236,971,2188
7,381,354,248,983,2188
8,385,370,265,1020,2188
9,373,374,265,1012,2188
10,405,368,285,1058,2188
11,413,376,299,1088,2188
1,500,200,50,750,2189
2,458,248,95,801,2189
3,411,268,144,823,2189
4,410,293,171,874,2189
5,399,319,202,920,2189
6,398,342,213,953,2189
7,384,362,234,980,2189
8,371,353,266,990,2189
9,379,386,272,1037,2189
10,380,411,272,1063,2189
11,380,434,272,1086,2189
1,500,200,50,750,2190
2,454,235,100,789,2190
3,409,258,150,817,2190
4,409,274,179,862,2190
5,389,318,206,913,2190
6,375,325,240,940,2190
7,372,370,232,974,2190
8,381,375,247,1003,2190
9,366,399,263,1028,2190
10,375,422,259,1056,2190
11,376,427,283,1086,2190
1,500,200,50,750,2191
2,453,255,92,800,2191
3,418,282,123,823,2191
4,406,287,166,859,2191
5,400,317,196,913,2191
6,410,361,208,979,2191
7,401,361,224,986,2191
8,386,368,251,1005,2191
9,369,400,255,1024,2191
10,395,419,248,1062,2191
11,400,429,256,1085,2191
1,500,200,50,750,2192
2,472,223,99,794,2192
3,433,255,137,825,2192
4,421,282,157,860,2192
5,415,302,191,908,2192
6,420,346,211,977,2192
7,382,348,244,974,2192
8,395,356,246,997,2192
9,385,368,269,1022,2192
10,382,381,281,1044,2192
11,402,411,276,1089,2192
1,500,200,50,750,2193
2,456,219,107,782,2193
3,431,268,125,824,2193
4,420,288,165,873,2193
5,429,303,175,907,2193
6,429,328,212,969,2193
7,404,349,225,978,2193
8,418,375,238,1031,2193
9,408,385,242,1035,2193
10,410,413,244,1067,2193
11,399,419,271,1089,2193
1,500,200,50,750,2194
2,446,242,96,784,2194
3,450,266,136,852,2194
4,416,278,170,864,2194
5,431,285,202,918,2194
6,437,297,233,967,2194
7,418,328,234,980,2194
8,405,341,259,1005,2194
9,395,374,250,1019,2194
10,414,403,245,1062,2194
11,406,413,256,1075,2194
1,500,200,50,750,2195
2,479,193,108,780,2195
3,437,256,140,833,2195
4,423,280,163,866,2195
5,414,307,194,915,2195
6,396,335,214,945,2195
7,382,370,213,965,2195
8,384,376,250,1010,2195
9,380,367,284,1031,2195
10,386,377,288,1051,2195
11,395,421,265,1081,2195
1,500,200,50,750,2196
2,482,212,96,790,2196
3,431,250,150,831,2196
4,423,264,183,870,2196
5,392,314,197,903,2196
6,401,348,210,959,2196
7,389,367,221,977,2196
8,395,383,243,1021,2196
9,384,380,257,1021,2196
10,431,388,255,1074,2196
11,442,373,274,1089,2196
1,500,200,50,750,2197
2,466,232,92,790,2197
3,419,257,154,830,2197
4,386,276,201,863,2197
5,390,326,194,910,2197
6,401,332,235,968,2197
7,395,350,250,995,2197
8,392,367,250,1009,2197
9,366,391,256,1013,2197
10,393,419,255,1067,2197
11,396,413,272,1081,2197
1,500,200,50,750,2198
2,458,258,88,804,2198
3,414,280,132,826,2198
4,419,281,167,867,2198
5,406,305,195,906,2198
6,396,330,224,950,2198
7,396,348,250,994,2198
8,384,369,256,1009,2198
9,373,386,277,1036,2198
10,371,396,291,1058,2198
11,380,413,296,1089,2198
1,500,200,50,750,2199
2,453,232,100,785,2199
3,424,260,125,809,2199
4,428,302,152,882,2199
5,392,319,190,901,2199
6,395,344,217,956,2199
7,387,362,239,988,2199
8,393,386,230,1009,2199
9,371,392,254,1017,2199
10,381,396,281,1058,2199
11,392,405,293,1090,2199
1,500,200,50,750,2200
2,440,239,106,785,2200
3,423,265,137,825,2200
4,411,297,158,866,2200
5,428,297,197,922,2200
6,401,346,219,966,2200
7,386,357,233,976,2200
8,384,363,252,999,2200
9,399,362,280,1041,2200
10,388,380,292,1060,2200
11,382,425,277,1084,2200
1,500,200,50,750,2201
2,452,223,102,777,2201
3,445,246,136,827,2201
4,428,288,153,869,2201
5,378,326,192,896,2201
6,409,360,199,968,2201
7,392,355,237,984,2201
8,383,366,257,1006,2201
9,413,371,261,1045,2201
10,399,405,255,1059,2201
11,421,408,275,1104,2201
1,500,200,50,750,2202
2,475,229,95,799,2202
3,424,278,127,829,2202
4,412,306,134,852,2202
5,420,317,167,904,2202
6,427,337,192,956,2202
7,406,350,222,978,2202
8,433,357,238,1028,2202
9,424,369,242,1035,2202
10,436,376,274,1086,2202
11,419,388,278,1085,2202
1,500,200,50,750,2203
2,444,239,103,786,2203
3,425,269,132,826,2203
4,419,295,154,868,2203
5,416,313,189,918,2203
6,415,349,192,956,2203
7,420,354,214,988,2203
8,412,371,218,1001,2203
9,436,396,236,1068,2203
10,398,411,253,1062,2203
11,393,438,251,1082,2203
1,500,200,50,750,2204
2,443,245,89,777,2204
3,444,277,121,842,2204
4,402,300,147,849,2204
5,392,342,182,916,2204
6,396,349,216,961,2204
7,398,344,238,980,2204
8,391,388,237,1016,2204
9,375,387,253,1015,2204
10,377,392,277,1046,2204
11,354,416,300,1070,2204
1,500,200,50,750,2205
2,449,247,92,788,2205
3,422,257,152,831,2205
4,398,290,182,870,2205
5,424,322,195,941,2205
6,417,349,204,970,2205
7,402,342,248,992,2205
8,396,343,262,1001,2205
9,389,380,266,1035,2205
10,388,405,282,1075,2205
11,402,398,288,1088,2205
1,500,200,50,750,2206
2,468,219,113,800,2206
3,439,248,132,819,2206
4,424,290,160,874,2206
5,421,314,187,922,2206
6,413,336,212,961,2206
7,390,350,232,972,2206
8,385,363,258,1006,2206
9,387,388,254,1029,2206
10,397,409,272,1078,2206
11,396,406,285,1087,2206
1,500,200,50,750,2207
2,455,244,87,786,2207
3,440,271,131,842,2207
4,407,304,149,860,2207
5,398,301,200,899,2207
6,400,325,204,929,2207
7,393,336,249,978,2207
8,409,342,263,1014,2207
9,415,332,286,1033,2207
10,418,371,277,1066,2207
11,409,399,283,1091,2207
1,500,200,50,750,2208
2,449,234,108,791,2208
3,415,273,148,836,2208
4,377,311,175,863,2208
5,393,319,187,899,2208
6,400,331,223,954,2208
7,405,341,230,976,2208
8,392,388,223,1003,2208
9,388,395,235,1018,2208
10,407,398,251,1056,2208
11,390,395,278,1063,2208
1,500,200,50,750,2209
2,477,219,94,790,2209
3,455,277,105,837,2209
4,419,297,144,860,2209
5,407,310,174,891,2209
6,432,344,186,962,2209
7,410,371,204,985,2209
8,409,371,220,1000,2209
9,416,369,252,1037,2209
10,406,402,254,1062,2209
11,419,412,254,1085,2209
1,500,200,50,750,2210
2,464,223,100,787,2210
3,442,252,131,825,2210
4,411,305,148,864,2210
5,402,309,186,897,2210
6,399,332,219,950,2210
7,375,346,252,973,2210
8,387,367,261,1015,2210
9,390,364,266,1020,2210
10,396,362,298,1056,2210
11,407,399,280,1086,2210
1,500,200,50,750,2211
2,467,228,98,793,2211
3,439,258,142,839,2211
4,417,287,169,873,2211
5,413,324,185,922,2211
6,395,343,221,959,2211
7,403,355,218,976,2211
8,404,385,228,1017,2211
9,394,383,245,1022,2211
10,387,419,239,1045,2211
11,400,410,267,1077,2211
1,500,200,50,750,2212
2,475,228,92,795,2212
3,431,260,144,835,2212
4,425,273,165,863,2212
5,431,288,190,909,2212
6,431,325,210,966,2212
7,406,353,235,994,2212
8,384,379,231,994,2212
9,409,382,253,1044,2212
10,404,391,262,1057,2212
11,427,385,275,1087,2212
1,500,200,50,750,2213
2,456,243,91,790,2213
3,426,259,138,823,2213
4,426,286,160,872,2213
5,416,299,180,895,2213
6,402,340,207,949,2213
7,401,367,222,990,2213
8,415,365,239,1019,2213
9,394,375,258,1027,2213
10,402,368,276,1046,2213
11,414,371,288,1073,2213
1,500,200,50,750,2214
2,454,239,89,782,2214
3,422,281,126,829,2214
4,401,302,161,864,2214
5,409,304,198,911,2214
6,393,317,222,932,2214
7,396,366,223,985,2214
8,395,376,247,1018,2214
9,387,379,261,1027,2214
10,387,395,276,1058,2214
11,389,415,271,1075,2214
1,500,200,50,750,2215
2,460,219,101,780,2215
3,457,243,133,833,2215
4,414,278,167,859,2215
5,435,292,170,897,2215
6,431,309,202,942,2215
7,427,335,219,981,2215
8,406,334,251,991,2215
9,404,369,244,1017,2215
10,403,401,258,1062,2215
11,389,422,277,1088,2215
1,500,200,50,750,2216
2,457,248,91,796,2216
3,412,257,148,817,2216
4,393,281,189,863,2216
5,405,311,192,908,2216
6,415,316,232,963,2216
7,427,334,239,1000,2216
8,404,352,248,1004,2216
9,399,345,268,1012,2216
10,408,410,258,1076,2216
11,410,404,258,1072,2216
1,500,200,50,750,2217
2,446,240,102,788,2217
3,409,265,151,825,2217
4,408,290,179,877,2217
5,409,309,186,904,2217
6,402,341,217,960,2217
7,401,332,230,963,2217
8,374,369,258,1001,2217
9,395,409,251,1055,2217
10,391,407,266,1064,2217
11,397,396,279,1072,2217
1,500,200,50,750,2218
2,451,227,99,777,2218
3,415,247,146,808,2218
4,418,275,168,861,2218
5,408,311,206,925,2218
6,382,346,220,948,2218
7,402,359,236,997,2218
8,372,375,256,1003,2218
9,376,372,274,1022,2218
10,392,412,270,1074,2218
11,397,394,279,1070,2218
1,500,200,50,750,2219
2,447,235,109,791,2219
3,430,238,142,810,2219
4,403,268,181,852,2219
5,412,299,202,913,2219
6,420,342,212,974,2219
7,386,358,232,976,2219
8,386,361,262,1009,2219
9,383,372,281,1036,2219
10,385,390,270,1045,2219
11,398,421,292,1111,2219
1,500,200,50,750,2220
2,468,221,103,792,2220
3,429,266,136,831,2220
4,425,265,180,870,2220
5,431,305,187,923,2220
6,426,330,198,954,2220
7,400,353,216,969,2220
8,407,375,244,1026,2220
9,397,399,248,1044,2220
10,375,410,264,1049,2220
11,396,416,288,1100,2220
1,500,200,50,750,2221
2,445,250,93,788,2221
3,443,261,132,836,2221
4,423,297,160,880,2221
5,397,305,198,900,2221
6,409,338,208,955,2221
7,397,343,233,973,2221
8,401,356,252,1009,2221
9,388,362,273,1023,2221
10,388,378,284,1050,2221
11,411,399,290,1100,2221
1,500,200,50,750,2222
2,460,225,101,786,2222
3,431,265,122,818,2222
4,424,276,168,868,2222
5,421,299,197,917,2222
6,398,319,228,945,2222
7,390,349,236,975,2222
8,389,363,241,993,2222
9,392,369,256,1017,2222
10,401,391,271,1063,2222
11,405,409,287,1101,2222
1,500,200,50,750,2223
2,448,242,91,781,2223
3,439,239,135,813,2223
4,429,276,171,876,2223
5,396,319,202,917,2223
6,403,333,212,948,2223
7,405,337,241,983,2223
8,401,346,244,991,2223
9,401,381,239,1021,2223
10,407,395,251,1053,2223
11,420,401,271,1092,2223
1,500,200,50,750,2224
2,480,222,98,800,2224
3,440,257,136,833,2224
4,401,294,167,862,2224
5,411,324,196,931,2224
6,411,338,207,956,2224
7,395,345,240,980,2224
8,397,359,264,1020,2224
9,383,352,295,1030,2224
10,395,364,294,1053,2224
11,404,407,276,1087,2224
1,500,200,50,750,2225
2,466,231,92,789,2225
3,458,251,121,830,2225
4,428,262,163,853,2225
5,419,308,180,907,2225
6,428,335,206,969,2225
7,395,343,241,979,2225
8,384,359,264,1007,2225
9,378,378,273,1029,2225
10,366,378,295,1039,2225
11,369,415,292,1076,2225
1,500,200,50,750,2226
2,459,230,95,784,2226
3,427,251,151,829,2226
4,411,267,180,858,2226
5,415,304,195,914,2226
6,421,340,213,974,2226
7,391,355,240,986,2226
8,393,361,257,1011,2226
9,389,386,247,1022,2226
10,396,382,273,1051,2226
11,391,374,295,1060,2226
1,500,200,50,750,2227
2,458,230,107,795,2227
3,425,281,134,840,2227
4,411,301,161,873,2227
5,399,315,195,909,2227
6,431,334,194,959,2227
7,420,357,216,993,2227
8,421,376,216,1013,2227
9,394,408,225,1027,2227
10,403,407,244,1054,2227
11,423,424,254,1101,2227
1,500,200,50,750,2228
2,441,231,102,774,2228
3,433,250,142,825,2228
4,399,281,184,864,2228
5,397,296,215,908,2228
6,413,338,219,970,2228
7,391,366,229,986,2228
8,385,381,244,1010,2228
9,391,379,264,1034,2228
10,400,383,274,1057,2228
11,399,407,272,1078,2228
1,500,200,50,750,2229
2,464,225,104,793,2229
3,415,271,136,822,2229
4,394,312,170,876,2229
5,378,321,190,889,2229
6,393,347,186,926,2229
7,390,340,239,969,2229
8,398,356,255,1009,2229
9,370,375,265,1010,2229
10,375,404,263,1042,2229
11,422,416,255,1093,2229
1,500,200,50,750,2230
2,454,235,101,790,2230
3,410,273,139,822,2230
4,437,285,168,890,2230
5,421,292,201,914,2230
6,400,351,212,963,2230
7,390,349,235,974,2230
8,413,360,250,1023,2230
9,406,368,257,1031,2230
10,389,385,283,1057,2230
11,384,391,294,1069,2230
1,500,200,50,750,2231
2,477,229,88,794,2231
3,444,263,126,833,2231
4,408,310,162,880,2231
5,400,329,183,912,2231
6,412,347,206,965,2231
7,388,363,228,979,2231
8,406,341,254,1001,2231
9,399,353,262,1014,2231
10,425,381,262,1068,2231
11,400,386,289,1075,2231
1,500,200,50,750,2232
2,455,219,104,778,2232
3,431,264,145,840,2232
4,389,291,172,852,2232
5,382,333,192,907,2232
6,399,341,225,965,2232
7,381,356,239,976,2232
8,374,370,263,1007,2232
9,385,365,284,1034,2232
10,389,378,282,1049,2232
11,390,397,286,1073,2232
1,500,200,50,750,2233
2,472,238,85,795,2233
3,441,271,116,828,2233
4,414,301,163,878,2233
5,397,317,188,902,2233
6,411,328,218,957,2233
7,398,346,245,989,2233
8,393,366,251,1010,2233
9,400,377,255,1032,2233
10,407,389,256,1052,2233
11,387,405,281,1073,2233
1,500,200,50,750,2234
2,453,229,110,792,2234
3,423,273,142,838,2234
4,412,285,177,874,2234
5,387,302,213,902,2234
6,404,317,250,971,2234
7,396,343,250,989,2234
8,387,368,254,1009,2234
9,411,379,259,1049,2234
10,395,393,268,1056,2234
11,385,416,292,1093,2234
1,500,200,50,750,2235
2,452,216,111,779,2235
3,420,267,131,818,2235
4,399,295,161,855,2235
5,398,322,185,905,2235
6,408,333,214,955,2235
7,404,353,228,985,2235
8,401,365,237,1003,2235
9,388,398,246,1032,2235
10,418,375,268,1061,2235
11,411,393,276,1080,2235
1,500,200,50,750,2236
2,452,242,83,777,2236
3,439,255,128,822,2236
4,428,274,163,865,2236
5,442,290,181,913,2236
6,431,318,199,948,2236
7,400,334,231,965,2236
8,404,356,248,1008,2236
9,409,359,249,1017,2236
10,382,384,275,1041,2236
11,403,383,286,1072,2236
1,500,200,50,750,2237
2,464,221,105,790,2237
3,431,273,134,838,2237
4,411,273,179,863,2237
5,406,305,198,909,2237
6,404,344,213,961,2237
7,391,346,238,975,2237
8,376,361,260,997,2237
9,378,387,257,1022,2237
10,393,399,263,1055,2237
11,394,400,273,1067,2237
1,500,200,50,750,2238
2,436,243,106,785,2238
3,415,262,156,833,2238
4,394,302,171,867,2238
5,383,334,182,899,2238
6,386,342,213,941,2238
7,410,350,232,992,2238
8,405,364,246,1015,2238
9,399,377,262,1038,2238
10,407,384,261,1052,2238
11,413,399,271,1083,2238
1,500,200,50,750,2239
2,444,240,99,783,2239
3,427,261,144,832,2239
4,391,305,165,861,2239
5,411,317,203,931,2239
6,403,335,218,956,2239
7,397,359,232,988,2239
8,387,361,249,997,2239
9,394,380,243,1017,2239
10,408,393,260,1061,2239
11,399,403,278,1080,2239
1,500,200,50,750,2240
2,449,247,94,790,2240
3,418,279,127,824,2240
4,410,303,160,873,2240
5,420,309,191,920,2240
6,403,325,218,946,2240
7,397,363,224,984,2240
8,401,351,256,1008,2240
9,387,381,250,1018,2240
10,375,378,276,1029,2240
11,404,407,262,1073,2240
1,500,200,50,750,2241
2,462,239,93,794,2241
3,418,276,132,826,2241
4,423,293,153,869,2241
5,411,316,200,927,2241
6,405,328,232,965,2241
7,383,377,232,992,2241
8,373,407,229,1009,2241
9,382,394,259,1035,2241
10,388,385,286,1059,2241
11,376,396,304,1076,2241
1,500,200,50,750,2242
2,480,228,87,795,2242
3,428,261,116,805,2242
4,439,276,152,867,2242
5,405,327,180,912,2242
6,410,344,192,946,2242
7,400,361,222,983,2242
8,415,371,232,1018,2242
9,392,384,256,1032,2242
10,396,385,267,1048,2242
11,414,384,276,1074,2242
1,500,200,50,750,2243
2,447,244,94,785,2243
3,427,269,124,820,2243
4,416,273,156,845,2243
5,412,309,183,904,2243
6,430,334,214,978,2243
7,405,357,226,988,2243
8,399,350,245,994,2243
9,398,375,262,1035,2243
10,414,400,266,1080,2243
11,384,419,266,1069,2243
1,500,200,50,750,2244
2,461,234,95,790,2244
3,424,269,130,823,2244
4,386,301,173,860,2244
5,389,330,194,913,2244
6,378,359,214,951,2244
7,381,367,239,987,2244
8,351,387,264,1002,2244
9,350,390,276,1016,2244
10,362,400,287,1049,2244
11,370,419,287,1076,2244
1,500,200,50,750,2245
2,460,227,106,793,2245
3,411,280,131,822,2245
4,400,293,171,864,2245
5,403,316,197,916,2245
6,409,333,219,961,2245
7,427,347,222,996,2245
8,425,346,244,1015,2245
9,399,385,241,1025,2245
10,395,398,262,1055,2245
11,410,406,258,1074,2245
1,500,200,50,750,2246
2,465,217,94,776,2246
3,432,260,154,846,2246
4,417,281,184,882,2246
5,430,282,203,915,2246
6,425,326,221,972,2246
7,405,336,224,965,2246
8,392,358,228,978,2246
9,405,383,249,1037,2246
10,392,403,265,1060,2246
11,402,414,267,1083,2246
1,500,200,50,750,2247
2,455,222,113,790,2247
3,422,242,149,813,2247
4,416,270,176,862,2247
5,403,318,181,902,2247
6,398,342,216,956,2247
7,391,357,228,976,2247
8,391,367,247,1005,2247
9,392,409,231,1032,2247
10,380,428,239,1047,2247
11,368,413,283,1064,2247
1,500,200,50,750,2248
2,455,231,96,782,2248
3,423,250,146,819,2248
4,416,282,171,869,2248
5,409,304,202,915,2248
6,405,328,228,961,2248
7,389,351,241,981,2248
8,378,359,256,993,2248
9,382,384,253,1019,2248
10,375,407,276,1058,2248
11,382,415,294,1091,2248
1,500,200,50,750,2249
2,462,234,89,785,2249
3,462,260,116,838,2249
4,410,273,161,844,2249
5,408,316,181,905,2249
6,406,319,226,951,2249
7,410,341,220,971,2249
8,438,363,221,1022,2249
9,430,356,245,1031,2249
10,411,370,272,1053,2249
11,402,395,287,1084,2249
1,500,200,50,750,2250
2,481,221,83,785,2250
3,446,244,117,807,2250
4,439,274,155,868,2250
5,430,296,180,906,2250
6,425,331,195,951,2250
7,417,347,225,989,2250
8,394,365,253,1012,2250
9,381,371,272,1024,2250
10,388,411,265,1064,2250
11,397,386,290,1073,2250
1,500,200,50,750,2251
2,444,236,101,781,2251
3,429,260,141,830,2251
4,429,270,177,876,2251
5,405,280,209,894,2251
6,426,318,207,951,2251
7,449,311,222,982,2251
8,443,334,229,1006,2251
9,440,375,232,1047,2251
10,429,376,244,1049,2251
11,416,401,260,1077,2251
1,500,200,50,750,2252
2,466,218,100,784,2252
3,432,266,137,835,2252
4,400,315,150,865,2252
5,391,349,174,914,2252
6,398,356,207,961,2252
7,404,356,220,980,2252
8,399,376,245,1020,2252
9,388,397,233,1018,2252
10,384,385,279,1048,2252
11,397,405,277,1079,2252
1,500,200,50,750,2253
2,454,244,95,793,2253
3,434,260,126,820,2253
4,429,299,147,875,2253
5,416,304,189,909,2253
6,415,328,212,955,2253
7,397,379,200,976,2253
8,400,381,228,1009,2253
9,392,400,224,1016,2253
10,410,398,250,1058,2253
11,405,410,271,1086,2253
1,500,200,50,750,2254
2,454,226,107,787,2254
3,448,264,132,844,2254
4,420,273,175,868,2254
5,399,298,193,890,2254
6,403,364,193,960,2254
7,377,400,207,984,2254
8,393,385,237,1015,2254
9,387,387,248,1022,2254
10,403,397,242,1042,2254
11,395,405,276,1076,2254
1,500,200,50,750,2255
2,458,232,105,795,2255
3,418,269,141,828,2255
4,420,287,156,863,2255
5,408,322,178,908,2255
6,413,344,200,957,2255
7,409,360,205,974,2255
8,430,362,220,1012,2255
9,420,370,241,1031,2255
10,422,397,231,1050,2255
11,422,398,260,1080,2255
1,500,200,50,750,2256
2,441,247,92,780,2256
3,418,275,127,820,2256
4,414,303,153,870,2256
5,404,311,197,912,2256
6,408,333,214,955,2256
7,429,341,221,991,2256
8,426,361,216,1003,2256
9,427,375,245,1047,2256
10,413,381,259,1053,2256
11,433,404,254,1091,2256
1,500,200,50,750,2257
2,475,215,90,780,2257
3,444,256,126,826,2257
4,452,284,137,873,2257
5,434,304,160,898,2257
6,437,319,212,968,2257
7,398,337,248,983,2257
8,389,365,258,1012,2257
9,378,395,256,1029,2257
10,385,404,270,1059,2257
11,395,412,294,1101,2257
1,500,200,50,750,2258
2,458,244,86,788,2258
3,422,268,133,823,2258
4,403,300,150,853,2258
5,391,328,174,893,2258
6,412,349,184,945,2258
7,401,358,219,978,2258
8,390,377,229,996,2258
9,410,375,239,1024,2258
10,411,418,243,1072,2258
11,419,421,247,1087,2258
1,500,200,50,750,2259
2,452,233,90,775,2259
3,460,261,120,841,2259
4,436,282,147,865,2259
5,415,319,180,914,2259
6,405,354,208,967,2259
7,395,368,210,973,2259
8,388,366,236,990,2259
9,409,392,241,1042,2259
10,397,397,254,1048,2259
11,418,417,253,1088,2259
1,500,200,50,750,2260
2,444,241,113,798,2260
3,395,276,156,827,2260
4,396,312,163,871,2260
5,421,324,174,919,2260
6,394,340,193,927,2260
7,400,360,219,979,2260
8,394,392,215,1001,2260
9,402,402,235,1039,2260
10,400,403,261,1064,2260
11,389,401,268,1058,2260
1,500,200,50,750,2261
2,463,226,95,784,2261
3,439,248,133,820,2261
4,411,287,156,854,2261
5,416,305,181,902,2261
6,396,322,221,939,2261
7,404,321,255,980,2261
8,387,361,269,1017,2261
9,378,369,267,1014,2261
10,384,400,283,1067,2261
11,393,415,279,1087,2261
1,500,200,50,750,2262
2,464,229,94,787,2262
3,425,264,141,830,2262
4,407,296,168,871,2262
5,410,318,193,921,2262
6,428,349,187,964,2262
7,409,346,222,977,2262
8,413,376,220,1009,2262
9,406,379,243,1028,2262
10,383,393,251,1027,2262
11,428,421,250,1099,2262
1,500,200,50,750,2263
2,444,244,97,785,2263
3,427,274,134,835,2263
4,411,283,161,855,2263
5,412,314,196,922,2263
6,403,348,216,967,2263
7,387,370,222,979,2263
8,389,371,237,997,2263
9,388,408,261,1057,2263
10,377,413,259,1049,2263
11,369,427,272,1068,2263
1,500,200,50,750,2264
2,466,239,87,792,2264
3,444,264,126,834,2264
4,423,270,174,867,2264
5,401,280,196,877,2264
6,423,313,229,965,2264
7,419,326,236,981,2264
8,396,366,242,1004,2264
9,378,391,255,1024,2264
10,389,417,266,1072,2264
11,380,444,266,1090,2264
1,500,200,50,750,2265
2,456,236,92,784,2265
3,431,274,120,825,2265
4,431,291,153,875,2265
5,427,298,191,916,2265
6,413,316,214,943,2265
7,411,325,228,964,2265
8,405,355,241,1001,2265
9,406,384,232,1022,2265
10,411,381,256,1048,2265
11,425,395,264,1084,2265
1,500,200,50,750,2266
2,440,228,102,770,2266
3,414,283,137,834,2266
4,406,289,164,859,2266
5,411,302,190,903,2266
6,404,328,222,954,2266
7,387,359,235,981,2266
8,392,376,240,1008,2266
9,385,380,253,1018,2266
10,417,392,271,1080,2266
11,401,411,270,1082,2266
1,500,200,50,750,2267
2,463,233,92,788,2267
3,456,252,125,833,2267
4,403,289,165,857,2267
5,395,334,173,902,2267
6,413,350,198,961,2267
7,407,321,238,966,2267
8,409,343,258,1010,2267
9,394,396,250,1040,2267
10,368,404,274,1046,2267
11,405,409,270,1084,2267
1,500,200,50,750,2268
2,453,248,84,785,2268
3,443,255,145,843,2268
4,417,274,167,858,2268
5,406,324,190,920,2268
6,397,360,192,949,2268
7,399,355,211,965,2268
8,422,343,241,1006,2268
9,414,388,246,1048,2268
10,386,386,281,1053,2268
11,416,398,282,1096,2268
1,500,200,50,750,2269
2,447,240,93,780,2269
3,418,271,144,833,2269
4,391,276,190,857,2269
5,388,310,206,904,2269
6,403,307,236,946,2269
7,379,328,248,955,2269
8,414,351,264,1029,2269
9,381,371,263,1015,2269
10,390,416,253,1059,2269
11,396,425,272,1093,2269
1,500,200,50,750,2270
2,446,228,107,781,2270
3,430,253,138,821,2270
4,432,261,168,861,2270
5,413,302,184,899,2270
6,426,342,201,969,2270
7,410,346,217,973,2270
8,397,354,225,976,2270
9,405,374,263,1042,2270
10,409,382,269,1060,2270
11,409,387,288,1084,2270
1,500,200,50,750,2271
2,453,232,92,777,2271
3,427,266,122,815,2271
4,408,294,150,852,2271
5,419,323,200,942,2271
6,393,342,218,953,2271
7,395,373,224,992,2271
8,387,371,229,987,2271
9,410,387,244,1041,2271
10,382,386,273,1041,2271
11,391,386,294,1071,2271
1,500,200,50,750,2272
2,458,224,106,788,2272
3,431,258,145,834,2272
4,410,294,167,871,2272
5,395,314,201,910,2272
6,407,342,209,958,2272
7,391,347,230,968,2272
8,404,383,225,1012,2272
9,393,386,240,1019,2272
10,401,403,247,1051,2272
11,402,439,247,1088,2272
1,500,200,50,750,2273
2,450,235,99,784,2273
3,432,266,130,828,2273
4,407,296,157,860,2273
5,395,330,188,913,2273
6,399,366,206,971,2273
7,382,369,228,979,2273
8,367,376,249,992,2273
9,408,392,272,1072,2273
10,374,382,300,1056,2273
11,369,414,288,1071,2273
1,500,200,50,750,2274
2,460,222,97,779,2274
3,422,254,143,819,2274
4,396,283,185,864,2274
5,392,356,177,925,2274
6,400,373,192,965,2274
7,376,375,231,982,2274
8,360,380,256,996,2274
9,365,389,285,1039,2274
10,379,391,278,1048,2274
11,398,402,282,1082,2274
1,500,200,50,750,2275
2,460,253,79,792,2275
3,442,273,116,831,2275
4,419,278,165,862,2275
5,422,311,183,916,2275
6,427,319,206,952,2275
7,401,356,216,973,2275
8,403,370,220,993,2275
9,423,366,240,1029,2275
10,402,416,248,1066,2275
11,412,424,241,1077,2275
1,500,200,50,750,2276
2,451,213,115,779,2276
3,413,272,148,833,2276
4,398,313,157,868,2276
5,392,339,179,910,2276
6,415,360,203,978,2276
7,380,356,234,970,2276
8,408,391,219,1018,2276
9,373,410,244,1027,2276
10,373,426,274,1073,2276
11,352,434,285,1071,2276
1,500,200,50,750,2277
2,462,226,97,785,2277
3,437,258,134,829,2277
4,415,304,158,877,2277
5,407,328,168,903,2277
6,412,362,190,964,2277
7,392,366,224,982,2277
8,393,378,235,1006,2277
9,396,376,263,1035,2277
10,375,397,278,1050,2277
11,403,414,272,1089,2277
1,500,200,50,750,2278
2,445,243,104,792,2278
3,414,255,158,827,2278
4,404,290,177,871,2278
5,408,307,195,910,2278
6,415,336,204,955,2278
7,416,333,241,990,2278
8,409,349,257,1015,2278
9,419,366,255,1040,2278
10,392,371,295,1058,2278
11,417,394,273,1084,2278
1,500,200,50,750,2279
2,455,235,93,783,2279
3,433,268,133,834,2279
4,408,284,162,854,2279
5,412,304,198,914,2279
6,422,330,210,962,2279
7,411,365,213,989,2279
8,401,390,211,1002,2279
9,401,361,262,1024,2279
10,399,369,275,1043,2279
11,392,417,275,1084,2279
1,500,200,50,750,2280
2,453,243,94,790,2280
3,421,263,139,823,2280
4,431,288,167,886,2280
5,401,292,205,898,2280
6,412,324,232,968,2280
7,389,344,248,981,2280
8,376,371,262,1009,2280
9,386,372,283,1041,2280
10,393,414,274,1081,2280
11,375,415,291,1081,2280
1,500,200,50,750,2281
2,447,231,106,784,2281
3,431,238,151,820,2281
4,410,262,197,869,2281
5,411,293,209,913,2281
6,403,322,222,947,2281
7,378,360,232,970,2281
8,385,369,258,1012,2281
9,379,366,291,1036,2281
10,396,413,265,1074,2281
11,399,419,268,1086,2281
1,500,200,50,750,2282
2,446,223,110,779,2282
3,409,270,149,828,2282
4,390,291,173,854,2282
5,403,317,190,910,2282
6,402,360,196,958,2282
7,382,375,220,977,2282
8,391,352,253,996,2282
9,393,357,263,1013,2282
10,397,391,284,1072,2282
11,384,408,283,1075,2282
1,500,200,50,750,2283
2,448,242,97,787,2283
3,443,248,147,838,2283
4,419,277,174,870,2283
5,403,296,199,898,2283
6,424,320,221,965,2283
7,405,348,234,987,2283
8,408,340,256,1004,2283
9,383,357,276,1016,2283
10,409,384,272,1065,2283
11,387,400,276,1063,2283
1,500,200,50,750,2284
2,455,242,88,785,2284
3,420,272,135,827,2284
4,415,279,173,867,2284
5,413,307,190,910,2284
6,408,347,204,959,2284
7,413,354,211,978,2284
8,407,372,239,1018,2284
9,401,352,262,1015,2284
10,410,391,270,1071,2284
11,383,390,297,1070,2284
1,500,200,50,750,2285
2,459,243,88,790,2285
3,417,272,128,817,2285
4,432,295,149,876,2285
5,410,329,176,915,2285
6,390,368,191,949,2285
7,377,368,226,971,2285
8,357,391,239,987,2285
9,372,410,252,1034,2285
10,404,406,261,1071,2285
11,405,403,283,1091,2285
1,500,200,50,750,2286
2,462,236,89,787,2286
3,434,262,126,822,2286
4,423,298,163,884,2286
5,412,321,205,938,2286
6,398,333,223,954,2286
7,374,376,222,972,2286
8,375,396,232,1003,2286
9,382,383,249,1014,2286
10,395,384,274,1053,2286
11,388,410,258,1056,2286
1,500,200,50,750,2287
2,448,218,111,777,2287
3,434,273,127,834,2287
4,411,311,157,879,2287
5,400,308,188,896,2287
6,397,336,220,953,2287
7,402,353,234,989,2287
8,409,364,246,1019,2287
9,411,369,245,1025,2287
10,401,410,253,1064,2287
11,406,408,272,1086,2287
1,500,200,50,750,2288
2,459,222,101,782,2288
3,457,253,130,840,2288
4,429,291,146,866,2288
5,416,315,186,917,2288
6,401,333,222,956,2288
7,397,350,235,982,2288
8,378,362,251,991,2288
9,389,367,263,1019,2288
10,390,377,282,1049,2288
11,407,403,272,1082,2288
1,500,200,50,750,2289
2,469,229,99,797,2289
3,446,252,138,836,2289
4,414,286,168,868,2289
5,420,306,195,921,2289
6,389,346,206,941,2289
7,401,340,236,977,2289
8,375,379,246,1000,2289
9,386,392,252,1030,2289
10,398,409,253,1060,2289
11,402,402,280,1084,2289
1,500,200,50,750,2290
2,462,234,107,803,2290
3,421,249,154,824,2290
4,426,275,171,872,2290
5,425,318,179,922,2290
6,428,332,193,953,2290
7,425,338,220,983,2290
8,427,349,221,997,2290
9,407,394,228,1029,2290
10,410,394,256,1060,2290
11,408,422,260,1090,2290
1,500,200,50,750,2291
2,478,218,96,792,2291
3,447,238,137,822,2291
4,421,253,189,863,2291
5,411,293,205,909,2291
6,404,335,213,952,2291
7,408,364,224,996,2291
8,378,395,235,1008,2291
9,377,383,262,1022,2291
10,383,392,298,1073,2291
11,371,407,293,1071,2291
1,500,200,50,750,2292
2,432,242,105,779,2292
3,417,289,133,839,2292
4,412,302,157,871,2292
5,413,328,180,921,2292
6,407,356,213,976,2292
7,400,361,214,975,2292
8,403,363,229,995,2292
9,401,376,244,1021,2292
10,419,390,247,1056,2292
11,419,395,265,1079,2292
1,500,200,50,750,2293
2,459,222,106,787,2293
3,432,241,151,824,2293
4,434,245,190,869,2293
5,406,299,191,896,2293
6,422,345,206,973,2293
7,421,337,224,982,2293
8,384,369,243,996,2293
9,378,387,258,1023,2293
10,391,402,267,1060,2293
11,415,395,287,1097,2293
1,500,200,50,750,2294
2,468,223,99,790,2294
3,432,260,127,819,2294
4,432,278,154,864,2294
5,421,306,178,905,2294
6,412,326,201,939,2294
7,421,347,223,991,2294
8,408,348,252,1008,2294
9,406,364,262,1032,2294
10,401,407,252,1060,2294
11,392,424,291,1107,2294
1,500,200,50,750,2295
2,446,233,97,776,2295
3,428,273,119,820,2295
4,426,285,158,869,2295
5,404,295,202,901,2295
6,391,331,221,943,2295
7,379,385,228,992,2295
8,382,410,228,1020,2295
9,372,407,252,1031,2295
10,383,411,262,1056,2295
11,379,414,287,1080,2295
1,500,200,50,750,2296
2,448,243,88,779,2296
3,428,264,130,822,2296
4,420,283,174,877,2296
5,416,316,180,912,2296
6,393,348,217,958,2296
7,378,367,222,967,2296
8,371,396,241,1008,2296
9,373,415,254,1042,2296
10,363,408,273,1044,2296
11,386,423,284,1093,2296
1,500,200,50,750,2297
2,457,239,92,788,2297
3,433,251,145,829,2297
4,405,290,166,861,2297
5,397,318,197,912,2297
6,385,358,216,959,2297
7,390,371,223,984,2297
8,356,369,271,996,2297
9,372,386,272,1030,2297
10,367,386,299,1052,2297
11,387,395,308,1090,2297
1,500,200,50,750,2298
2,432,258,92,782,2298
3,404,279,131,814,2298
4,397,328,154,879,2298
5,377,326,202,905,2298
6,390,373,216,979,2298
7,396,354,234,984,2298
8,389,365,247,1001,2298
9,415,380,253,1048,2298
10,418,403,250,1071,2298
11,429,402,255,1086,2298
1,500,200,50,750,2299
2,462,219,107,788,2299
3,417,264,127,808,2299
4,418,296,163,877,2299
5,394,310,196,900,2299
6,395,327,230,952,2299
7,368,344,249,961,2299
8,389,366,252,1007,2299
9,408,364,248,1020,2299
10,418,386,256,1060,2299
11,416,385,284,1085,2299
1,500,200,50,750,2300
2,464,222,103,789,2300
3,437,251,130,818,2300
4,424,266,165,855,2300
5,394,325,170,889,2300
6,385,358,197,940,2300
7,421,362,208,991,2300
8,407,379,223,1009,2300
9,395,396,219,1010,2300
10,386,402,256,1044,2300
11,402,407,269,1078,2300
1,500,200,50,750,2301
2,458,230,89,777,2301
3,427,272,124,823,2301
4,398,304,151,853,2301
5,416,329,180,925,2301
6,393,332,229,954,2301
7,398,342,250,990,2301
8,382,347,265,994,2301
9,412,375,248,1035,2301
10,437,390,243,1070,2301
11,428,408,249,1085,2301
1,500,200,50,750,2302
2,474,222,106,802,2302
3,431,271,130,832,2302
4,432,284,154,870,2302
5,430,314,190,934,2302
6,414,360,199,973,2302
7,403,368,217,988,2302
8,395,378,237,1010,2302
9,402,382,251,1035,2302
10,410,402,265,1077,2302
11,406,420,265,1091,2302
1,500,200,50,750,2303
2,466,227,87,780,2303
3,442,263,127,832,2303
4,432,260,169,861,2303
5,410,311,179,900,2303
6,412,328,208,948,2303
7,429,340,231,1000,2303
8,419,346,243,1008,2303
9,404,378,246,1028,2303
10,387,380,271,1038,2303
11,401,406,261,1068,2303
1,500,200,50,750,2304
2,460,224,100,784,2304
3,446,256,117,819,2304
4,408,302,156,866,2304
5,398,311,182,891,2304
6,402,354,192,948,2304
7,383,359,234,976,2304
8,373,370,252,995,2304
9,382,363,279,1024,2304
10,379,402,274,1055,2304
11,396,414,275,1085,2304
1,500,200,50,750,2305
2,482,224,95,801,2305
3,455,241,133,829,2305
4,446,273,167,886,2305
5,422,306,190,918,2305
6,431,334,202,967,2305
7,405,347,224,976,2305
8,443,340,239,1022,2305
9,435,352,244,1031,2305
10,410,384,255,1049,2305
11,432,417,258,1107,2305
1,500,200,50,750,2306
2,439,250,105,794,2306
3,411,280,140,831,2306
4,400,296,167,863,2306
5,382,332,189,903,2306
6,395,345,212,952,2306
7,375,360,234,969,2306
8,410,360,230,1000,2306
9,402,380,260,1042,2306
10,389,414,251,1054,2306
11,387,415,265,1067,2306
1,500,200,50,750,2307
2,463,227,106,796,2307
3,433,265,130,828,2307
4,423,269,172,864,2307
5,414,312,183,909,2307
6,419,329,207,955,2307
7,400,351,231,982,2307
8,385,380,250,1015,2307
9,392,387,263,1042,2307
10,382,392,262,1036,2307
11,399,423,258,1080,2307
1,500,200,50,750,2308
2,466,241,89,796,2308
3,433,248,146,827,2308
4,407,290,171,868,2308
5,425,297,198,920,2308
6,409,332,218,959,2308
7,395,327,257,979,2308
8,398,370,248,1016,2308
9,394,369,272,1035,2308
10,404,378,274,1056,2308
11,409,401,273,1083,2308
1,500,200,50,750,2309
2,452,237,96,785,2309
3,433,267,124,824,2309
4,430,285,155,870,2309
5,425,304,178,907,2309
6,439,322,193,954,2309
7,456,321,214,991,2309
8,420,362,213,995,2309
9,439,380,218,1037,2309
10,407,418,226,1051,2309
11,430,416,240,1086,2309
1,500,200,50,750,2310
2,465,225,92,782,2310
3,444,263,137,844,2310
4,430,263,174,867,2310
5,433,299,185,917,2310
6,434,329,206,969,2310
7,403,364,204,971,2310
8,391,380,223,994,2310
9,401,376,264,1041,2310
10,412,369,286,1067,2310
11,411,389,286,1086,2310
1,500,200,50,750,2311
2,453,222,106,781,2311
3,425,265,136,826,2311
4,412,288,165,865,2311
5,403,324,182,909,2311
6,432,351,199,982,2311
7,394,362,232,988,2311
8,391,370,233,994,2311
9,412,374,246,1032,2311
10,438,399,228,1065,2311
11,427,403,262,1092,2311
1,500,200,50,750,2312
2,436,251,87,774,2312
3,430,278,123,831,2312
4,391,290,162,843,2312
5,387,317,196,900,2312
6,385,331,221,937,2312
7,393,349,224,966,2312
8,396,359,242,997,2312
9,391,402,239,1032,2312
10,380,387,279,1046,2312
11,379,393,308,1080,2312
1,500,200,50,750,2313
2,451,224,105,780,2313
3,452,257,131,840,2313
4,416,273,171,860,2313
5,401,293,214,908,2313
6,407,299,239,945,2313
7,399,331,243,973,2313
8,384,367,260,1011,2313
9,376,381,281,1038,2313
10,387,370,297,1054,2313
11,392,380,305,1077,2313
1,500,200,50,750,2314
2,451,237,86,774,2314
3,432,267,119,818,2314
4,416,309,153,878,2314
5,393,326,184,903,2314
6,381,351,207,939,2314
7,375,360,233,968,2314
8,401,365,252,1018,2314
9,388,357,267,1012,2314
10,403,376,280,1059,2314
11,387,408,294,1089,2314
1,500,200,50,750,2315
2,471,226,96,793,2315
3,432,239,151,822,2315
4,415,288,159,862,2315
5,420,312,193,925,2315
6,427,327,206,960,2315
7,421,357,216,994,2315
8,397,353,261,1011,2315
9,385,371,266,1022,2315
10,388,374,280,1042,2315
11,405,404,285,1094,2315
1,500,200,50,750,2316
2,457,240,97,794,2316
3,440,254,139,833,2316
4,404,283,164,851,2316
5,402,321,187,910,2316
6,408,323,236,967,2316
7,418,330,251,999,2316
8,402,335,266,1003,2316
9,412,358,275,1045,2316
10,395,375,291,1061,2316
11,404,389,284,1077,2316
1,500,200,50,750,2317
2,456,243,97,796,2317
3,424,279,118,821,2317
4,410,299,159,868,2317
5,396,335,188,919,2317
6,405,345,211,961,2317
7,388,347,229,964,2317
8,396,374,235,1005,2317
9,401,388,260,1049,2317
10,384,391,278,1053,2317
11,375,403,291,1069,2317
1,500,200,50,750,2318
2,460,219,108,787,2318
3,430,263,130,823,2318
4,418,282,151,851,2318
5,412,320,190,922,2318
6,417,330,208,955,2318
7,414,337,226,977,2318
8,420,360,235,1015,2318
9,418,355,259,1032,2318
10,430,369,279,1078,2318
11,421,398,276,1095,2318
1,500,200,50,750,2319
2,459,233,105,797,2319
3,423,279,133,835,2319
4,422,292,163,877,2319
5,408,301,208,917,2319
6,408,328,222,958,2319
7,391,360,240,991,2319
8,371,389,239,999,2319
9,372,394,265,1031,2319
10,376,429,264,1069,2319
11,388,421,286,1095,2319
1,500,200,50,750,2320
2,448,240,102,790,2320
3,435,266,138,839,2320
4,406,298,168,872,2320
5,404,303,201,908,2320
6,425,328,210,963,2320
7,402,375,212,989,2320
8,389,378,239,1006,2320
9,382,386,258,1026,2320
10,405,378,278,1061,2320
11,426,411,260,1097,2320
1,500,200,50,750,2321
2,468,221,97,786,2321
3,456,228,133,817,2321
4,428,279,157,864,2321
5,419,329,173,921,2321
6,403,340,210,953,2321
7,388,349,238,975,2321
8,371,387,241,999,2321
9,407,400,247,1054,2321
10,383,413,262,1058,2321
11,390,416,269,1075,2321
1,500,200,50,750,2322
2,465,240,85,790,2322
3,433,274,128,835,2322
4,402,295,176,873,2322
5,403,318,209,930,2322
6,396,341,217,954,2322
7,388,363,229,980,2322
8,387,371,243,1001,2322
9,400,374,249,1023,2322
10,401,378,279,1058,2322
11,406,399,266,1071,2322
1,500,200,50,750,2323
2,466,241,90,797,2323
3,450,241,135,826,2323
4,447,282,149,878,2323
5,422,298,183,903,2323
6,419,357,199,975,2323
7,388,372,224,984,2323
8,393,382,230,1005,2323
9,382,379,276,1037,2323
10,394,396,269,1059,2323
11,403,418,266,1087,2323
1,500,200,50,750,2324
2,462,220,107,789,2324
3,433,274,124,831,2324
4,421,287,155,863,2324
5,398,302,180,880,2324
6,436,329,200,965,2324
7,398,329,244,971,2324
8,388,347,259,994,2324
9,383,393,254,1030,2324
10,377,406,268,1051,2324
11,390,402,285,1077,2324
1,500,200,50,750,2325
2,490,221,93,804,2325
3,441,254,133,828,2325
4,423,295,156,874,2325
5,418,318,182,918,2325
6,416,323,216,955,2325
7,411,340,221,972,2325
8,402,370,223,995,2325
9,404,388,242,1034,2325
10,412,401,249,1062,2325
11,403,399,274,1076,2325
1,500,200,50,750,2326
2,447,238,91,776,2326
3,429,270,138,837,2326
4,405,303,166,874,2326
5,409,286,196,891,2326
6,426,328,221,975,2326
7,398,342,231,971,2326
8,408,357,233,998,2326
9,413,387,240,1040,2326
10,393,415,250,1058,2326
11,388,442,253,1083,2326
1,500,200,50,750,2327
2,465,217,99,781,2327
3,424,262,140,826,2327
4,417,283,168,868,2327
5,408,317,179,904,2327
6,408,341,200,949,2327
7,386,368,227,981,2327
8,375,402,243,1020,2327
9,361,394,262,1017,2327
10,389,394,274,1057,2327
11,402,426,274,1102,2327
1,500,200,50,750,2328
2,446,246,84,776,2328
3,421,281,128,830,2328
4,413,283,153,849,2328
5,409,319,181,909,2328
6,414,324,215,953,2328
7,396,354,227,977,2328
8,406,372,238,1016,2328
9,402,383,256,1041,2328
10,389,377,287,1053,2328
11,401,399,294,1094,2328
1,500,200,50,750,2329
2,447,235,100,782,2329
3,432,252,138,822,2329
4,412,298,157,867,2329
5,412,296,202,910,2329
6,403,320,220,943,2329
7,417,352,227,996,2329
8,407,383,226,1016,2329
9,384,375,265,1024,2329
10,392,395,261,1048,2329
11,387,406,285,1078,2329
1,500,200,50,750,2330
2,469,243,89,801,2330
3,449,256,130,835,2330
4,417,274,164,855,2330
5,426,300,194,920,2330
6,419,331,209,959,2330
7,401,354,225,980,2330
8,403,379,248,1030,2330
9,386,377,256,1019,2330
10,424,382,254,1060,2330
11,432,380,274,1086,2330
1,500,200,50,750,2331
2,465,235,86,786,2331
3,421,259,134,814,2331
4,412,296,160,868,2331
5,400,325,170,895,2331
6,407,357,203,967,2331
7,410,340,230,980,2331
8,418,341,248,1007,2331
9,417,346,275,1038,2331
10,396,381,283,1060,2331
11,402,389,282,1073,2331
1,500,200,50,750,2332
2,455,235,102,792,2332
3,424,275,129,828,2332
4,419,286,161,866,2332
5,406,311,197,914,2332
6,426,318,211,955,2332
7,409,306,259,974,2332
8,391,370,236,997,2332
9,406,394,252,1052,2332
10,390,402,258,1050,2332
11,402,414,280,1096,2332
1,500,200,50,750,2333
2,454,230,102,786,2333
3,454,248,136,838,2333
4,434,268,176,878,2333
5,423,292,199,914,2333
6,429,332,204,965,2333
7,422,339,220,981,2333
8,402,361,234,997,2333
9,399,397,247,1043,2333
10,383,417,257,1057,2333
11,379,434,273,1086,2333
1,500,200,50,750,2334
2,455,230,102,787,2334
3,431,245,147,823,2334
4,405,267,180,852,2334
5,423,313,194,930,2334
6,413,340,214,967,2334
7,412,358,216,986,2334
8,407,347,240,994,2334
9,407,363,258,1028,2334
10,399,385,274,1058,2334
11,394,406,278,1078,2334
1,500,200,50,750,2335
2,465,235,94,794,2335
3,415,261,135,811,2335
4,404,285,185,874,2335
5,405,293,214,912,2335
6,410,317,232,959,2335
7,400,344,248,992,2335
8,395,372,249,1016,2335
9,394,391,237,1022,2335
10,413,385,257,1055,2335
11,427,402,267,1096,2335
1,500,200,50,750,2336
2,428,233,124,785,2336
3,405,256,163,824,2336
4,403,290,186,879,2336
5,382,320,198,900,2336
6,396,344,207,947,2336
7,409,349,222,980,2336
8,401,354,239,994,2336
9,388,385,254,1027,2336
10,408,404,260,1072,2336
11,388,418,269,1075,2336
1,500,200,50,750,2337
2,480,224,85,789,2337
3,427,285,112,824,2337
4,425,288,152,865,2337
5,425,317,178,920,2337
6,417,324,214,955,2337
7,410,324,236,970,2337
8,406,344,262,1012,2337
9,384,366,276,1026,2337
10,381,370,293,1044,2337
11,389,401,293,1083,2337
1,500,200,50,750,2338
2,471,219,94,784,2338
3,429,245,148,822,2338
4,425,279,176,880,2338
5,396,309,202,907,2338
6,410,353,219,982,2338
7,394,343,240,977,2338
8,383,379,247,1009,2338
9,391,368,278,1037,2338
10,402,385,271,1058,2338
11,394,412,272,1078,2338
1,500,200,50,750,2339
2,466,229,96,791,2339
3,436,248,131,815,2339
4,420,288,160,868,2339
5,405,332,180,917,2339
6,399,362,194,955,2339
7,382,389,206,977,2339
8,386,396,235,1017,2339
9,398,389,241,1028,2339
10,412,375,264,1051,2339
11,412,387,285,1084,2339
1,500,200,50,750,2340
2,447,228,103,778,2340
3,429,250,154,833,2340
4,422,267,177,866,2340
5,413,324,184,921,2340
6,429,336,195,960,2340
7,416,330,235,981,2340
8,402,373,246,1021,2340
9,387,386,253,1026,2340
10,393,410,255,1058,2340
11,409,404,255,1068,2340
1,500,200,50,750,2341
2,464,225,100,789,2341
3,435,252,134,821,2341
4,416,289,173,878,2341
5,403,325,190,918,2341
6,401,360,187,948,2341
7,385,382,215,982,2341
8,394,384,233,1011,2341
9,372,357,284,1013,2341
10,392,393,279,1064,2341
11,382,430,283,1095,2341
1,500,200,50,750,2342
2,467,215,99,781,2342
3,434,274,136,844,2342
4,415,298,171,884,2342
5,402,329,184,915,2342
6,399,345,215,959,2342
7,380,374,242,996,2342
8,364,386,252,1002,2342
9,374,405,255,1034,2342
10,388,417,253,1058,2342
11,393,412,277,1082,2342
1,500,200,50,750,2343
2,472,213,98,783,2343
3,432,248,140,820,2343
4,439,271,165,875,2343
5,423,299,164,886,2343
6,440,331,184,955,2343
7,435,333,208,976,2343
8,424,371,222,1017,2343
9,417,354,265,1036,2343
10,409,375,276,1060,2343
11,421,388,290,1099,2343
1,500,200,50,750,2344
2,459,231,91,781,2344
3,436,266,127,829,2344
4,423,306,135,864,2344
5,415,310,181,906,2344
6,435,337,186,958,2344
7,416,349,218,983,2344
8,405,364,236,1005,2344
9,402,368,254,1024,2344
10,406,393,247,1046,2344
11,419,380,279,1078,2344
1,500,200,50,750,2345
2,448,233,98,779,2345
3,411,246,151,808,2345
4,410,279,179,868,2345
5,425,302,185,912,2345
6,428,342,202,972,2345
7,402,346,233,981,2345
8,398,378,224,1000,2345
9,407,404,227,1038,2345
10,398,410,252,1060,2345
11,420,424,246,1090,2345
1,500,200,50,750,2346
2,475,232,93,800,2346
3,431,272,139,842,2346
4,414,270,181,865,2346
5,392,315,185,892,2346
6,403,355,213,971,2346
7,402,367,221,990,2346
8,406,381,221,1008,2346
9,411,376,249,1036,2346
10,392,375,275,1042,2346
11,399,380,283,1062,2346
1,500,200,50,750,2347
2,440,247,99,786,2347
3,419,270,144,833,2347
4,399,275,184,858,2347
5,418,310,194,922,2347
6,413,330,219,962,2347
7,392,344,248,984,2347
8,383,356,263,1002,2347
9,398,382,263,1043,2347
10,390,401,273,1064,2347
11,385,417,286,1088,2347
1,500,200,50,750,2348
2,465,229,99,793,2348
3,426,270,131,827,2348
4,401,304,162,867,2348
5,394,320,205,919,2348
6,413,343,202,958,2348
7,396,354,226,976,2348
8,388,373,247,1008,2348
9,382,384,269,1035,2348
10,383,403,259,1045,2348
11,379,409,277,1065,2348
1,500,200,50,750,2349
2,463,225,108,796,2349
3,430,256,137,823,2349
4,425,293,163,881,2349
5,406,313,188,907,2349
6,401,339,202,942,2349
7,374,367,212,953,2349
8,392,353,254,999,2349
9,423,358,249,1030,2349
10,422,382,259,1063,2349
11,425,392,272,1089,2349
1,500,200,50,750,2350
2,486,231,89,806,2350
3,443,252,133,828,2350
4,401,287,164,852,2350
5,396,302,186,884,2350
6,424,344,198,966,2350
7,395,358,216,969,2350
8,385,378,241,1004,2350
9,407,386,257,1050,2350
10,404,370,270,1044,2350
11,409,388,279,1076,2350
1,500,200,50,750,2351
2,482,225,88,795,2351
3,453,261,125,839,2351
4,440,299,147,886,2351
5,432,304,185,921,2351
6,421,332,206,959,2351
7,406,368,195,969,2351
8,424,369,220,1013,2351
9,414,374,231,1019,2351
10,426,396,252,1074,2351
11,400,410,268,1078,2351
1,500,200,50,750,2352
2,464,230,99,793,2352
3,408,269,138,815,2352
4,415,277,169,861,2352
5,393,328,210,931,2352
6,401,330,232,963,2352
7,379,351,262,992,2352
8,384,366,258,1008,2352
9,394,396,263,1053,2352
10,381,400,273,1054,2352
11,413,403,276,1092,2352
1,500,200,50,750,2353
2,461,216,108,785,2353
3,438,251,142,831,2353
4,403,290,165,858,2353
5,411,324,192,927,2353
6,415,341,207,963,2353
7,385,368,226,979,2353
8,373,372,247,992,2353
9,401,382,254,1037,2353
10,396,398,261,1055,2353
11,400,400,270,1070,2353
1,500,200,50,750,2354
2,446,251,93,790,2354
3,425,268,131,824,2354
4,416,292,158,866,2354
5,426,305,185,916,2354
6,417,350,194,961,2354
7,410,355,224,989,2354
8,402,370,224,996,2354
9,416,361,257,1034,2354
10,395,392,264,1051,2354
11,399,409,267,1075,2354
1,500,200,50,750,2355
2,446,246,102,794,2355
3,419,277,124,820,2355
4,423,299,150,872,2355
5,416,316,182,914,2355
6,417,327,208,952,2355
7,414,343,230,987,2355
8,397,356,252,1005,2355
9,390,395,248,1033,2355
10,393,407,259,1059,2355
11,384,417,279,1080,2355
1,500,200,50,750,2356
2,451,220,111,782,2356
3,440,247,144,831,2356
4,441,266,181,888,2356
5,410,306,193,909,2356
6,401,343,213,957,2356
7,376,360,236,972,2356
8,359,398,236,993,2356
9,367,391,267,1025,2356
10,368,410,276,1054,2356
11,385,436,276,1097,2356
1,500,200,50,750,2357
2,463,220,105,788,2357
3,436,242,155,833,2357
4,421,270,181,872,2357
5,402,299,199,900,2357
6,409,339,206,954,2357
7,414,345,224,983,2357
8,401,366,235,1002,2357
9,393,381,249,1023,2357
10,395,393,286,1074,2357
11,380,404,288,1072,2357
1,500,200,50,750,2358
2,461,229,103,793,2358
3,424,265,131,820,2358
4,420,283,157,860,2358
5,423,315,176,914,2358
6,430,320,207,957,2358
7,389,359,221,969,2358
8,399,357,243,999,2358
9,418,354,257,1029,2358
10,411,368,271,1050,2358
11,424,383,272,1079,2358
1,500,200,50,750,2359
2,453,243,102,798,2359
3,435,268,136,839,2359
4,418,274,183,875,2359
5,405,301,200,906,2359
6,423,319,229,971,2359
7,389,370,224,983,2359
8,377,358,266,1001,2359
9,382,379,259,1020,2359
10,385,396,264,1045,2359
11,405,402,277,1084,2359
1,500,200,50,750,2360
2,470,232,94,796,2360
3,432,261,131,824,2360
4,416,293,160,869,2360
5,411,308,179,898,2360
6,410,335,212,957,2360
7,403,352,226,981,2360
8,406,365,222,993,2360
9,400,381,233,1014,2360
10,428,393,242,1063,2360
11,447,405,245,1097,2360
1,500,200,50,750,2361
2,454,211,112,777,2361
3,447,260,129,836,2361
4,409,305,153,867,2361
5,397,311,188,896,2361
6,401,361,208,970,2361
7,392,363,217,972,2361
8,375,391,238,1004,2361
9,369,398,254,1021,2361
10,380,413,259,1052,2361
11,369,441,269,1079,2361
1,500,200,50,750,2362
2,470,225,95,790,2362
3,448,249,134,831,2362
4,428,269,182,879,2362
5,410,296,192,898,2362
6,414,308,229,951,2362
7,406,348,232,986,2362
8,401,342,268,1011,2362
9,383,358,291,1032,2362
10,408,385,284,1077,2362
11,393,421,269,1083,2362
1,500,200,50,750,2363
2,461,225,103,789,2363
3,427,254,132,813,2363
4,442,294,138,874,2363
5,440,314,179,933,2363
6,435,326,190,951,2363
7,446,332,217,995,2363
8,439,346,231,1016,2363
9,445,366,220,1031,2363
10,398,398,249,1045,2363
11,406,390,279,1075,2363
1,500,200,50,750,2364
2,467,222,94,783,2364
3,455,248,124,827,2364
4,416,297,147,860,2364
5,420,319,171,910,2364
6,422,346,187,955,2364
7,404,337,232,973,2364
8,403,374,228,1005,2364
9,417,379,249,1045,2364
10,385,383,268,1036,2364
11,374,405,281,1060,2364
1,500,200,50,750,2365
2,460,233,105,798,2365
3,436,247,144,827,2365
4,405,265,187,857,2365
5,391,297,230,918,2365
6,383,347,224,954,2365
7,397,354,236,987,2365
8,394,374,236,1004,2365
9,411,353,270,1034,2365
10,389,380,295,1064,2365
11,389,384,294,1067,2365
1,500,200,50,750,2366
2,458,220,110,788,2366
3,442,241,146,829,2366
4,419,265,178,862,2366
5,419,301,192,912,2366
6,440,337,197,974,2366
7,417,348,217,982,2366
8,400,383,228,1011,2366
9,399,402,237,1038,2366
10,398,391,254,1043,2366
11,388,395,280,1063,2366
1,500,200,50,750,2367
2,468,222,99,789,2367
3,427,257,136,820,2367
4,431,278,150,859,2367
5,433,300,186,919,2367
6,433,323,199,955,2367
7,391,335,237,963,2367
8,388,348,267,1003,2367
9,388,378,262,1028,2367
10,392,391,265,1048,2367
11,395,412,283,1090,2367
1,500,200,50,750,2368
2,466,236,96,798,2368
3,443,256,135,834,2368
4,440,270,163,873,2368
5,431,303,184,918,2368
6,434,343,192,969,2368
7,417,359,208,984,2368
8,408,376,241,1025,2368
9,397,387,240,1024,2368
10,416,428,233,1077,2368
11,426,402,263,1091,2368
1,500,200,50,750,2369
2,441,227,114,782,2369
3,417,276,143,836,2369
4,419,298,174,891,2369
5,390,306,218,914,2369
6,382,312,253,947,2369
7,367,345,255,967,2369
8,368,376,245,989,2369
9,376,407,253,1036,2369
10,390,400,275,1065,2369
11,393,402,271,1066,2369
1,500,200,50,750,2370
2,467,229,96,792,2370
3,435,271,135,841,2370
4,411,290,159,860,2370
5,424,317,179,920,2370
6,428,342,197,967,2370
7,402,369,201,972,2370
8,408,359,245,1012,2370
9,386,391,249,1026,2370
10,393,409,259,1061,2370
11,397,385,275,1057,2370
1,500,200,50,750,2371
2,470,238,87,795,2371
3,437,257,135,829,2371
4,406,279,178,863,2371
5,392,341,181,914,2371
6,404,360,198,962,2371
7,385,371,222,978,2371
8,372,377,236,985,2371
9,392,381,253,1026,2371
10,395,395,285,1075,2371
11,421,397,270,1088,2371
1,500,200,50,750,2372
2,440,234,112,786,2372
3,416,280,137,833,2372
4,387,323,156,866,2372
5,390,331,190,911,2372
6,383,357,213,953,2372
7,395,366,217,978,2372
8,391,375,245,1011,2372
9,369,364,287,1020,2372
10,371,402,277,1050,2372
11,378,423,274,1075,2372
1,500,200,50,750,2373
2,449,235,90,774,2373
3,443,262,127,832,2373
4,429,273,167,869,2373
5,429,287,192,908,2373
6,444,328,195,967,2373
7,413,343,214,970,2373
8,419,383,215,1017,2373
9,414,378,244,1036,2373
10,422,393,244,1059,2373
11,399,406,274,1079,2373
1,500,200,50,750,2374
2,466,215,104,785,2374
3,429,263,143,835,2374
4,401,302,164,867,2374
5,380,315,221,916,2374
6,380,343,249,972,2374
7,374,348,261,983,2374
8,371,373,256,1000,2374
9,376,391,265,1032,2374
10,388,383,282,1053,2374
11,404,399,279,1082,2374
1,500,200,50,750,2375
2,456,224,108,788,2375
3,400,251,151,802,2375
4,415,281,176,872,2375
5,400,312,182,894,2375
6,426,351,201,978,2375
7,396,363,231,990,2375
8,391,363,251,1005,2375
9,396,390,245,1031,2375
10,394,398,272,1064,2375
11,399,425,254,1078,2375
1,500,200,50,750,2376
2,470,225,95,790,2376
3,434,251,137,822,2376
4,409,301,152,862,2376
5,385,334,189,908,2376
6,398,320,216,934,2376
7,385,361,245,991,2376
8,374,376,259,1009,2376
9,368,371,266,1005,2376
10,364,391,264,1019,2376
11,379,405,287,1071,2376
1,500,200,50,750,2377
2,466,226,101,793,2377
3,429,271,136,836,2377
4,416,293,169,878,2377
5,398,311,201,910,2377
6,411,341,209,961,2377
7,405,357,224,986,2377
8,408,355,248,1011,2377
9,398,379,265,1042,2377
10,415,364,291,1070,2377
11,403,396,291,1090,2377
1,500,200,50,750,2378
2,457,236,84,777,2378
3,421,275,132,828,2378
4,423,287,162,872,2378
5,403,330,183,916,2378
6,386,350,212,948,2378
7,393,361,214,968,2378
8,390,382,227,999,2378
9,406,386,245,1037,2378
10,398,410,263,1071,2378
11,426,392,260,1078,2378
1,500,200,50,750,2379
2,471,226,101,798,2379
3,438,255,136,829,2379
4,420,295,158,873,2379
5,411,310,204,925,2379
6,401,313,238,952,2379
7,381,331,247,959,2379
8,395,360,256,1011,2379
9,382,368,272,1022,2379
10,402,383,293,1078,2379
11,400,387,290,1077,2379
1,500,200,50,750,2380
2,448,231,101,780,2380
3,434,250,146,830,2380
4,430,265,186,881,2380
5,387,319,205,911,2380
6,385,363,212,960,2380
7,393,363,233,989,2380
8,389,373,241,1003,2380
9,383,400,240,1023,2380
10,397,425,238,1060,2380
11,393,409,271,1073,2380
1,500,200,50,750,2381
2,461,236,91,788,2381
3,437,274,130,841,2381
4,399,306,161,866,2381
5,396,312,197,905,2381
6,408,302,230,940,2381
7,374,339,238,951,2381
8,390,354,269,1013,2381
9,382,368,277,1027,2381
10,376,375,294,1045,2381
11,399,395,299,1093,2381
1,500,200,50,750,2382
2,455,229,96,780,2382
3,438,271,127,836,2382
4,414,294,169,877,2382
5,393,307,198,898,2382
6,410,326,212,948,2382
7,425,350,229,1004,2382
8,419,351,241,1011,2382
9,405,372,259,1036,2382
10,398,374,276,1048,2382
11,426,398,264,1088,2382
1,500,200,50,750,2383
2,475,246,83,804,2383
3,441,269,120,830,2383
4,431,283,150,864,2383
5,424,308,177,909,2383
6,406,331,202,939,2383
7,395,341,241,977,2383
8,406,347,261,1014,2383
9,410,377,257,1044,2383
10,409,391,262,1062,2383
11,413,387,279,1079,2383
1,500,200,50,750,2384
2,462,217,107,786,2384
3,444,248,133,825,2384
4,411,273,185,869,2384
5,419,308,187,914,2384
6,416,329,209,954,2384
7,394,368,224,986,2384
8,386,357,258,1001,2384
9,385,387,260,1032,2384
10,394,403,270,1067,2384
11,377,404,288,1069,2384
1,500,200,50,750,2385
2,458,228,94,780,2385
3,425,254,143,822,2385
4,423,280,167,870,2385
5,419,285,198,902,2385
6,422,316,220,958,2385
7,400,325,250,975,2385
8,398,360,254,1012,2385
9,380,390,253,1023,2385
10,380,454,241,1075,2385
11,369,450,256,1075,2385
1,500,200,50,750,2386
2,471,211,102,784,2386
3,452,240,128,820,2386
4,430,281,156,867,2386
5,412,300,179,891,2386
6,429,319,192,940,2386
7,427,332,208,967,2386
8,428,337,248,1013,2386
9,408,368,248,1024,2386
10,410,421,237,1068,2386
11,408,413,256,1077,2386
1,500,200,50,750,2387
2,449,241,93,783,2387
3,425,272,131,828,2387
4,398,291,169,858,2387
5,421,308,190,919,2387
6,401,337,212,950,2387
7,408,349,230,987,2387
8,408,360,247,1015,2387
9,407,355,262,1024,2387
10,411,380,274,1065,2387
11,395,393,271,1059,2387
1,500,200,50,750,2388
2,456,221,101,778,2388
3,457,218,141,816,2388
4,432,281,143,856,2388
5,419,327,171,917,2388
6,404,359,200,963,2388
7,397,359,213,969,2388
8,402,358,243,1003,2388
9,397,361,262,1020,2388
10,410,376,290,1076,2388
11,417,389,277,1083,2388
1,500,200,50,750,2389
2,459,224,97,780,2389
3,425,268,118,811,2389
4,424,292,153,869,2389
5,403,317,178,898,2389
6,408,335,208,951,2389
7,417,333,241,991,2389
8,397,347,254,998,2389
9,357,376,286,1019,2389
10,364,406,305,1075,2389
11,353,408,317,1078,2389
1,500,200,50,750,2390
2,444,230,99,773,2390
3,442,263,137,842,2390
4,419,285,174,878,2390
5,406,307,190,903,2390
6,419,332,214,965,2390
7,432,346,213,991,2390
8,421,356,221,998,2390
9,423,385,225,1033,2390
10,411,420,235,1066,2390
11,410,414,268,1092,2390
1,500,200,50,750,2391
2,465,231,95,791,2391
3,436,263,134,833,2391
4,424,278,160,862,2391
5,425,301,176,902,2391
6,442,323,224,989,2391
7,396,327,247,970,2391
8,391,337,262,990,2391
9,389,366,253,1008,2391
10,392,374,282,1048,2391
11,412,391,290,1093,2391
1,500,200,50,750,2392
2,469,216,108,793,2392
3,442,244,142,828,2392
4,418,257,176,851,2392
5,417,288,210,915,2392
6,435,307,209,951,2392
7,432,323,236,991,2392
8,421,352,232,1005,2392
9,406,369,248,1023,2392
10,427,395,248,1070,2392
11,406,421,252,1079,2392
1,500,200,50,750,2393
2,476,234,80,790,2393
3,459,258,125,842,2393
4,415,278,162,855,2393
5,414,329,170,913,2393
6,403,360,202,965,2393
7,384,390,207,981,2393
8,389,382,248,1019,2393
9,386,377,263,1026,2393
10,393,392,274,1059,2393
11,406,393,288,1087,2393
1,500,200,50,750,2394
2,462,234,92,788,2394
3,422,263,128,813,2394
4,429,306,145,880,2394
5,400,325,182,907,2394
6,399,343,212,954,2394
7,394,337,247,978,2394
8,385,351,264,1000,2394
9,390,387,264,1041,2394
10,376,391,285,1052,2394
11,364,410,303,1077,2394
1,500,200,50,750,2395
2,456,233,106,795,2395
3,414,267,135,816,2395
4,391,300,160,851,2395
5,401,324,194,919,2395
6,386,337,224,947,2395
7,386,362,230,978,2395
8,400,362,251,1013,2395
9,386,393,269,1048,2395
10,368,427,267,1062,2395
11,361,421,286,1068,2395
1,500,200,50,750,2396
2,452,219,101,772,2396
3,446,263,137,846,2396
4,413,273,178,864,2396
5,404,305,196,905,2396
6,409,328,226,963,2396
7,397,339,248,984,2396
8,377,381,243,1001,2396
9,398,400,243,1041,2396
10,395,398,256,1049,2396
11,400,412,280,1092,2396
1,500,200,50,750,2397
2,451,241,95,787,2397
3,422,265,147,834,2397
4,398,301,166,865,2397
5,383,326,196,905,2397
6,383,353,209,945,2397
7,384,354,234,972,2397
8,395,386,237,1018,2397
9,390,392,256,1038,2397
10,382,393,273,1048,2397
11,383,394,305,1082,2397
1,500,200,50,750,2398
2,448,247,81,776,2398
3,422,265,137,824,2398
4,412,289,165,866,2398
5,399,331,177,907,2398
6,401,350,201,952,2398
7,399,368,227,994,2398
8,383,351,263,997,2398
9,411,359,268,1038,2398
10,419,414,235,1068,2398
11,400,419,259,1078,2398
1,500,200,50,750,2399
2,464,222,96,782,2399
3,449,260,125,834,2399
4,411,294,168,873,2399
5,416,313,192,921,2399
6,386,358,215,959,2399
7,373,386,226,985,2399
8,384,354,254,992,2399
9,372,384,275,1031,2399
10,390,386,274,1050,2399
11,377,404,291,1072,2399
1,500,200,50,750,2400
2,442,259,103,804,2400
3,404,271,138,813,2400
4,401,291,169,861,2400
5,407,321,179,907,2400
6,428,346,201,975,2400
7,409,355,224,988,2400
8,414,379,235,1028,2400
9,384,405,243,1032,2400
10,383,396,278,1057,2400
11,394,399,280,1073,2400
1,500,200,50,750,2401
2,449,221,98,768,2401
3,451,247,138,836,2401
4,423,283,157,863,2401
5,407,321,188,916,2401
6,391,344,212,947,2401
7,390,352,248,990,2401
8,388,365,267,1020,2401
9,377,397,258,1032,2401
10,402,398,268,1068,2401
11,404,382,280,1066,2401
1,500,200,50,750,2402
2,451,240,97,788,2402
3,423,265,139,827,2402
4,417,267,181,865,2402
5,400,327,195,922,2402
6,396,326,221,943,2402
7,396,352,235,983,2402
8,379,383,246,1008,2402
9,380,396,250,1026,2402
10,392,397,265,1054,2402
11,399,419,252,1070,2402
1,500,200,50,750,2403
2,453,247,83,783,2403
3,439,264,141,844,2403
4,428,289,162,879,2403
5,430,284,194,908,2403
6,425,336,200,961,2403
7,404,344,224,972,2403
8,392,374,250,1016,2403
9,386,360,277,1023,2403
10,407,371,283,1061,2403
11,401,394,272,1067,2403
1,500,200,50,750,2404
2,466,225,97,788,2404
3,427,270,130,827,2404
4,426,284,167,877,2404
5,397,311,191,899,2404
6,409,342,212,963,2404
7,385,344,242,971,2404
8,399,355,256,1010,2404
9,410,362,258,1030,2404
10,400,371,269,1040,2404
11,427,389,271,1087,2404
1,500,200,50,750,2405
2,463,224,104,791,2405
3,415,266,135,816,2405
4,410,292,166,868,2405
5,413,301,195,909,2405
6,409,330,211,950,2405
7,410,325,231,966,2405
8,401,347,252,1000,2405
9,386,386,252,1024,2405
10,384,397,268,1049,2405
11,401,406,267,1074,2405
1,500,200,50,750,2406
2,446,223,109,778,2406
3,429,256,158,843,2406
4,408,274,178,860,2406
5,395,313,197,905,2406
6,382,335,242,959,2406
7,379,361,255,995,2406
8,358,364,261,983,2406
9,400,378,263,1041,2406
10,389,402,262,1053,2406
11,398,404,270,1072,2406
1,500,200,50,750,2407
2,457,229,106,792,2407
3,442,252,137,831,2407
4,416,275,178,869,2407
5,399,318,197,914,2407
6,376,351,225,952,2407
7,354,367,240,961,2407
8,353,373,251,977,2407
9,365,388,263,1016,2407
10,363,437,260,1060,2407
11,388,437,266,1091,2407
1,500,200,50,750,2408
2,475,221,87,783,2408
3,438,254,124,816,2408
4,426,275,170,871,2408
5,418,315,192,925,2408
6,416,316,231,963,2408
7,398,348,237,983,2408
8,393,359,248,1000,2408
9,385,400,255,1040,2408
10,382,416,252,1050,2408
11,387,440,270,1097,2408
1,500,200,50,750,2409
2,445,241,94,780,2409
3,421,266,131,818,2409
4,395,320,150,865,2409
5,385,325,193,903,2409
6,400,358,199,957,2409
7,399,378,207,984,2409
8,399,379,241,1019,2409
9,414,379,252,1045,2409
10,406,396,251,1053,2409
11,405,405,278,1088,2409
1,500,200,50,750,2410
2,473,219,108,800,2410
3,465,240,129,834,2410
4,435,269,164,868,2410
5,421,307,179,907,2410
6,416,323,219,958,2410
7,411,349,218,978,2410
8,400,376,227,1003,2410
9,408,396,235,1039,2410
10,404,400,246,1050,2410
11,415,406,273,1094,2410
1,500,200,50,750,2411
2,454,230,104,788,2411
3,436,253,157,846,2411
4,424,281,171,876,2411
5,391,325,199,915,2411
6,425,321,228,974,2411
7,385,340,247,972,2411
8,387,356,269,1012,2411
9,392,383,274,1049,2411
10,384,393,284,1061,2411
11,407,401,285,1093,2411
1,500,200,50,750,2412
2,441,238,104,783,2412
3,419,280,138,837,2412
4,409,291,167,867,2412
5,407,309,203,919,2412
6,415,321,222,958,2412
7,399,353,235,987,2412
8,399,360,254,1013,2412
9,384,384,257,1025,2412
10,401,408,253,1062,2412
11,406,424,251,1081,2412
1,500,200,50,750,2413
2,466,224,89,779,2413
3,431,252,130,813,2413
4,444,282,156,882,2413
5,435,293,179,907,2413
6,424,301,221,946,2413
7,417,336,242,995,2413
8,384,358,247,989,2413
9,381,372,274,1027,2413
10,367,371,292,1030,2413
11,386,411,279,1076,2413
1,500,200,50,750,2414
2,463,224,98,785,2414
3,450,253,119,822,2414
4,421,289,149,859,2414
5,405,322,182,909,2414
6,420,356,190,966,2414
7,404,359,215,978,2414
8,406,339,267,1012,2414
9,386,375,271,1032,2414
10,370,389,282,1041,2414
11,388,415,295,1098,2414
1,500,200,50,750,2415
2,455,246,84,785,2415
3,411,249,145,805,2415
4,405,289,160,854,2415
5,395,311,192,898,2415
6,409,345,212,966,2415
7,398,352,230,980,2415
8,405,370,253,1028,2415
9,399,373,249,1021,2415
10,397,391,256,1044,2415
11,416,404,254,1074,2415
1,500,200,50,750,2416
2,453,234,93,780,2416
3,425,272,132,829,2416
4,415,296,157,868,2416
5,401,332,170,903,2416
6,406,346,204,956,2416
7,401,364,223,988,2416
8,374,383,243,1000,2416
9,364,394,271,1029,2416
10,372,398,278,1048,2416
11,391,411,284,1086,2416
1,500,200,50,750,2417
2,451,233,101,785,2417
3,399,259,157,815,2417
4,403,295,159,857,2417
5,386,306,195,887,2417
6,419,327,219,965,2417
7,394,358,229,981,2417
8,392,369,231,992,2417
9,419,406,225,1050,2417
10,407,414,241,1062,2417
11,394,408,272,1074,2417
1,500,200,50,750,2418
2,462,240,91,793,2418
3,415,279,135,829,2418
4,391,294,179,864,2418
5,397,300,204,901,2418
6,398,325,220,943,2418
7,390,347,235,972,2418
8,378,361,269,1008,2418
9,378,392,247,1017,2418
10,407,423,252,1082,2418
11,395,424,271,1090,2418
1,500,200,50,750,2419
2,480,214,95,789,2419
3,449,272,122,843,2419
4,419,288,164,871,2419
5,415,314,182,911,2419
6,394,351,203,948,2419
7,371,375,233,979,2419
8,368,396,235,999,2419
9,382,396,242,1020,2419
10,412,410,239,1061,2419
11,396,428,257,1081,2419
1,500,200,50,750,2420
2,454,226,111,791,2420
3,421,259,148,828,2420
4,414,296,167,877,2420
5,421,301,196,918,2420
6,404,338,207,949,2420
7,405,362,225,992,2420
8,392,366,244,1002,2420
9,393,382,247,1022,2420
10,400,377,272,1049,2420
11,416,412,262,1090,2420
1,500,200,50,750,2421
2,447,233,110,790,2421
3,413,274,141,828,2421
4,413,306,154,873,2421
5,412,333,169,914,2421
6,415,343,203,961,2421
7,428,342,224,994,2421
8,406,359,246,1011,2421
9,412,349,268,1029,2421
10,393,362,290,1045,2421
11,424,384,283,1091,2421
1,500,200,50,750,2422
2,454,230,104,788,2422
3,431,272,134,837,2422
4,441,276,164,881,2422
5,428,309,177,914,2422
6,409,335,203,947,2422
7,398,354,211,963,2422
8,419,367,211,997,2422
9,402,371,240,1013,2422
10,418,389,245,1052,2422
11,421,394,268,1083,2422
1,500,200,50,750,2423
2,456,230,97,783,2423
3,426,257,139,822,2423
4,411,289,169,869,2423
5,408,315,188,911,2423
6,428,311,223,962,2423
7,390,352,228,970,2423
8,409,362,239,1010,2423
9,407,360,252,1019,2423
10,406,394,254,1054,2423
11,399,390,283,1072,2423
1,500,200,50,750,2424
2,461,232,93,786,2424
3,452,257,125,834,2424
4,427,277,164,868,2424
5,441,315,179,935,2424
6,434,328,213,975,2424
7,407,358,216,981,2424
8,405,376,228,1009,2424
9,404,384,250,1038,2424
10,411,372,268,1051,2424
11,416,391,282,1089,2424
1,500,200,50,750,2425
2,468,218,100,786,2425
3,423,259,146,828,2425
4,398,307,168,873,2425
5,389,341,191,921,2425
6,381,366,208,955,2425
7,371,367,235,973,2425
8,381,386,241,1008,2425
9,392,380,258,1030,2425
10,404,373,265,1042,2425
11,436,387,285,1108,2425
1,500,200,50,750,2426
2,452,229,115,796,2426
3,431,258,140,829,2426
4,403,284,174,861,2426
5,394,301,207,902,2426
6,390,337,228,955,2426
7,381,335,250,966,2426
8,398,353,263,1014,2426
9,374,370,283,1027,2426
10,373,393,292,1058,2426
11,383,399,296,1078,2426
1,500,200,50,750,2427
2,456,243,87,786,2427
3,430,267,126,823,2427
4,406,272,184,862,2427
5,401,308,216,925,2427
6,406,323,238,967,2427
7,382,357,248,987,2427
8,374,376,251,1001,2427
9,388,368,271,1027,2427
10,384,392,287,1063,2427
11,389,417,274,1080,2427
1,500,200,50,750,2428
2,458,219,117,794,2428
3,433,246,147,826,2428
4,409,263,190,862,2428
5,418,302,187,907,2428
6,404,344,196,944,2428
7,401,336,244,981,2428
8,411,356,243,1010,2428
9,400,390,238,1028,2428
10,405,409,249,1063,2428
11,409,405,284,1098,2428
1,500,200,50,750,2429
2,443,238,100,781,2429
3,428,256,142,826,2429
4,406,277,178,861,2429
5,391,323,199,913,2429
6,391,362,206,959,2429
7,382,349,238,969,2429
8,375,378,239,992,2429
9,393,382,262,1037,2429
10,404,367,291,1062,2429
11,408,388,293,1089,2429
1,500,200,50,750,2430
2,452,224,99,775,2430
3,441,259,140,840,2430
4,429,280,155,864,2430
5,402,325,180,907,2430
6,418,328,205,951,2430
7,413,331,238,982,2430
8,411,345,237,993,2430
9,412,365,241,1018,2430
10,415,390,256,1061,2430
11,414,395,286,1095,2430
1,500,200,50,750,2431
2,450,243,93,786,2431
3,431,259,137,827,2431
4,439,281,166,886,2431
5,413,315,184,912,2431
6,394,348,219,961,2431
7,371,370,232,973,2431
8,376,359,269,1004,2431
9,389,360,273,1022,2431
10,399,369,288,1056,2431
11,415,397,274,1086,2431
1,500,200,50,750,2432
2,449,227,113,789,2432
3,418,258,141,817,2432
4,399,271,170,840,2432
5,415,302,183,900,2432
6,413,332,208,953,2432
7,423,349,216,988,2432
8,414,350,244,1008,2432
9,393,355,269,1017,2432
10,417,388,265,1070,2432
11,412,407,281,1100,2432
1,500,200,50,750,2433
2,472,225,84,781,2433
3,437,270,129,836,2433
4,417,284,164,865,2433
5,391,320,185,896,2433
6,411,341,212,964,2433
7,389,349,226,964,2433
8,366,378,248,992,2433
9,369,385,257,1011,2433
10,389,402,267,1058,2433
11,421,407,265,1093,2433
1,500,200,50,750,2434
2,447,235,104,786,2434
3,425,273,131,829,2434
4,424,294,170,888,2434
5,399,316,186,901,2434
6,416,340,219,975,2434
7,375,345,253,973,2434
8,395,359,259,1013,2434
9,399,401,249,1049,2434
10,395,403,258,1056,2434
11,399,419,269,1087,2434
1,500,200,50,750,2435
2,451,246,88,785,2435
3,426,269,131,826,2435
4,410,284,168,862,2435
5,417,295,186,898,2435
6,436,325,188,949,2435
7,413,362,204,979,2435
8,403,357,243,1003,2435
9,407,382,250,1039,2435
10,399,399,253,1051,2435
11,409,409,253,1071,2435
1,500,200,50,750,2436
2,458,232,106,796,2436
3,419,270,132,821,2436
4,413,282,181,876,2436
5,402,307,206,915,2436
6,406,354,218,978,2436
7,392,379,213,984,2436
8,389,371,229,989,2436
9,428,384,235,1047,2436
10,436,380,249,1065,2436
11,410,389,279,1078,2436
1,500,200,50,750,2437
2,446,221,102,769,2437
3,437,251,139,827,2437
4,430,271,167,868,2437
5,410,328,168,906,2437
6,386,352,210,948,2437
7,419,363,215,997,2437
8,413,376,208,997,2437
9,412,396,235,1043,2437
10,388,397,272,1057,2437
11,397,409,283,1089,2437
1,500,200,50,750,2438
2,461,230,105,796,2438
3,421,256,138,815,2438
4,406,300,167,873,2438
5,401,322,195,918,2438
6,396,329,222,947,2438
7,401,318,255,974,2438
8,408,319,280,1007,2438
9,404,350,279,1033,2438
10,390,394,266,1050,2438
11,395,414,276,1085,2438
1,500,200,50,750,2439
2,463,241,88,792,2439
3,434,264,132,830,2439
4,404,307,162,873,2439
5,409,330,175,914,2439
6,392,361,203,956,2439
7,380,387,219,986,2439
8,406,373,242,1021,2439
9,390,387,257,1034,2439
10,389,381,289,1059,2439
11,425,363,308,1096,2439
1,500,200,50,750,2440
2,442,229,108,779,2440
3,418,272,137,827,2440
4,419,258,174,851,2440
5,426,288,203,917,2440
6,425,323,209,957,2440
7,411,326,233,970,2440
8,423,342,244,1009,2440
9,427,341,272,1040,2440
10,410,355,284,1049,2440
11,399,391,290,1080,2440
1,500,200,50,750,2441
2,466,238,82,786,2441
3,448,253,130,831,2441
4,422,274,166,862,2441
5,415,283,211,909,2441
6,413,321,224,958,2441
7,399,359,230,988,2441
8,377,383,239,999,2441
9,390,377,263,1030,2441
10,418,405,247,1070,2441
11,414,391,283,1088,2441
1,500,200,50,750,2442
2,451,232,95,778,2442
3,444,273,116,833,2442
4,421,287,156,864,2442
5,396,301,195,892,2442
6,385,327,215,927,2442
7,411,354,228,993,2442
8,398,348,247,993,2442
9,403,351,268,1022,2442
10,400,389,271,1060,2442
11,420,411,280,1111,2442
1,500,200,50,750,2443
2,453,234,99,786,2443
3,422,256,148,826,2443
4,402,294,171,867,2443
5,395,308,207,910,2443
6,412,336,203,951,2443
7,419,357,223,999,2443
8,394,374,232,1000,2443
9,412,369,248,1029,2443
10,413,381,272,1066,2443
11,408,394,271,1073,2443
1,500,200,50,750,2444
2,452,233,104,789,2444
3,432,262,136,830,2444
4,425,267,168,860,2444
5,419,291,190,900,2444
6,423,341,198,962,2444
7,410,353,223,986,2444
8,396,372,238,1006,2444
9,382,415,241,1038,2444
10,399,399,269,1067,2444
11,406,408,278,1092,2444
1,500,200,50,750,2445
2,454,231,97,782,2445
3,415,274,137,826,2445
4,390,291,166,847,2445
5,383,325,197,905,2445
6,392,355,211,958,2445
7,388,379,221,988,2445
8,387,383,241,1011,2445
9,388,387,246,1021,2445
10,386,415,258,1059,2445
11,396,424,267,1087,2445
1,500,200,50,750,2446
2,452,246,92,790,2446
3,437,267,134,838,2446
4,417,298,157,872,2446
5,414,330,169,913,2446
6,409,370,197,976,2446
7,387,371,222,980,2446
8,388,379,251,1018,2446
9,386,389,255,1030,2446
10,425,381,258,1064,2446
11,434,413,250,1097,2446
1,500,200,50,750,2447
2,469,228,98,795,2447
3,458,240,134,832,2447
4,442,262,169,873,2447
5,426,274,217,917,2447
6,400,325,232,957,2447
7,390,371,226,987,2447
8,378,365,246,989,2447
9,393,384,266,1043,2447
10,401,373,280,1054,2447
11,393,381,309,1083,2447
1,500,200,50,750,2448
2,462,231,96,789,2448
3,418,263,135,816,2448
4,414,291,165,870,2448
5,404,310,189,903,2448
6,412,330,199,941,2448
7,389,350,227,966,2448
8,396,354,254,1004,2448
9,405,372,256,1033,2448
10,391,406,266,1063,2448
11,377,430,282,1089,2448
1,500,200,50,750,2449
2,469,227,96,792,2449
3,421,254,139,814,2449
4,421,284,155,860,2449
5,434,312,176,922,2449
6,411,335,199,945,2449
7,421,330,221,972,2449
8,419,358,239,1016,2449
9,408,383,237,1028,2449
10,430,378,256,1064,2449
11,416,407,271,1094,2449
1,500,200,50,750,2450
2,458,235,98,791,2450
3,434,258,140,832,2450
4,422,274,157,853,2450
5,437,296,178,911,2450
6,438,319,206,963,2450
7,421,336,219,976,2450
8,416,360,236,1012,2450
9,400,363,265,1028,2450
10,395,391,265,1051,2450
11,406,416,260,1082,2450
1,500,200,50,750,2451
2,436,236,96,768,2451
3,413,286,133,832,2451
4,379,315,164,858,2451
5,387,343,182,912,2451
6,406,354,200,960,2451
7,402,351,232,985,2451
8,393,373,247,1013,2451
9,399,380,260,1039,2451
10,382,436,245,1063,2451
11,393,444,259,1096,2451
1,500,200,50,750,2452
2,461,240,95,796,2452
3,427,235,160,822,2452
4,421,268,173,862,2452
5,409,320,192,921,2452
6,407,326,214,947,2452
7,429,354,204,987,2452
8,410,361,229,1000,2452
9,409,384,243,1036,2452
10,400,402,271,1073,2452
11,385,411,282,1078,2452
1,500,200,50,750,2453
2,451,237,113,801,2453
3,407,261,146,814,2453
4,394,276,183,853,2453
5,396,312,196,904,2453
6,419,309,211,939,2453
7,413,343,242,998,2453
8,402,382,236,1020,2453
9,380,391,258,1029,2453
10,409,384,271,1064,2453
11,386,398,304,1088,2453
1,500,200,50,750,2454
2,452,246,95,793,2454
3,428,286,121,835,2454
4,420,291,152,863,2454
5,411,309,195,915,2454
6,399,347,222,968,2454
7,393,362,238,993,2454
8,378,368,240,986,2454
9,402,361,247,1010,2454
10,410,395,268,1073,2454
11,409,386,273,1068,2454
1,500,200,50,750,2455
2,450,239,96,785,2455
3,435,265,121,821,2455
4,408,295,166,869,2455
5,417,319,194,930,2455
6,401,341,208,950,2455
7,399,358,219,976,2455
8,379,356,255,990,2455
9,407,375,263,1045,2455
10,412,387,252,1051,2455
11,421,380,284,1085,2455
1,500,200,50,750,2456
2,470,230,106,806,2456
3,413,253,148,814,2456
4,431,273,174,878,2456
5,428,318,173,919,2456
6,430,331,189,950,2456
7,429,356,218,1003,2456
8,420,368,218,1006,2456
9,421,387,221,1029,2456
10,414,395,254,1063,2456
11,415,409,257,1081,2456
1,500,200,50,750,2457
2,466,237,101,804,2457
3,410,288,130,828,2457
4,409,309,155,873,2457
5,388,345,185,918,2457
6,348,367,223,938,2457
7,348,364,255,967,2457
8,365,393,257,1015,2457
9,365,381,278,1024,2457
10,381,380,297,1058,2457
11,389,420,280,1089,2457
1,500,200,50,750,2458
2,484,205,100,789,2458
3,452,244,135,831,2458
4,442,260,173,875,2458
5,420,284,211,915,2458
6,405,324,220,949,2458
7,395,394,209,998,2458
8,386,379,248,1013,2458
9,378,404,251,1033,2458
10,409,424,229,1062,2458
11,407,435,241,1083,2458
1,500,200,50,750,2459
2,458,223,94,775,2459
3,445,257,131,833,2459
4,423,271,166,860,2459
5,388,329,172,889,2459
6,385,345,225,955,2459
7,376,387,207,970,2459
8,372,389,224,985,2459
9,378,382,263,1023,2459
10,401,396,277,1074,2459
11,370,408,298,1076,2459
1,500,200,50,750,2460
2,454,226,102,782,2460
3,429,252,146,827,2460
4,410,305,170,885,2460
5,417,316,198,931,2460
6,402,352,203,957,2460
7,395,361,225,981,2460
8,404,363,246,1013,2460
9,386,386,256,1028,2460
10,376,397,274,1047,2460
11,373,431,278,1082,2460
1,500,200,50,750,2461
2,489,216,97,802,2461
3,451,240,136,827,2461
4,432,255,191,878,2461
5,394,297,213,904,2461
6,399,337,205,941,2461
7,396,367,211,974,2461
8,397,377,230,1004,2461
9,394,386,250,1030,2461
10,396,399,269,1064,2461
11,389,416,262,1067,2461
1,500,200,50,750,2462
2,475,248,78,801,2462
3,435,260,118,813,2462
4,434,282,162,878,2462
5,411,298,195,904,2462
6,405,336,214,955,2462
7,411,357,223,991,2462
8,397,363,246,1006,2462
9,404,362,256,1022,2462
10,427,393,239,1059,2462
11,409,389,277,1075,2462
1,500,200,50,750,2463
2,480,211,99,790,2463
3,432,265,132,829,2463
4,417,307,167,891,2463
5,402,299,207,908,2463
6,398,330,226,954,2463
7,404,357,221,982,2463
8,387,391,223,1001,2463
9,382,395,233,1010,2463
10,397,425,239,1061,2463
11,388,427,266,1081,2463
1,500,200,50,750,2464
2,442,223,103,768,2464
3,432,253,132,817,2464
4,433,268,170,871,2464
5,430,320,168,918,2464
6,418,338,208,964,2464
7,405,335,250,990,2464
8,408,357,246,1011,2464
9,399,391,255,1045,2464
10,383,404,260,1047,2464
11,432,418,261,1111,2464
1,500,200,50,750,2465
2,470,230,84,784,2465
3,452,267,118,837,2465
4,437,288,152,877,2465
5,397,298,212,907,2465
6,398,339,216,953,2465
7,392,387,214,993,2465
8,376,394,221,991,2465
9,398,395,245,1038,2465
10,411,389,257,1057,2465
11,399,422,261,1082,2465
1,500,200,50,750,2466
2,457,236,106,799,2466
3,433,266,140,839,2466
4,423,305,147,875,2466
5,422,327,170,919,2466
6,375,344,215,934,2466
7,395,375,216,986,2466
8,400,383,233,1016,2466
9,403,361,258,1022,2466
10,391,403,260,1054,2466
11,391,424,263,1078,2466
1,500,200,50,750,2467
2,450,223,102,775,2467
3,455,263,129,847,2467
4,426,278,157,861,2467
5,424,307,192,923,2467
6,416,337,207,960,2467
7,407,348,221,976,2467
8,411,356,237,1004,2467
9,425,370,244,1039,2467
10,424,379,259,1062,2467
11,444,379,265,1088,2467
1,500,200,50,750,2468
2,462,231,100,793,2468
3,437,275,129,841,2468
4,418,288,163,869,2468
5,449,297,185,931,2468
6,420,329,208,957,2468
7,424,323,233,980,2468
8,420,353,231,1004,2468
9,410,357,256,1023,2468
10,394,410,257,1061,2468
11,400,415,265,1080,2468
1,500,200,50,750,2469
2,453,234,103,790,2469
3,415,263,136,814,2469
4,415,308,164,887,2469
5,409,313,199,921,2469
6,388,339,227,954,2469
7,375,379,241,995,2469
8,366,389,262,1017,2469
9,359,390,293,1042,2469
10,351,408,294,1053,2469
11,386,391,301,1078,2469
1,500,200,50,750,2470
2,469,232,101,802,2470
3,420,265,143,828,2470
4,396,282,173,851,2470
5,431,322,180,933,2470
6,406,356,203,965,2470
7,405,341,234,980,2470
8,368,354,261,983,2470
9,374,392,265,1031,2470
10,385,392,274,1051,2470
11,393,421,278,1092,2470
1,500,200,50,750,2471
2,448,253,91,792,2471
3,417,261,140,818,2471
4,396,287,181,864,2471
5,404,323,191,918,2471
6,428,309,209,946,2471
7,426,332,208,966,2471
8,425,343,231,999,2471
9,416,369,248,1033,2471
10,425,392,236,1053,2471
11,414,405,250,1069,2471
1,500,200,50,750,2472
2,442,242,96,780,2472
3,434,263,132,829,2472
4,421,294,150,865,2472
5,417,327,180,924,2472
6,431,345,209,985,2472
7,382,358,237,977,2472
8,377,371,250,998,2472
9,384,398,254,1036,2472
10,358,405,284,1047,2472
11,383,405,321,1109,2472
1,500,200,50,750,2473
2,481,222,94,797,2473
3,449,241,134,824,2473
4,427,280,155,862,2473
5,415,311,202,928,2473
6,391,332,223,946,2473
7,368,346,259,973,2473
8,377,362,265,1004,2473
9,389,381,266,1036,2473
10,386,405,258,1049,2473
11,389,418,293,1100,2473
1,500,200,50,750,2474
2,459,232,96,787,2474
3,423,263,147,833,2474
4,418,294,163,875,2474
5,423,302,192,917,2474
6,412,308,227,947,2474
7,383,356,227,966,2474
8,383,371,242,996,2474
9,408,380,254,1042,2474
10,376,425,248,1049,2474
11,371,444,257,1072,2474
1,500,200,50,750,2475
2,480,229,92,801,2475
3,447,237,143,827,2475
4,418,267,171,856,2475
5,416,319,190,925,2475
6,400,341,204,945,2475
7,385,360,221,966,2475
8,382,399,228,1009,2475
9,375,414,239,1028,2475
10,406,446,223,1075,2475
11,395,432,251,1078,2475
1,500,200,50,750,2476
2,455,241,96,792,2476
3,422,260,147,829,2476
4,394,282,186,862,2476
5,408,308,197,913,2476
6,419,325,210,954,2476
7,418,325,246,989,2476
8,400,348,261,1009,2476
9,405,352,262,1019,2476
10,412,380,252,1044,2476
11,408,408,268,1084,2476
1,500,200,50,750,2477
2,461,228,97,786,2477
3,431,256,129,816,2477
4,408,270,169,847,2477
5,424,290,202,916,2477
6,422,313,217,952,2477
7,421,338,225,984,2477
8,386,370,249,1005,2477
9,373,395,272,1040,2477
10,379,409,277,1065,2477
11,364,421,282,1067,2477
1,500,200,50,750,2478
2,454,241,91,786,2478
3,410,262,137,809,2478
4,410,291,155,856,2478
5,415,316,182,913,2478
6,416,327,207,950,2478
7,408,343,217,968,2478
8,403,374,229,1006,2478
9,397,369,269,1035,2478
10,436,370,263,1069,2478
11,440,389,264,1093,2478
1,500,200,50,750,2479
2,456,225,104,785,2479
3,414,255,138,807,2479
4,413,284,170,867,2479
5,419,309,178,906,2479
6,408,327,212,947,2479
7,424,349,223,996,2479
8,397,371,236,1004,2479
9,376,393,258,1027,2479
10,402,381,265,1048,2479
11,401,396,269,1066,2479
1,500,200,50,750,2480
2,463,218,106,787,2480
3,443,272,124,839,2480
4,404,296,152,852,2480
5,400,323,177,900,2480
6,413,326,215,954,2480
7,423,345,229,997,2480
8,388,378,233,999,2480
9,427,375,247,1049,2480
10,387,395,264,1046,2480
11,396,412,283,1091,2480
1,500,200,50,750,2481
2,453,245,83,781,2481
3,437,250,129,816,2481
4,436,260,174,870,2481
5,444,289,180,913,2481
6,445,315,204,964,2481
7,419,355,207,981,2481
8,410,354,240,1004,2481
9,411,362,259,1032,2481
10,398,399,265,1062,2481
11,399,431,262,1092,2481
1,500,200,50,750,2482
2,458,247,99,804,2482
3,404,279,148,831,2482
4,390,291,178,859,2482
5,377,328,198,903,2482
6,385,351,218,954,2482
7,373,393,225,991,2482
8,365,377,252,994,2482
9,376,375,268,1019,2482
10,364,400,288,1052,2482
11,374,410,291,1075,2482
1,500,200,50,750,2483
2,462,229,100,791,2483
3,423,252,138,813,2483
4,403,299,171,873,2483
5,378,336,192,906,2483
6,374,367,214,955,2483
7,377,396,219,992,2483
8,377,393,233,1003,2483
9,395,384,249,1028,2483
10,393,368,285,1046,2483
11,411,391,297,1099,2483
1,500,200,50,750,2484
2,445,237,101,783,2484
3,425,258,132,815,2484
4,418,284,181,883,2484
5,390,303,207,900,2484
6,391,346,228,965,2484
7,368,381,234,983,2484
8,370,385,245,1000,2484
9,355,392,251,998,2484
10,388,408,263,1059,2484
11,404,421,273,1098,2484
1,500,200,50,750,2485
2,459,235,93,787,2485
3,425,263,141,829,2485
4,402,297,170,869,2485
5,392,327,199,918,2485
6,384,344,220,948,2485
7,397,360,236,993,2485
8,397,356,255,1008,2485
9,392,353,276,1021,2485
10,398,370,305,1073,2485
11,385,400,295,1080,2485
1,500,200,50,750,2486
2,455,228,100,783,2486
3,436,268,143,847,2486
4,412,303,151,866,2486
5,384,317,191,892,2486
6,376,333,228,937,2486
7,373,343,237,953,2486
8,396,359,241,996,2486
9,384,375,266,1025,2486
10,383,396,267,1046,2486
11,390,413,269,1072,2486
1,500,200,50,750,2487
2,460,219,107,786,2487
3,444,262,127,833,2487
4,431,270,157,858,2487
5,416,317,197,930,2487
6,393,338,226,957,2487
7,384,364,231,979,2487
8,387,359,252,998,2487
9,391,383,257,1031,2487
10,380,400,271,1051,2487
11,387,418,278,1083,2487
1,500,200,50,750,2488
2,458,230,100,788,2488
3,434,283,120,837,2488
4,419,313,157,889,2488
5,408,319,188,915,2488
6,426,333,194,953,2488
7,410,344,228,982,2488
8,428,357,231,1016,2488
9,402,383,251,1036,2488
10,395,396,276,1067,2488
11,401,393,278,1072,2488
1,500,200,50,750,2489
2,448,241,98,787,2489
3,411,271,143,825,2489
4,400,296,183,879,2489
5,402,330,196,928,2489
6,396,383,190,969,2489
7,384,363,236,983,2489
8,381,385,247,1013,2489
9,376,388,263,1027,2489
10,392,403,271,1066,2489
11,384,416,285,1085,2489
1,500,200,50,750,2490
2,446,239,98,783,2490
3,440,268,131,839,2490
4,430,268,168,866,2490
5,424,288,184,896,2490
6,427,344,194,965,2490
7,409,365,199,973,2490
8,435,352,229,1016,2490
9,444,348,250,1042,2490
10,429,366,260,1055,2490
11,420,392,261,1073,2490
1,500,200,50,750,2491
2,455,232,99,786,2491
3,419,280,135,834,2491
4,393,313,171,877,2491
5,377,340,202,919,2491
6,397,336,229,962,2491
7,400,348,226,974,2491
8,424,358,238,1020,2491
9,412,356,261,1029,2491
10,400,403,245,1048,2491
11,413,413,266,1092,2491
1,500,200,50,750,2492
2,452,238,102,792,2492
3,416,275,132,823,2492
4,390,320,157,867,2492
5,394,341,181,916,2492
6,383,348,216,947,2492
7,389,368,225,982,2492
8,415,370,243,1028,2492
9,419,362,245,1026,2492
10,410,391,251,1052,2492
11,379,432,282,1093,2492
1,500,200,50,750,2493
2,473,217,90,780,2493
3,436,252,121,809,2493
4,439,274,150,863,2493
5,430,295,178,903,2493
6,435,340,203,978,2493
7,412,362,217,991,2493
8,383,362,248,993,2493
9,388,381,246,1015,2493
10,402,421,262,1085,2493
11,402,408,279,1089,2493
1,500,200,50,750,2494
2,448,249,92,789,2494
3,421,268,136,825,2494
4,409,291,173,873,2494
5,401,329,193,923,2494
6,393,356,218,967,2494
7,372,378,233,983,2494
8,372,382,253,1007,2494
9,373,381,260,1014,2494
10,386,384,291,1061,2494
11,388,389,295,1072,2494
1,500,200,50,750,2495
2,457,219,98,774,2495
3,430,233,138,801,2495
4,421,282,160,863,2495
5,412,328,194,934,2495
6,416,324,226,966,2495
7,391,352,242,985,2495
8,399,359,248,1006,2495
9,401,347,277,1025,2495
10,386,374,289,1049,2495
11,409,387,283,1079,2495
1,500,200,50,750,2496
2,459,242,88,789,2496
3,426,265,127,818,2496
4,413,282,178,873,2496
5,383,324,206,913,2496
6,396,355,216,967,2496
7,361,394,230,985,2496
8,345,396,257,998,2496
9,374,382,279,1035,2496
10,382,384,284,1050,2496
11,369,403,298,1070,2496
1,500,200,50,750,2497
2,448,230,100,778,2497
3,414,272,133,819,2497
4,424,294,162,880,2497
5,417,307,191,915,2497
6,413,330,214,957,2497
7,394,341,244,979,2497
8,393,345,255,993,2497
9,407,354,271,1032,2497
10,396,395,260,1051,2497
11,395,435,256,1086,2497
1,500,200,50,750,2498
2,456,225,101,782,2498
3,438,249,133,820,2498
4,445,287,162,894,2498
5,442,292,190,924,2498
6,422,318,216,956,2498
7,413,367,208,988,2498
8,407,370,220,997,2498
9,427,368,239,1034,2498
10,392,387,270,1049,2498
11,399,410,279,1088,2498
1,500,200,50,750,2499
2,449,222,109,780,2499
3,432,242,162,836,2499
4,421,269,170,860,2499
5,426,290,191,907,2499
6,445,329,203,977,2499
7,429,339,211,979,2499
8,402,363,237,1002,2499
9,435,372,239,1046,2499
10,423,380,250,1053,2499
11,436,391,253,1080,2499
1,500,200,50,750,2500
2,448,240,97,785,2500
3,433,266,132,831,2500
4,399,314,152,865,2500
5,406,334,166,906,2500
6,407,376,184,967,2500
7,397,364,213,974,2500
8,391,360,232,983,2500
9,388,383,248,1019,2500
10,414,401,258,1073,2500
11,407,406,273,1086,2500
1,500,200,50,750,2501
2,449,233,102,784,2501
3,420,262,139,821,2501
4,413,311,159,883,2501
5,396,332,193,921,2501
6,383,340,233,956,2501
7,384,346,254,984,2501
8,372,364,261,997,2501
9,370,366,292,1028,2501
10,354,389,309,1052,2501
11,357,405,314,1076,2501
1,500,200,50,750,2502
2,461,235,102,798,2502
3,427,257,144,828,2502
4,405,291,169,865,2502
5,394,329,179,902,2502
6,399,331,209,939,2502
7,401,348,226,975,2502
8,395,372,234,1001,2502
9,394,379,261,1034,2502
10,403,395,256,1054,2502
11,410,427,258,1095,2502
1,500,200,50,750,2503
2,452,225,100,777,2503
3,425,246,146,817,2503
4,421,290,161,872,2503
5,412,331,171,914,2503
6,419,357,179,955,2503
7,405,362,219,986,2503
8,403,345,248,996,2503
9,409,372,247,1028,2503
10,399,387,262,1048,2503
11,386,406,274,1066,2503
1,500,200,50,750,2504
2,468,230,90,788,2504
3,423,247,145,815,2504
4,437,277,169,883,2504
5,437,277,204,918,2504
6,417,321,223,961,2504
7,392,324,252,968,2504
8,396,354,257,1007,2504
9,398,370,273,1041,2504
10,395,373,287,1055,2504
11,428,407,262,1097,2504
1,500,200,50,750,2505
2,453,250,92,795,2505
3,420,271,136,827,2505
4,410,300,158,868,2505
5,417,316,176,909,2505
6,420,344,199,963,2505
7,406,341,218,965,2505
8,405,367,248,1020,2505
9,383,372,281,1036,2505
10,392,397,286,1075,2505
11,390,426,270,1086,2505
1,500,200,50,750,2506
2,468,230,93,791,2506
3,422,263,141,826,2506
4,404,289,172,865,2506
5,403,295,203,901,2506
6,415,317,218,950,2506
7,416,344,236,996,2506
8,424,356,238,1018,2506
9,417,360,250,1027,2506
10,404,365,278,1047,2506
11,411,396,298,1105,2506
1,500,200,50,750,2507
2,452,233,103,788,2507
3,433,263,134,830,2507
4,416,277,158,851,2507
5,428,323,166,917,2507
6,418,330,210,958,2507
7,391,357,229,977,2507
8,398,362,255,1015,2507
9,409,368,262,1039,2507
10,393,395,263,1051,2507
11,400,381,284,1065,2507
1,500,200,50,750,2508
2,435,233,107,775,2508
3,423,260,142,825,2508
4,424,273,176,873,2508
5,403,283,215,901,2508
6,400,327,215,942,2508
7,391,347,224,962,2508
8,412,358,251,1021,2508
9,404,368,260,1032,2508
10,412,358,267,1037,2508
11,421,373,298,1092,2508
1,500,200,50,750,2509
2,462,227,91,780,2509
3,447,248,130,825,2509
4,449,281,150,880,2509
5,444,293,179,916,2509
6,441,323,202,966,2509
7,419,317,234,970,2509
8,416,347,238,1001,2509
9,411,364,254,1029,2509
10,404,385,256,1045,2509
11,390,413,287,1090,2509
1,500,200,50,750,2510
2,480,219,98,797,2510
3,437,262,139,838,2510
4,428,277,175,880,2510
5,410,305,197,912,2510
6,393,342,235,970,2510
7,358,359,253,970,2510
8,358,387,252,997,2510
9,370,389,274,1033,2510
10,369,409,276,1054,2510
11,358,427,275,1060,2510
1,500,200,50,750,2511
2,455,239,91,785,2511
3,421,270,142,833,2511
4,414,306,171,891,2511
5,401,334,167,902,2511
6,414,353,186,953,2511
7,400,378,201,979,2511
8,395,381,231,1007,2511
9,372,399,249,1020,2511
10,352,436,264,1052,2511
11,368,457,279,1104,2511
1,500,200,50,750,2512
2,458,230,91,779,2512
3,442,272,130,844,2512
4,403,301,160,864,2512
5,393,346,177,916,2512
6,378,368,200,946,2512
7,373,379,234,986,2512
8,361,383,249,993,2512
9,363,376,275,1014,2512
10,377,408,265,1050,2512
11,381,412,287,1080,2512
1,500,200,50,750,2513
2,458,239,95,792,2513
3,434,273,114,821,2513
4,414,316,152,882,2513
5,403,341,174,918,2513
6,395,360,211,966,2513
7,394,363,236,993,2513
8,393,362,251,1006,2513
9,410,373,251,1034,2513
10,427,387,247,1061,2513
11,429,415,256,1100,2513
1,500,200,50,750,2514
2,463,230,104,797,2514
3,427,261,140,828,2514
4,404,288,178,870,2514
5,377,320,215,912,2514
6,388,345,223,956,2514
7,376,377,223,976,2514
8,375,384,246,1005,2514
9,387,398,263,1048,2514
10,417,376,274,1067,2514
11,413,387,272,1072,2514
1,500,200,50,750,2515
2,453,210,110,773,2515
3,450,250,130,830,2515
4,421,282,154,857,2515
5,448,313,160,921,2515
6,417,325,210,952,2515
7,426,359,212,997,2515
8,405,381,224,1010,2515
9,411,348,256,1015,2515
10,415,364,276,1055,2515
11,385,399,284,1068,2515
1,500,200,50,750,2516
2,452,233,100,785,2516
3,454,238,148,840,2516
4,440,268,155,863,2516
5,418,317,183,918,2516
6,396,350,215,961,2516
7,368,366,235,969,2516
8,382,366,249,997,2516
9,405,362,268,1035,2516
10,388,420,245,1053,2516
11,394,417,275,1086,2516
1,500,200,50,750,2517
2,465,241,92,798,2517
3,440,263,132,835,2517
4,419,298,153,870,2517
5,396,325,184,905,2517
6,385,354,221,960,2517
7,394,373,210,977,2517
8,388,385,237,1010,2517
9,397,399,251,1047,2517
10,391,391,268,1050,2517
11,416,390,259,1065,2517
1,500,200,50,750,2518
2,440,228,116,784,2518
3,434,254,149,837,2518
4,432,260,179,871,2518
5,423,289,191,903,2518
6,414,321,218,953,2518
7,413,339,215,967,2518
8,407,350,241,998,2518
9,413,360,256,1029,2518
10,408,379,281,1068,2518
11,398,411,282,1091,2518
1,500,200,50,750,2519
2,431,235,113,779,2519
3,419,262,148,829,2519
4,402,273,180,855,2519
5,384,323,207,914,2519
6,375,342,230,947,2519
7,388,369,243,1000,2519
8,377,378,243,998,2519
9,396,371,258,1025,2519
10,415,381,247,1043,2519
11,414,384,275,1073,2519
1,500,200,50,750,2520
2,469,219,100,788,2520
3,424,261,136,821,2520
4,389,300,163,852,2520
5,395,317,211,923,2520
6,392,320,240,952,2520
7,400,362,225,987,2520
8,388,384,237,1009,2520
9,408,377,231,1016,2520
10,411,402,252,1065,2520
11,408,397,277,1082,2520
1,500,200,50,750,2521
2,451,242,98,791,2521
3,428,267,130,825,2521
4,417,290,168,875,2521
5,398,342,171,911,2521
6,410,356,219,985,2521
7,396,348,240,984,2521
8,385,365,260,1010,2521
9,401,378,269,1048,2521
10,400,368,289,1057,2521
11,425,386,284,1095,2521
1,500,200,50,750,2522
2,447,237,96,780,2522
3,429,259,145,833,2522
4,410,302,159,871,2522
5,393,348,178,919,2522
6,380,363,216,959,2522
7,377,371,223,971,2522
8,393,370,244,1007,2522
9,378,386,256,1020,2522
10,385,369,291,1045,2522
11,417,392,297,1106,2522
1,500,200,50,750,2523
2,444,239,108,791,2523
3,412,251,148,811,2523
4,408,282,173,863,2523
5,387,318,202,907,2523
6,377,352,219,948,2523
7,382,365,241,988,2523
8,380,372,256,1008,2523
9,365,393,274,1032,2523
10,372,412,272,1056,2523
11,374,428,292,1094,2523
1,500,200,50,750,2524
2,475,226,95,796,2524
3,434,250,144,828,2524
4,420,286,164,870,2524
5,407,294,213,914,2524
6,428,318,217,963,2524
7,434,315,233,982,2524
8,413,344,246,1003,2524
9,397,363,271,1031,2524
10,408,394,267,1069,2524
11,411,409,259,1079,2524
1,500,200,50,750,2525
2,453,226,108,787,2525
3,416,287,139,842,2525
4,383,320,166,869,2525
5,392,342,180,914,2525
6,392,348,210,950,2525
7,389,359,229,977,2525
8,386,376,251,1013,2525
9,376,408,258,1042,2525
10,370,409,277,1056,2525
11,381,411,283,1075,2525
1,500,200,50,750,2526
2,462,237,86,785,2526
3,458,253,122,833,2526
4,426,271,176,873,2526
5,422,283,193,898,2526
6,427,306,208,941,2526
7,420,342,212,974,2526
8,392,374,236,1002,2526
9,391,399,243,1033,2526
10,398,401,269,1068,2526
11,394,399,307,1100,2526
1,500,200,50,750,2527
2,430,253,103,786,2527
3,419,295,129,843,2527
4,394,319,159,872,2527
5,387,332,195,914,2527
6,395,360,209,964,2527
7,378,352,237,967,2527
8,400,359,243,1002,2527
9,393,387,258,1038,2527
10,396,387,270,1053,2527
11,386,404,270,1060,2527
1,500,200,50,750,2528
2,456,236,104,796,2528
3,423,270,139,832,2528
4,409,284,177,870,2528
5,404,298,203,905,2528
6,403,311,226,940,2528
7,403,341,227,971,2528
8,408,364,245,1017,2528
9,374,386,260,1020,2528
10,380,404,261,1045,2528
11,391,400,268,1059,2528
1,500,200,50,750,2529
2,447,231,104,782,2529
3,423,242,148,813,2529
4,407,290,178,875,2529
5,400,314,209,923,2529
6,407,330,216,953,2529
7,419,333,233,985,2529
8,410,347,255,1012,2529
9,405,360,272,1037,2529
10,414,373,263,1050,2529
11,427,389,267,1083,2529
1,500,200,50,750,2530
2,462,235,95,792,2530
3,451,257,127,835,2530
4,421,286,169,876,2530
5,412,282,208,902,2530
6,428,310,220,958,2530
7,424,341,218,983,2530
8,416,358,234,1008,2530
9,407,373,255,1035,2530
10,397,396,268,1061,2530
11,424,408,272,1104,2530
1,500,200,50,750,2531
2,444,246,98,788,2531
3,432,284,137,853,2531
4,426,274,177,877,2531
5,406,310,187,903,2531
6,408,339,213,960,2531
7,409,373,202,984,2531
8,401,375,224,1000,2531
9,388,384,238,1010,2531
10,399,396,258,1053,2531
11,411,412,276,1099,2531
1,500,200,50,750,2532
2,459,216,116,791,2532
3,438,235,161,834,2532
4,427,261,182,870,2532
5,425,289,192,906,2532
6,441,326,210,977,2532
7,414,330,232,976,2532
8,416,349,235,1000,2532
9,395,398,248,1041,2532
10,403,417,239,1059,2532
11,409,406,257,1072,2532
1,500,200,50,750,2533
2,460,233,101,794,2533
3,434,280,120,834,2533
4,399,304,156,859,2533
5,399,330,175,904,2533
6,410,338,211,959,2533
7,413,339,234,986,2533
8,400,377,221,998,2533
9,409,394,234,1037,2533
10,391,411,250,1052,2533
11,397,411,280,1088,2533
1,500,200,50,750,2534
2,449,245,103,797,2534
3,410,260,145,815,2534
4,426,300,164,890,2534
5,403,326,192,921,2534
6,397,336,218,951,2534
7,392,356,241,989,2534
8,381,364,261,1006,2534
9,388,378,257,1023,2534
10,387,398,277,1062,2534
11,385,404,289,1078,2534
1,500,200,50,750,2535
2,471,216,99,786,2535
3,429,255,128,812,2535
4,411,296,168,875,2535
5,382,331,187,900,2535
6,404,354,203,961,2535
7,395,369,220,984,2535
8,390,382,236,1008,2535
9,375,406,248,1029,2535
10,384,401,266,1051,2535
11,412,422,267,1101,2535
1,500,200,50,750,2536
2,462,224,103,789,2536
3,446,265,135,846,2536
4,408,267,185,860,2536
5,400,314,190,904,2536
6,401,334,215,950,2536
7,365,368,228,961,2536
8,378,394,219,991,2536
9,390,407,227,1024,2536
10,398,412,252,1062,2536
11,409,399,275,1083,2536
1,500,200,50,750,2537
2,439,225,116,780,2537
3,402,252,161,815,2537
4,432,285,163,880,2537
5,408,322,192,922,2537
6,424,338,207,969,2537
7,399,339,242,980,2537
8,394,359,237,990,2537
9,404,361,273,1038,2537
10,412,376,272,1060,2537
11,405,389,287,1081,2537
1,500,200,50,750,2538
2,447,228,107,782,2538
3,423,259,146,828,2538
4,429,271,176,876,2538
5,407,302,199,908,2538
6,404,334,213,951,2538
7,403,340,238,981,2538
8,400,359,241,1000,2538
9,407,362,263,1032,2538
10,416,368,275,1059,2538
11,415,384,265,1064,2538
1,500,200,50,750,2539
2,465,217,89,771,2539
3,438,269,127,834,2539
4,398,308,150,856,2539
5,396,327,188,911,2539
6,401,337,200,938,2539
7,412,356,207,975,2539
8,407,378,224,1009,2539
9,400,388,239,1027,2539
10,378,392,275,1045,2539
11,404,394,290,1088,2539
1,500,200,50,750,2540
2,463,226,107,796,2540
3,422,258,153,833,2540
4,400,278,186,864,2540
5,394,325,203,922,2540
6,403,339,219,961,2540
7,390,361,215,966,2540
8,394,374,229,997,2540
9,400,396,242,1038,2540
10,399,427,248,1074,2540
11,399,416,271,1086,2540
1,500,200,50,750,2541
2,475,235,88,798,2541
3,425,259,145,829,2541
4,396,273,199,868,2541
5,400,315,207,922,2541
6,401,333,240,974,2541
7,398,341,244,983,2541
8,386,346,258,990,2541
9,396,363,261,1020,2541
10,373,393,266,1032,2541
11,410,404,279,1093,2541
1,500,200,50,750,2542
2,457,247,94,798,2542
3,430,265,132,827,2542
4,412,294,163,869,2542
5,405,335,183,923,2542
6,422,333,206,961,2542
7,409,331,224,964,2542
8,396,363,242,1001,2542
9,388,356,286,1030,2542
10,391,362,299,1052,2542
11,401,406,273,1080,2542
1,500,200,50,750,2543
2,451,224,99,774,2543
3,433,274,135,842,2543
4,410,284,174,868,2543
5,406,310,201,917,2543
6,396,334,224,954,2543
7,393,360,230,983,2543
8,388,383,246,1017,2543
9,390,375,260,1025,2543
10,388,406,259,1053,2543
11,396,419,264,1079,2543
1,500,200,50,750,2544
2,454,233,93,780,2544
3,462,254,128,844,2544
4,416,285,170,871,2544
5,393,323,203,919,2544
6,384,337,228,949,2544
7,379,356,249,984,2544
8,380,362,262,1004,2544
9,375,399,254,1028,2544
10,374,393,274,1041,2544
11,387,400,287,1074,2544
1,500,200,50,750,2545
2,469,218,95,782,2545
3,465,253,123,841,2545
4,428,287,157,872,2545
5,411,302,186,899,2545
6,400,334,217,951,2545
7,393,369,226,988,2545
8,349,413,243,1005,2545
9,373,410,261,1044,2545
10,376,421,264,1061,2545
11,376,418,286,1080,2545
1,500,200,50,750,2546
2,440,226,107,773,2546
3,419,253,144,816,2546
4,407,282,166,855,2546
5,415,309,184,908,2546
6,420,347,196,963,2546
7,390,354,232,976,2546
8,393,366,242,1001,2546
9,413,364,269,1046,2546
10,397,385,275,1057,2546
11,376,424,282,1082,2546
1,500,200,50,750,2547
2,450,231,95,776,2547
3,424,256,142,822,2547
4,422,318,140,880,2547
5,416,334,172,922,2547
6,405,357,195,957,2547
7,389,362,229,980,2547
8,385,355,254,994,2547
9,396,376,270,1042,2547
10,411,368,287,1066,2547
11,387,391,285,1063,2547
1,500,200,50,750,2548
2,453,230,97,780,2548
3,439,265,133,837,2548
4,412,296,172,880,2548
5,400,311,201,912,2548
6,399,331,214,944,2548
7,413,333,238,984,2548
8,401,350,248,999,2548
9,391,373,258,1022,2548
10,388,402,267,1057,2548
11,403,412,270,1085,2548
1,500,200,50,750,2549
2,465,218,106,789,2549
3,444,230,159,833,2549
4,429,269,178,876,2549
5,406,295,212,913,2549
6,421,322,223,966,2549
7,406,335,231,972,2549
8,408,363,240,1011,2549
9,421,375,237,1033,2549
10,429,401,238,1068,2549
11,397,413,265,1075,2549
1,500,200,50,750,2550
2,471,236,83,790,2550
3,447,247,143,837,2550
4,421,276,166,863,2550
5,411,306,203,920,2550
6,404,353,197,954,2550
7,386,359,233,978,2550
8,377,379,250,1006,2550
9,410,388,259,1057,2550
10,383,392,273,1048,2550
11,383,420,281,1084,2550
1,500,200,50,750,2551
2,439,222,109,770,2551
3,423,253,146,822,2551
4,404,308,160,872,2551
5,410,325,182,917,2551
6,397,344,217,958,2551
7,380,368,230,978,2551
8,391,403,218,1012,2551
9,375,412,242,1029,2551
10,368,409,263,1040,2551
11,382,416,296,1094,2551
1,500,200,50,750,2552
2,470,195,123,788,2552
3,432,229,150,811,2552
4,431,275,175,881,2552
5,428,301,182,911,2552
6,436,314,217,967,2552
7,406,320,238,964,2552
8,438,336,243,1017,2552
9,410,357,255,1022,2552
10,428,392,249,1069,2552
11,405,408,266,1079,2552
1,500,200,50,750,2553
2,458,246,85,789,2553
3,434,286,114,834,2553
4,414,299,152,865,2553
5,406,334,172,912,2553
6,397,348,220,965,2553
7,376,362,247,985,2553
8,382,370,263,1015,2553
9,399,379,270,1048,2553
10,370,410,281,1061,2553
11,363,418,292,1073,2553
1,500,200,50,750,2554
2,456,244,92,792,2554
3,417,272,137,826,2554
4,412,292,165,869,2554
5,401,302,210,913,2554
6,380,322,236,938,2554
7,400,360,239,999,2554
8,404,362,252,1018,2554
9,396,383,261,1040,2554
10,406,392,271,1069,2554
11,394,394,272,1060,2554
1,500,200,50,750,2555
2,459,231,91,781,2555
3,434,262,133,829,2555
4,406,289,165,860,2555
5,406,344,171,921,2555
6,428,362,190,980,2555
7,410,358,209,977,2555
8,407,389,225,1021,2555
9,401,388,251,1040,2555
10,408,393,264,1065,2555
11,429,382,289,1100,2555
1,500,200,50,750,2556
2,489,217,87,793,2556
3,457,239,136,832,2556
4,444,273,160,877,2556
5,441,289,192,922,2556
6,409,323,208,940,2556
7,405,323,241,969,2556
8,429,358,234,1021,2556
9,404,384,247,1035,2556
10,434,372,250,1056,2556
11,448,387,259,1094,2556
1,500,200,50,750,2557
2,473,218,104,795,2557
3,427,255,141,823,2557
4,430,275,164,869,2557
5,410,335,168,913,2557
6,410,356,201,967,2557
7,405,357,219,981,2557
8,403,375,237,1015,2557
9,390,378,262,1030,2557
10,414,397,252,1063,2557
11,399,384,291,1074,2557
1,500,200,50,750,2558
2,454,218,116,788,2558
3,426,259,148,833,2558
4,399,294,173,866,2558
5,390,327,185,902,2558
6,384,352,203,939,2558
7,384,354,240,978,2558
8,374,390,241,1005,2558
9,378,401,256,1035,2558
10,399,403,268,1070,2558
11,395,405,281,1081,2558
1,500,200,50,750,2559
2,451,245,96,792,2559
3,438,262,133,833,2559
4,410,291,169,870,2559
5,400,324,195,919,2559
6,395,339,237,971,2559
7,395,358,232,985,2559
8,392,375,242,1009,2559
9,373,382,273,1028,2559
10,367,395,281,1043,2559
11,378,415,285,1078,2559
1,500,200,50,750,2560
2,464,236,81,781,2560
3,430,265,136,831,2560
4,396,298,170,864,2560
5,393,317,197,907,2560
6,404,326,208,938,2560
7,410,359,218,987,2560
8,398,359,240,997,2560
9,421,389,240,1050,2560
10,398,411,243,1052,2560
11,410,404,274,1088,2560
1,500,200,50,750,2561
2,478,225,83,786,2561
3,442,249,126,817,2561
4,418,281,163,862,2561
5,412,300,190,902,2561
6,412,331,203,946,2561
7,414,349,218,981,2561
8,412,368,238,1018,2561
9,398,385,250,1033,2561
10,425,397,253,1075,2561
11,411,438,234,1083,2561
1,500,200,50,750,2562
2,448,236,105,789,2562
3,412,282,137,831,2562
4,401,290,180,871,2562
5,386,320,201,907,2562
6,394,325,219,938,2562
7,370,352,255,977,2562
8,384,378,247,1009,2562
9,389,377,262,1028,2562
10,409,370,270,1049,2562
11,420,375,291,1086,2562
1,500,200,50,750,2563
2,454,210,118,782,2563
3,444,251,145,840,2563
4,410,302,153,865,2563
5,434,319,174,927,2563
6,418,336,197,951,2563
7,393,353,228,974,2563
8,407,388,225,1020,2563
9,376,405,247,1028,2563
10,397,430,245,1072,2563
11,411,408,270,1089,2563
1,500,200,50,750,2564
2,470,215,107,792,2564
3,458,242,133,833,2564
4,420,283,155,858,2564
5,414,300,181,895,2564
6,407,344,197,948,2564
7,405,381,206,992,2564
8,405,393,211,1009,2564
9,415,403,230,1048,2564
10,393,419,241,1053,2564
11,388,423,262,1073,2564
1,500,200,50,750,2565
2,463,225,90,778,2565
3,440,266,124,830,2565
4,418,287,157,862,2565
5,408,291,201,900,2565
6,404,324,220,948,2565
7,390,343,235,968,2565
8,399,347,244,990,2565
9,414,369,247,1030,2565
10,408,372,267,1047,2565
11,423,383,280,1086,2565
1,500,200,50,750,2566
2,465,222,104,791,2566
3,436,251,141,828,2566
4,412,284,171,867,2566
5,390,317,190,897,2566
6,409,353,208,970,2566
7,404,357,229,990,2566
8,384,358,248,990,2566
9,394,407,243,1044,2566
10,384,421,251,1056,2566
11,393,422,267,1082,2566
1,500,200,50,750,2567
2,456,228,94,778,2567
3,440,255,125,820,2567
4,432,276,153,861,2567
5,437,320,152,909,2567
6,436,333,180,949,2567
7,437,333,206,976,2567
8,412,352,237,1001,2567
9,417,374,254,1045,2567
10,408,387,269,1064,2567
11,406,404,285,1095,2567
1,500,200,50,750,2568
2,466,219,102,787,2568
3,430,254,142,826,2568
4,417,308,169,894,2568
5,418,312,178,908,2568
6,414,344,195,953,2568
7,399,329,244,972,2568
8,405,357,242,1004,2568
9,392,360,269,1021,2568
10,397,392,267,1056,2568
11,402,396,288,1086,2568
1,500,200,50,750,2569
2,469,234,94,797,2569
3,434,265,131,830,2569
4,417,293,153,863,2569
5,392,303,197,892,2569
6,408,334,216,958,2569
7,378,366,224,968,2569
8,395,369,234,998,2569
9,410,382,240,1032,2569
10,417,372,274,1063,2569
11,405,399,273,1077,2569
1,500,200,50,750,2570
2,467,233,92,792,2570
3,448,246,125,819,2570
4,414,294,168,876,2570
5,403,312,203,918,2570
6,391,342,210,943,2570
7,416,363,232,1011,2570
8,383,372,240,995,2570
9,390,404,232,1026,2570
10,394,431,233,1058,2570
11,414,406,269,1089,2570
1,500,200,50,750,2571
2,455,237,103,795,2571
3,416,254,146,816,2571
4,415,276,177,868,2571
5,410,309,189,908,2571
6,399,338,201,938,2571
7,421,349,209,979,2571
8,420,380,205,1005,2571
9,425,390,228,1043,2571
10,414,435,221,1070,2571
11,414,419,258,1091,2571
1,500,200,50,750,2572
2,462,230,98,790,2572
3,409,264,142,815,2572
4,406,312,177,895,2572
5,392,328,192,912,2572
6,392,324,240,956,2572
7,403,334,240,977,2572
8,378,359,257,994,2572
9,385,382,260,1027,2572
10,390,399,270,1059,2572
11,400,417,277,1094,2572
1,500,200,50,750,2573
2,468,212,113,793,2573
3,434,239,138,811,2573
4,408,271,170,849,2573
5,397,301,204,902,2573
6,406,344,216,966,2573
7,387,363,233,983,2573
8,393,368,236,997,2573
9,412,367,239,1018,2573
10,418,375,249,1042,2573
11,420,385,271,1076,2573
1,500,200,50,750,2574
2,456,231,102,789,2574
3,441,260,134,835,2574
4,423,312,144,879,2574
5,398,349,173,920,2574
6,378,372,201,951,2574
7,372,372,228,972,2574
8,391,363,229,983,2574
9,402,382,259,1043,2574
10,410,385,264,1059,2574
11,402,404,292,1098,2574
1,500,200,50,750,2575
2,473,228,96,797,2575
3,424,260,142,826,2575
4,431,277,170,878,2575
5,400,300,200,900,2575
6,435,324,210,969,2575
7,429,344,217,990,2575
8,405,375,237,1017,2575
9,383,396,243,1022,2575
10,410,409,245,1064,2575
11,382,426,265,1073,2575
1,500,200,50,750,2576
2,445,244,90,779,2576
3,436,263,113,812,2576
4,441,269,161,871,2576
5,430,301,166,897,2576
6,439,326,185,950,2576
7,443,356,188,987,2576
8,421,372,201,994,2576
9,426,363,241,1030,2576
10,412,381,261,1054,2576
11,417,412,257,1086,2576
1,500,200,50,750,2577
2,464,223,98,785,2577
3,425,252,144,821,2577
4,416,290,164,870,2577
5,412,309,187,908,2577
6,434,339,203,976,2577
7,425,348,219,992,2577
8,417,361,222,1000,2577
9,433,351,252,1036,2577
10,406,367,290,1063,2577
11,399,400,295,1094,2577
1,500,200,50,750,2578
2,440,239,97,776,2578
3,408,270,123,801,2578
4,407,289,157,853,2578
5,430,300,181,911,2578
6,431,322,195,948,2578
7,432,344,210,986,2578
8,415,370,237,1022,2578
9,400,381,247,1028,2578
10,417,398,247,1062,2578
11,392,416,276,1084,2578
1,500,200,50,750,2579
2,459,230,109,798,2579
3,420,262,139,821,2579
4,397,306,170,873,2579
5,393,310,202,905,2579
6,417,346,210,973,2579
7,413,333,233,979,2579
8,394,344,258,996,2579
9,399,382,245,1026,2579
10,404,381,264,1049,2579
11,417,392,270,1079,2579
1,500,200,50,750,2580
2,455,236,94,785,2580
3,437,261,144,842,2580
4,392,302,169,863,2580
5,396,322,198,916,2580
6,406,338,225,969,2580
7,388,363,243,994,2580
8,381,374,257,1012,2580
9,390,374,277,1041,2580
10,378,378,281,1037,2580
11,411,393,280,1084,2580
1,500,200,50,750,2581
2,445,242,93,780,2581
3,423,256,145,824,2581
4,406,286,175,867,2581
5,407,319,180,906,2581
6,402,337,202,941,2581
7,417,338,217,972,2581
8,415,360,233,1008,2581
9,403,404,234,1041,2581
10,401,390,256,1047,2581
11,411,402,282,1095,2581
1,500,200,50,750,2582
2,455,240,100,795,2582
3,416,271,139,826,2582
4,392,315,164,871,2582
5,385,333,196,914,2582
6,386,350,221,957,2582
7,387,363,243,993,2582
8,379,353,259,991,2582
9,388,384,265,1037,2582
10,371,420,262,1053,2582
11,373,440,267,1080,2582
1,500,200,50,750,2583
2,453,243,89,785,2583
3,406,294,119,819,2583
4,419,313,157,889,2583
5,376,324,188,888,2583
6,394,363,208,965,2583
7,378,359,240,977,2583
8,376,393,241,1010,2583
9,371,393,263,1027,2583
10,385,403,272,1060,2583
11,378,407,298,1083,2583
1,500,200,50,750,2584
2,460,232,102,794,2584
3,423,252,147,822,2584
4,414,283,173,870,2584
5,413,298,189,900,2584
6,428,329,205,962,2584
7,417,364,211,992,2584
8,424,359,228,1011,2584
9,435,379,236,1050,2584
10,410,366,274,1050,2584
11,410,390,274,1074,2584
1,500,200,50,750,2585
2,489,204,89,782,2585
3,459,259,112,830,2585
4,428,280,138,846,2585
5,417,301,183,901,2585
6,430,328,211,969,2585
7,418,324,249,991,2585
8,403,332,266,1001,2585
9,421,364,243,1028,2585
10,411,383,251,1045,2585
11,432,408,257,1097,2585
1,500,200,50,750,2586
2,452,251,91,794,2586
3,405,284,139,828,2586
4,395,302,167,864,2586
5,400,339,179,918,2586
6,400,367,193,960,2586
7,412,373,212,997,2586
8,409,374,220,1003,2586
9,398,385,252,1035,2586
10,401,381,276,1058,2586
11,417,392,271,1080,2586
1,500,200,50,750,2587
2,470,216,116,802,2587
3,414,261,145,820,2587
4,414,279,181,874,2587
5,409,318,190,917,2587
6,419,335,217,971,2587
7,410,348,217,975,2587
8,402,366,244,1012,2587
9,408,397,239,1044,2587
10,410,426,231,1067,2587
11,377,418,258,1053,2587
1,500,200,50,750,2588
2,451,239,94,784,2588
3,448,270,120,838,2588
4,443,274,149,866,2588
5,442,298,182,922,2588
6,438,296,222,956,2588
7,452,325,215,992,2588
8,432,331,234,997,2588
9,437,366,232,1035,2588
10,408,400,236,1044,2588
11,435,392,256,1083,2588
1,500,200,50,750,2589
2,457,244,80,781,2589
3,423,290,123,836,2589
4,412,305,151,868,2589
5,431,321,180,932,2589
6,437,297,218,952,2589
7,400,334,234,968,2589
8,400,369,240,1009,2589
9,407,383,250,1040,2589
10,388,397,258,1043,2589
11,399,413,268,1080,2589
1,500,200,50,750,2590
2,443,237,110,790,2590
3,439,249,143,831,2590
4,402,290,180,872,2590
5,409,305,202,916,2590
6,383,325,236,944,2590
7,410,344,241,995,2590
8,415,337,255,1007,2590
9,415,359,258,1032,2590
10,417,377,256,1050,2590
11,425,388,273,1086,2590
1,500,200,50,750,2591
2,465,235,93,793,2591
3,437,248,138,823,2591
4,419,293,157,869,2591
5,411,336,172,919,2591
6,394,364,200,958,2591
7,400,356,225,981,2591
8,393,384,232,1009,2591
9,403,373,261,1037,2591
10,406,383,268,1057,2591
11,407,404,268,1079,2591
1,500,200,50,750,2592
2,466,228,95,789,2592
3,440,267,135,842,2592
4,406,300,162,868,2592
5,410,317,191,918,2592
6,405,335,209,949,2592
7,403,355,213,971,2592
8,392,378,226,996,2592
9,383,390,241,1014,2592
10,389,413,238,1040,2592
11,398,424,250,1072,2592
1,500,200,50,750,2593
2,454,226,106,786,2593
3,435,256,129,820,2593
4,402,295,171,868,2593
5,411,292,214,917,2593
6,409,322,225,956,2593
7,432,321,232,985,2593
8,425,343,244,1012,2593
9,402,366,252,1020,2593
10,412,368,259,1039,2593
11,419,406,262,1087,2593
1,500,200,50,750,2594
2,460,250,84,794,2594
3,421,280,131,832,2594
4,405,284,168,857,2594
5,396,299,219,914,2594
6,394,317,234,945,2594
7,381,345,235,961,2594
8,396,347,254,997,2594
9,384,371,261,1016,2594
10,408,367,274,1049,2594
11,416,402,265,1083,2594
1,500,200,50,750,2595
2,466,227,92,785,2595
3,416,280,132,828,2595
4,401,310,155,866,2595
5,409,334,175,918,2595
6,433,338,205,976,2595
7,419,358,205,982,2595
8,404,377,225,1006,2595
9,396,406,230,1032,2595
10,395,402,255,1052,2595
11,410,432,249,1091,2595
1,500,200,50,750,2596
2,455,229,95,779,2596
3,442,277,121,840,2596
4,404,283,170,857,2596
5,403,280,210,893,2596
6,411,325,227,963,2596
7,412,319,258,989,2596
8,398,341,269,1008,2596
9,402,347,278,1027,2596
10,405,379,271,1055,2596
11,407,390,284,1081,2596
1,500,200,50,750,2597
2,472,248,78,798,2597
3,422,264,127,813,2597
4,418,306,146,870,2597
5,417,328,184,929,2597
6,405,369,193,967,2597
7,390,372,216,978,2597
8,384,373,251,1008,2597
9,390,382,260,1032,2597
10,385,407,265,1057,2597
11,373,418,286,1077,2597
1,500,200,50,750,2598
2,474,231,86,791,2598
3,451,267,118,836,2598
4,427,300,152,879,2598
5,413,304,190,907,2598
6,433,324,204,961,2598
7,416,339,221,976,2598
8,408,378,217,1003,2598
9,421,373,229,1023,2598
10,420,406,243,1069,2598
11,410,408,261,1079,2598
1,500,200,50,750,2599
2,469,233,102,804,2599
3,430,258,133,821,2599
4,395,301,156,852,2599
5,407,332,181,920,2599
6,403,346,207,956,2599
7,389,349,247,985,2599
8,395,356,260,1011,2599
9,387,385,256,1028,2599
10,400,387,275,1062,2599
11,405,391,274,1070,2599
1,500,200,50,750,2600
2,464,216,103,783,2600
3,431,245,125,801,2600
4,445,279,154,878,2600
5,432,285,191,908,2600
6,435,312,227,974,2600
7,413,351,221,985,2600
8,406,359,246,1011,2600
9,392,378,263,1033,2600
10,406,391,254,1051,2600
11,423,393,254,1070,2600
1,500,200,50,750,2601
2,447,227,101,775,2601
3,437,257,142,836,2601
4,431,277,164,872,2601
5,418,302,181,901,2601
6,423,349,202,974,2601
7,387,351,230,968,2601
8,389,367,246,1002,2601
9,388,374,265,1027,2601
10,376,413,272,1061,2601
11,408,415,275,1098,2601
1,500,200,50,750,2602
2,458,242,91,791,2602
3,419,273,119,811,2602
4,404,288,159,851,2602
5,392,331,192,915,2602
6,406,350,208,964,2602
7,390,364,224,978,2602
8,388,373,236,997,2602
9,389,389,244,1022,2602
10,389,411,244,1044,2602
11,392,397,280,1069,2602
1,500,200,50,750,2603
2,452,245,88,785,2603
3,425,283,111,819,2603
4,388,319,158,865,2603
5,392,342,182,916,2603
6,390,351,213,954,2603
7,402,348,235,985,2603
8,404,371,234,1009,2603
9,400,370,259,1029,2603
10,421,372,270,1063,2603
11,413,393,281,1087,2603
1,500,200,50,750,2604
2,440,258,90,788,2604
3,411,297,127,835,2604
4,374,302,169,845,2604
5,376,326,180,882,2604
6,404,357,185,946,2604
7,406,362,207,975,2604
8,397,402,205,1004,2604
9,399,406,227,1032,2604
10,419,394,245,1058,2604
11,408,413,260,1081,2604
1,500,200,50,750,2605
2,466,217,102,785,2605
3,432,273,130,835,2605
4,411,292,176,879,2605
5,399,341,181,921,2605
6,372,379,201,952,2605
7,378,386,236,1000,2605
8,355,409,244,1008,2605
9,380,429,246,1055,2605
10,386,433,254,1073,2605
11,370,449,264,1083,2605
1,500,200,50,750,2606
2,446,233,101,780,2606
3,411,282,127,820,2606
4,402,305,163,870,2606
5,395,331,182,908,2606
6,397,344,205,946,2606
7,402,358,235,995,2606
8,386,378,243,1007,2606
9,372,359,292,1023,2606
10,389,387,295,1071,2606
11,381,414,284,1079,2606
1,500,200,50,750,2607
2,460,225,97,782,2607
3,424,258,137,819,2607
4,424,300,157,881,2607
5,425,315,176,916,2607
6,415,318,203,936,2607
7,399,342,226,967,2607
8,399,360,238,997,2607
9,414,389,245,1048,2607
10,396,399,264,1059,2607
11,412,398,279,1089,2607
1,500,200,50,750,2608
2,463,223,91,777,2608
3,435,256,121,812,2608
4,410,282,172,864,2608
5,419,301,201,921,2608
6,400,318,234,952,2608
7,403,343,233,979,2608
8,418,375,227,1020,2608
9,414,380,245,1039,2608
10,414,400,238,1052,2608
11,439,382,260,1081,2608
1,500,200,50,750,2609
2,470,216,101,787,2609
3,440,254,144,838,2609
4,415,278,176,869,2609
5,401,307,192,900,2609
6,398,343,211,952,2609
7,385,365,239,989,2609
8,372,387,241,1000,2609
9,378,398,253,1029,2609
10,401,395,277,1073,2609
11,397,394,283,1074,2609
1,500,200,50,750,2610
2,471,226,101,798,2610
3,445,256,114,815,2610
4,445,279,144,868,2610
5,425,287,190,902,2610
6,426,318,210,954,2610
7,411,351,221,983,2610
8,423,365,224,1012,2610
9,438,378,232,1048,2610
10,424,377,258,1059,2610
11,419,395,263,1077,2610
1,500,200,50,750,2611
2,450,231,103,784,2611
3,434,263,136,833,2611
4,395,311,163,869,2611
5,398,330,184,912,2611
6,384,340,219,943,2611
7,392,385,205,982,2611
8,396,398,216,1010,2611
9,401,374,251,1026,2611
10,378,391,272,1041,2611
11,392,419,274,1085,2611
1,500,200,50,750,2612
2,467,230,93,790,2612
3,442,260,133,835,2612
4,415,271,174,860,2612
5,419,303,189,911,2612
6,432,342,189,963,2612
7,417,354,198,969,2612
8,414,353,253,1020,2612
9,429,384,241,1054,2612
10,416,383,260,1059,2612
11,408,423,256,1087,2612
1,500,200,50,750,2613
2,460,214,112,786,2613
3,442,265,130,837,2613
4,415,298,155,868,2613
5,419,318,184,921,2613
6,401,324,237,962,2613
7,382,357,228,967,2613
8,401,360,254,1015,2613
9,393,357,277,1027,2613
10,403,376,277,1056,2613
11,406,380,285,1071,2613
1,500,200,50,750,2614
2,459,221,99,779,2614
3,434,262,117,813,2614
4,426,312,147,885,2614
5,411,329,173,913,2614
6,390,359,195,944,2614
7,395,389,200,984,2614
8,389,398,220,1007,2614
9,386,393,247,1026,2614
10,404,410,246,1060,2614
11,397,425,260,1082,2614
1,500,200,50,750,2615
2,468,214,107,789,2615
3,437,237,142,816,2615
4,402,295,158,855,2615
5,396,323,181,900,2615
6,407,343,216,966,2615
7,405,366,223,994,2615
8,403,381,239,1023,2615
9,391,380,261,1032,2615
10,392,378,271,1041,2615
11,398,388,293,1079,2615
1,500,200,50,750,2616
2,437,239,104,780,2616
3,411,275,146,832,2616
4,394,285,187,866,2616
5,381,333,212,926,2616
6,363,348,240,951,2616
7,347,391,242,980,2616
8,343,395,264,1002,2616
9,349,391,278,1018,2616
10,380,393,294,1067,2616
11,372,402,317,1091,2616
1,500,200,50,750,2617
2,468,221,94,783,2617
3,439,251,134,824,2617
4,456,279,144,879,2617
5,429,294,163,886,2617
6,433,336,184,953,2617
7,421,357,198,976,2617
8,404,376,215,995,2617
9,415,393,225,1033,2617
10,406,390,245,1041,2617
11,416,396,272,1084,2617
1,500,200,50,750,2618
2,468,233,94,795,2618
3,426,272,135,833,2618
4,408,306,155,869,2618
5,392,337,183,912,2618
6,382,357,195,934,2618
7,394,385,215,994,2618
8,409,376,217,1002,2618
9,416,390,241,1047,2618
10,403,407,254,1064,2618
11,405,414,269,1088,2618
1,500,200,50,750,2619
2,464,239,91,794,2619
3,427,267,138,832,2619
4,390,314,160,864,2619
5,406,332,181,919,2619
6,408,340,212,960,2619
7,393,362,217,972,2619
8,386,355,257,998,2619
9,400,367,263,1030,2619
10,401,388,265,1054,2619
11,410,405,267,1082,2619
1,500,200,50,750,2620
2,468,224,95,787,2620
3,420,263,127,810,2620
4,410,290,173,873,2620
5,426,318,187,931,2620
6,416,339,196,951,2620
7,427,353,213,993,2620
8,412,376,222,1010,2620
9,399,389,237,1025,2620
10,400,391,273,1064,2620
11,394,415,285,1094,2620
1,500,200,50,750,2621
2,457,231,91,779,2621
3,449,260,117,826,2621
4,446,267,148,861,2621
5,443,279,179,901,2621
6,446,324,196,966,2621
7,414,353,210,977,2621
8,416,348,241,1005,2621
9,408,355,253,1016,2621
10,403,377,280,1060,2621
11,399,417,274,1090,2621
1,500,200,50,750,2622
2,450,240,95,785,2622
3,429,270,133,832,2622
4,422,293,169,884,2622
5,384,321,195,900,2622
6,405,353,210,968,2622
7,384,364,232,980,2622
8,405,377,225,1007,2622
9,393,391,246,1030,2622
10,390,410,267,1067,2622
11,381,409,283,1073,2622
1,500,200,50,750,2623
2,449,230,101,780,2623
3,437,259,137,833,2623
4,425,293,162,880,2623
5,416,324,172,912,2623
6,397,350,195,942,2623
7,392,378,220,990,2623
8,394,370,233,997,2623
9,381,395,246,1022,2623
10,357,439,255,1051,2623
11,396,424,274,1094,2623
1,500,200,50,750,2624
2,452,254,87,793,2624
3,421,271,127,819,2624
4,413,312,147,872,2624
5,412,310,190,912,2624
6,387,375,209,971,2624
7,364,375,231,970,2624
8,373,383,245,1001,2624
9,418,377,264,1059,2624
10,405,370,275,1050,2624
11,407,393,284,1084,2624
1,500,200,50,750,2625
2,475,232,90,797,2625
3,441,239,132,812,2625
4,434,264,156,854,2625
5,418,280,184,882,2625
6,419,310,209,938,2625
7,422,344,217,983,2625
8,401,376,240,1017,2625
9,401,357,282,1040,2625
10,386,405,254,1045,2625
11,379,399,280,1058,2625
1,500,200,50,750,2626
2,475,223,96,794,2626
3,436,256,136,828,2626
4,409,281,169,859,2626
5,412,336,162,910,2626
6,400,341,214,955,2626
7,395,359,236,990,2626
8,406,371,229,1006,2626
9,376,386,267,1029,2626
10,392,407,272,1071,2626
11,389,415,289,1093,2626
1,500,200,50,750,2627
2,449,217,105,771,2627
3,441,242,143,826,2627
4,414,261,170,845,2627
5,414,298,197,909,2627
6,395,341,208,944,2627
7,415,371,203,989,2627
8,399,368,242,1009,2627
9,393,375,265,1033,2627
10,411,378,276,1065,2627
11,397,402,283,1082,2627
1,500,200,50,750,2628
2,445,232,96,773,2628
3,422,251,150,823,2628
4,429,278,176,883,2628
5,406,309,207,922,2628
6,410,326,226,962,2628
7,401,353,237,991,2628
8,383,369,263,1015,2628
9,399,373,267,1039,2628
10,412,383,273,1068,2628
11,397,398,298,1093,2628
1,500,200,50,750,2629
2,443,241,98,782,2629
3,439,237,148,824,2629
4,429,271,167,867,2629
5,405,304,201,910,2629
6,413,323,230,966,2629
7,400,342,233,975,2629
8,412,362,233,1007,2629
9,395,395,240,1030,2629
10,392,396,261,1049,2629
11,406,414,273,1093,2629
1,500,200,50,750,2630
2,458,240,96,794,2630
3,433,272,126,831,2630
4,411,292,161,864,2630
5,398,338,178,914,2630
6,395,365,196,956,2630
7,411,362,215,988,2630
8,387,362,248,997,2630
9,393,353,283,1029,2630
10,399,383,281,1063,2630
11,384,430,274,1088,2630
1,500,200,50,750,2631
2,466,222,107,795,2631
3,432,244,151,827,2631
4,421,292,164,877,2631
5,407,301,189,897,2631
6,420,338,187,945,2631
7,419,336,217,972,2631
8,417,349,223,989,2631
9,413,378,239,1030,2631
10,411,386,255,1052,2631
11,426,410,273,1109,2631
1,500,200,50,750,2632
2,453,243,93,789,2632
3,427,275,135,837,2632
4,405,287,173,865,2632
5,390,325,193,908,2632
6,403,340,217,960,2632
7,389,365,232,986,2632
8,380,350,270,1000,2632
9,381,378,267,1026,2632
10,398,394,258,1050,2632
11,408,383,289,1080,2632
1,500,200,50,750,2633
2,464,240,96,800,2633
3,427,269,135,831,2633
4,415,299,153,867,2633
5,397,327,176,900,2633
6,383,347,206,936,2633
7,370,389,217,976,2633
8,385,375,249,1009,2633
9,399,370,267,1036,2633
10,399,396,258,1053,2633
11,381,419,274,1074,2633
1,500,200,50,750,2634
2,466,222,109,797,2634
3,439,265,127,831,2634
4,410,284,169,863,2634
5,407,301,199,907,2634
6,395,327,230,952,2634
7,397,359,242,998,2634
8,379,368,249,996,2634
9,381,376,275,1032,2634
10,362,417,285,1064,2634
11,365,431,292,1088,2634
1,500,200,50,750,2635
2,454,217,108,779,2635
3,445,254,132,831,2635
4,421,290,167,878,2635
5,399,314,205,918,2635
6,379,327,244,950,2635
7,378,350,248,976,2635
8,376,363,266,1005,2635
9,368,373,280,1021,2635
10,398,385,276,1059,2635
11,404,393,275,1072,2635
1,500,200,50,750,2636
2,482,234,82,798,2636
3,451,253,120,824,2636
4,427,303,158,888,2636
5,404,311,198,913,2636
6,394,354,205,953,2636
7,404,361,214,979,2636
8,415,363,242,1020,2636
9,392,363,274,1029,2636
10,418,378,277,1073,2636
11,407,376,301,1084,2636
1,500,200,50,750,2637
2,464,232,95,791,2637
3,442,267,114,823,2637
4,438,272,162,872,2637
5,401,286,209,896,2637
6,414,338,214,966,2637
7,397,344,243,984,2637
8,410,386,244,1040,2637
9,400,366,260,1026,2637
10,394,360,280,1034,2637
11,416,368,306,1090,2637
1,500,200,50,750,2638
2,472,223,98,793,2638
3,439,255,137,831,2638
4,427,264,168,859,2638
5,426,293,190,909,2638
6,408,327,207,942,2638
7,396,365,217,978,2638
8,388,365,235,988,2638
9,401,371,252,1024,2638
10,402,403,259,1064,2638
11,411,418,259,1088,2638
1,500,200,50,750,2639
2,456,246,91,793,2639
3,422,276,129,827,2639
4,430,293,158,881,2639
5,415,340,171,926,2639
6,375,373,198,946,2639
7,386,374,218,978,2639
8,381,377,239,997,2639
9,382,387,260,1029,2639
10,381,389,277,1047,2639
11,394,423,260,1077,2639
1,500,200,50,750,2640
2,462,234,90,786,2640
3,437,254,126,817,2640
4,417,279,166,862,2640
5,406,302,192,900,2640
6,431,335,196,962,2640
7,391,336,235,962,2640
8,407,363,236,1006,2640
9,391,395,242,1028,2640
10,381,407,267,1055,2640
11,410,424,259,1093,2640
1,500,200,50,750,2641
2,468,228,95,791,2641
3,447,248,123,818,2641
4,442,283,153,878,2641
5,428,281,203,912,2641
6,411,304,237,952,2641
7,412,337,229,978,2641
8,414,349,248,1011,2641
9,406,365,253,1024,2641
10,434,352,272,1058,2641
11,434,382,277,1093,2641
1,500,200,50,750,2642
2,461,241,96,798,2642
3,437,252,133,822,2642
4,447,262,165,874,2642
5,417,312,180,909,2642
6,409,342,189,940,2642
7,417,371,203,991,2642
8,412,376,216,1004,2642
9,411,370,257,1038,2642
10,402,393,257,1052,2642
11,425,385,280,1090,2642
1,500,200,50,750,2643
2,456,232,101,789,2643
3,421,267,126,814,2643
4,414,311,146,871,2643
5,405,322,190,917,2643
6,412,353,210,975,2643
7,399,359,217,975,2643
8,397,358,250,1005,2643
9,393,351,274,1018,2643
10,417,382,265,1064,2643
11,416,397,269,1082,2643
1,500,200,50,750,2644
2,455,235,105,795,2644
3,418,274,140,832,2644
4,410,297,170,877,2644
5,405,298,212,915,2644
6,418,320,213,951,2644
7,410,347,227,984,2644
8,409,366,235,1010,2644
9,414,381,251,1046,2644
10,392,393,264,1049,2644
11,397,406,279,1082,2644
1,500,200,50,750,2645
2,456,219,105,780,2645
3,445,255,145,845,2645
4,412,295,157,864,2645
5,417,311,173,901,2645
6,401,338,207,946,2645
7,404,372,223,999,2645
8,392,377,243,1012,2645
9,400,368,257,1025,2645
10,392,394,285,1071,2645
11,386,424,281,1091,2645
1,500,200,50,750,2646
2,448,234,88,770,2646
3,412,259,138,809,2646
4,415,300,162,877,2646
5,402,346,185,933,2646
6,397,366,190,953,2646
7,373,394,210,977,2646
8,363,404,230,997,2646
9,360,411,244,1015,2646
10,369,434,255,1058,2646
11,398,432,270,1100,2646
1,500,200,50,750,2647
2,460,231,96,787,2647
3,420,255,143,818,2647
4,409,289,177,875,2647
5,406,316,190,912,2647
6,389,355,203,947,2647
7,385,377,224,986,2647
8,373,396,243,1012,2647
9,375,405,240,1020,2647
10,387,423,247,1057,2647
11,397,410,282,1089,2647
1,500,200,50,750,2648
2,447,235,106,788,2648
3,401,272,135,808,2648
4,407,295,170,872,2648
5,389,322,195,906,2648
6,391,327,212,930,2648
7,399,337,244,980,2648
8,428,355,246,1029,2648
9,381,375,265,1021,2648
10,404,387,264,1055,2648
11,401,384,279,1064,2648
1,500,200,50,750,2649
2,462,224,85,771,2649
3,453,251,131,835,2649
4,448,276,158,882,2649
5,402,319,175,896,2649
6,410,367,185,962,2649
7,430,359,204,993,2649
8,427,366,223,1016,2649
9,408,384,238,1030,2649
10,389,412,257,1058,2649
11,385,406,284,1075,2649
1,500,200,50,750,2650
2,461,233,99,793,2650
3,428,267,141,836,2650
4,431,275,160,866,2650
5,413,318,181,912,2650
6,415,348,202,965,2650
7,399,366,221,986,2650
8,397,373,236,1006,2650
9,394,372,252,1018,2650
10,413,416,242,1071,2650
11,412,414,253,1079,2650
1,500,200,50,750,2651
2,452,222,114,788,2651
3,439,227,154,820,2651
4,410,268,179,857,2651
5,390,313,204,907,2651
6,396,346,229,971,2651
7,380,361,235,976,2651
8,388,363,246,997,2651
9,378,401,266,1045,2651
10,380,418,268,1066,2651
11,380,421,282,1083,2651
1,500,200,50,750,2652
2,490,227,86,803,2652
3,444,245,137,826,2652
4,426,271,168,865,2652
5,439,295,185,919,2652
6,430,322,210,962,2652
7,419,347,219,985,2652
8,422,365,219,1006,2652
9,411,379,242,1032,2652
10,409,399,255,1063,2652
11,408,399,273,1080,2652
1,500,200,50,750,2653
2,448,229,103,780,2653
3,429,267,142,838,2653
4,397,291,176,864,2653
5,415,324,183,922,2653
6,397,336,226,959,2653
7,394,343,238,975,2653
8,407,373,238,1018,2653
9,392,394,245,1031,2653
10,386,408,255,1049,2653
11,383,459,254,1096,2653
1,500,200,50,750,2654
2,458,241,85,784,2654
3,435,262,123,820,2654
4,427,293,148,868,2654
5,430,317,171,918,2654
6,446,338,187,971,2654
7,383,358,235,976,2654
8,386,388,251,1025,2654
9,367,425,233,1025,2654
10,358,448,245,1051,2654
11,388,440,277,1105,2654
1,500,200,50,750,2655
2,445,241,99,785,2655
3,430,264,138,832,2655
4,398,281,183,862,2655
5,401,337,197,935,2655
6,392,360,202,954,2655
7,378,379,223,980,2655
8,376,375,251,1002,2655
9,368,394,259,1021,2655
10,362,407,262,1031,2655
11,385,427,268,1080,2655
1,500,200,50,750,2656
2,480,231,91,802,2656
3,430,253,143,826,2656
4,418,286,168,872,2656
5,415,322,183,920,2656
6,394,367,202,963,2656
7,370,402,209,981,2656
8,373,391,238,1002,2656
9,395,373,265,1033,2656
10,402,398,258,1058,2656
11,399,402,267,1068,2656
1,500,200,50,750,2657
2,460,232,97,789,2657
3,428,269,134,831,2657
4,416,290,155,861,2657
5,400,309,189,898,2657
6,394,367,203,964,2657
7,390,367,226,983,2657
8,389,394,225,1008,2657
9,391,391,251,1033,2657
10,380,397,258,1035,2657
11,401,402,256,1059,2657
1,500,200,50,750,2658
2,450,246,97,793,2658
3,416,265,139,820,2658
4,395,285,179,859,2658
5,408,302,200,910,2658
6,412,338,216,966,2658
7,402,359,234,995,2658
8,387,372,247,1006,2658
9,382,390,260,1032,2658
10,378,393,278,1049,2658
11,403,399,274,1076,2658
1,500,200,50,750,2659
2,454,226,112,792,2659
3,419,258,151,828,2659
4,411,296,166,873,2659
5,400,299,203,902,2659
6,398,347,217,962,2659
7,380,352,246,978,2659
8,375,368,253,996,2659
9,396,386,253,1035,2659
10,384,396,262,1042,2659
11,385,412,288,1085,2659
1,500,200,50,750,2660
2,458,219,109,786,2660
3,416,278,137,831,2660
4,396,297,167,860,2660
5,405,306,191,902,2660
6,383,342,211,936,2660
7,380,374,225,979,2660
8,399,348,253,1000,2660
9,408,355,270,1033,2660
10,410,394,269,1073,2660
11,409,388,282,1079,2660
1,500,200,50,750,2661
2,467,224,104,795,2661
3,453,252,142,847,2661
4,409,275,173,857,2661
5,414,279,213,906,2661
6,421,301,228,950,2661
7,431,331,227,989,2661
8,408,344,240,992,2661
9,430,383,236,1049,2661
10,415,387,257,1059,2661
11,395,379,282,1056,2661
1,500,200,50,750,2662
2,447,237,98,782,2662
3,432,265,136,833,2662
4,411,283,165,859,2662
5,397,289,205,891,2662
6,402,318,238,958,2662
7,409,329,249,987,2662
8,413,330,262,1005,2662
9,426,369,252,1047,2662
10,411,377,274,1062,2662
11,419,382,272,1073,2662
1,500,200,50,750,2663
2,463,224,111,798,2663
3,429,264,134,827,2663
4,426,280,161,867,2663
5,424,311,179,914,2663
6,427,326,206,959,2663
7,426,362,219,1007,2663
8,405,373,241,1019,2663
9,402,363,265,1030,2663
10,409,384,262,1055,2663
11,404,398,275,1077,2663
1,500,200,50,750,2664
2,461,237,92,790,2664
3,417,267,134,818,2664
4,425,289,175,889,2664
5,402,323,186,911,2664
6,416,322,220,958,2664
7,400,350,240,990,2664
8,403,368,235,1006,2664
9,416,381,238,1035,2664
10,410,405,242,1057,2664
11,389,413,270,1072,2664
1,500,200,50,750,2665
2,460,227,99,786,2665
3,456,233,140,829,2665
4,440,273,151,864,2665
5,424,308,169,901,2665
6,419,338,185,942,2665
7,424,347,217,988,2665
8,416,360,239,1015,2665
9,411,386,243,1040,2665
10,407,391,261,1059,2665
11,379,418,274,1071,2665
1,500,200,50,750,2666
2,466,223,96,785,2666
3,436,257,136,829,2666
4,415,298,160,873,2666
5,414,316,189,919,2666
6,405,342,216,963,2666
7,414,357,214,985,2666
8,394,364,239,997,2666
9,375,404,252,1031,2666
10,387,407,253,1047,2666
11,385,416,272,1073,2666
1,500,200,50,750,2667
2,447,230,109,786,2667
3,433,264,130,827,2667
4,422,284,164,870,2667
5,428,304,198,930,2667
6,421,303,230,954,2667
7,410,343,235,988,2667
8,432,352,223,1007,2667
9,433,377,237,1047,2667
10,436,404,243,1083,2667
11,433,413,238,1084,2667
1,500,200,50,750,2668
2,466,242,81,789,2668
3,438,257,127,822,2668
4,422,286,163,871,2668
5,423,310,188,921,2668
6,439,320,203,962,2668
7,415,338,219,972,2668
8,388,368,261,1017,2668
9,372,374,282,1028,2668
10,389,402,270,1061,2668
11,370,422,281,1073,2668
1,500,200,50,750,2669
2,478,217,97,792,2669
3,445,239,144,828,2669
4,424,253,194,871,2669
5,401,289,217,907,2669
6,424,317,237,978,2669
7,394,336,256,986,2669
8,394,359,239,992,2669
9,407,369,253,1029,2669
10,404,398,254,1056,2669
11,379,414,274,1067,2669
1,500,200,50,750,2670
2,450,241,105,796,2670
3,433,278,139,850,2670
4,409,297,159,865,2670
5,412,320,182,914,2670
6,421,324,207,952,2670
7,395,365,222,982,2670
8,398,376,235,1009,2670
9,390,394,249,1033,2670
10,393,382,266,1041,2670
11,396,403,283,1082,2670
1,500,200,50,750,2671
2,484,206,96,786,2671
3,456,251,124,831,2671
4,443,287,139,869,2671
5,411,307,190,908,2671
6,398,338,212,948,2671
7,402,350,245,997,2671
8,381,361,269,1011,2671
9,379,372,270,1021,2671
10,363,401,287,1051,2671
11,376,396,316,1088,2671
1,500,200,50,750,2672
2,468,226,103,797,2672
3,447,260,125,832,2672
4,426,300,147,873,2672
5,405,308,185,898,2672
6,418,347,194,959,2672
7,404,351,231,986,2672
8,412,353,250,1015,2672
9,407,383,239,1029,2672
10,390,418,245,1053,2672
11,375,438,262,1075,2672
1,500,200,50,750,2673
2,461,236,92,789,2673
3,417,278,135,830,2673
4,392,311,166,869,2673
5,387,337,191,915,2673
6,377,366,212,955,2673
7,390,361,233,984,2673
8,406,362,237,1005,2673
9,397,385,258,1040,2673
10,393,394,269,1056,2673
11,406,383,292,1081,2673
1,500,200,50,750,2674
2,457,233,98,788,2674
3,423,259,146,828,2674
4,406,288,176,870,2674
5,398,328,198,924,2674
6,384,331,238,953,2674
7,394,367,233,994,2674
8,382,366,243,991,2674
9,388,368,261,1017,2674
10,390,375,293,1058,2674
11,402,382,280,1064,2674
1,500,200,50,750,2675
2,464,232,89,785,2675
3,436,255,142,833,2675
4,416,279,169,864,2675
5,411,308,198,917,2675
6,415,345,209,969,2675
7,402,373,213,988,2675
8,384,398,221,1003,2675
9,373,401,249,1023,2675
10,400,402,255,1057,2675
11,400,432,264,1096,2675
1,500,200,50,750,2676
2,455,234,91,780,2676
3,435,242,136,813,2676
4,413,278,160,851,2676
5,400,302,198,900,2676
6,393,338,226,957,2676
7,390,341,250,981,2676
8,399,358,242,999,2676
9,395,375,248,1018,2676
10,417,374,262,1053,2676
11,447,376,262,1085,2676
1,500,200,50,750,2677
2,461,209,104,774,2677
3,447,242,143,832,2677
4,433,277,164,874,2677
5,427,282,190,899,2677
6,441,294,221,956,2677
7,421,342,218,981,2677
8,403,348,239,990,2677
9,415,365,249,1029,2677
10,401,382,277,1060,2677
11,386,419,257,1062,2677
1,500,200,50,750,2678
2,470,229,102,801,2678
3,429,260,138,827,2678
4,438,282,167,887,2678
5,409,335,162,906,2678
6,417,331,207,955,2678
7,394,352,222,968,2678
8,396,383,229,1008,2678
9,407,380,256,1043,2678
10,386,419,249,1054,2678
11,381,418,269,1068,2678
1,500,200,50,750,2679
2,459,213,108,780,2679
3,430,255,122,807,2679
4,417,292,152,861,2679
5,438,313,175,926,2679
6,408,325,213,946,2679
7,414,340,231,985,2679
8,411,365,221,997,2679
9,400,393,248,1041,2679
10,383,405,277,1065,2679
11,380,411,286,1077,2679
1,500,200,50,750,2680
2,459,240,97,796,2680
3,417,272,140,829,2680
4,398,291,163,852,2680
5,403,319,189,911,2680
6,402,369,188,959,2680
7,394,356,215,965,2680
8,393,379,227,999,2680
9,394,382,257,1033,2680
10,397,404,269,1070,2680
11,393,394,292,1079,2680
1,500,200,50,750,2681
2,468,234,88,790,2681
3,435,277,113,825,2681
4,418,312,134,864,2681
5,424,334,180,938,2681
6,412,345,202,959,2681
7,401,367,210,978,2681
8,408,381,234,1023,2681
9,361,393,270,1024,2681
10,394,387,292,1073,2681
11,383,412,291,1086,2681
1,500,200,50,750,2682
2,463,242,94,799,2682
3,438,265,124,827,2682
4,410,308,154,872,2682
5,395,320,194,909,2682
6,420,336,208,964,2682
7,421,324,256,1001,2682
8,402,336,267,1005,2682
9,378,364,278,1020,2682
10,383,383,278,1044,2682
11,395,390,284,1069,2682
1,500,200,50,750,2683
2,462,226,95,783,2683
3,436,258,118,812,2683
4,427,297,151,875,2683
5,415,329,190,934,2683
6,402,334,233,969,2683
7,383,347,245,975,2683
8,389,357,252,998,2683
9,372,372,284,1028,2683
10,382,389,291,1062,2683
11,386,404,304,1094,2683
1,500,200,50,750,2684
2,448,240,101,789,2684
3,430,266,127,823,2684
4,423,290,162,875,2684
5,418,319,196,933,2684
6,417,333,212,962,2684
7,392,350,240,982,2684
8,386,366,268,1020,2684
9,371,380,266,1017,2684
10,380,407,274,1061,2684
11,393,413,288,1094,2684
1,500,200,50,750,2685
2,448,225,100,773,2685
3,425,261,139,825,2685
4,409,275,165,849,2685
5,412,306,181,899,2685
6,424,346,196,966,2685
7,409,371,209,989,2685
8,399,380,223,1002,2685
9,388,372,259,1019,2685
10,388,391,271,1050,2685
11,371,396,293,1060,2685
1,500,200,50,750,2686
2,452,238,104,794,2686
3,423,264,142,829,2686
4,400,276,180,856,2686
5,406,302,193,901,2686
6,429,322,214,965,2686
7,418,322,238,978,2686
8,399,334,252,985,2686
9,421,345,273,1039,2686
10,402,385,267,1054,2686
11,400,388,303,1091,2686
1,500,200,50,750,2687
2,463,219,105,787,2687
3,426,255,140,821,2687
4,412,303,151,866,2687
5,399,308,192,899,2687
6,408,334,225,967,2687
7,393,331,262,986,2687
8,361,367,284,1012,2687
9,373,395,267,1035,2687
10,367,387,292,1046,2687
11,387,393,307,1087,2687
1,500,200,50,750,2688
2,453,222,101,776,2688
3,422,256,130,808,2688
4,430,284,154,868,2688
5,421,317,162,900,2688
6,414,347,196,957,2688
7,389,372,216,977,2688
8,383,378,259,1020,2688
9,388,402,244,1034,2688
10,382,415,267,1064,2688
11,400,432,263,1095,2688
1,500,200,50,750,2689
2,471,224,91,786,2689
3,438,264,135,837,2689
4,420,275,169,864,2689
5,427,324,176,927,2689
6,395,341,221,957,2689
7,399,368,214,981,2689
8,398,376,237,1011,2689
9,403,366,264,1033,2689
10,400,396,263,1059,2689
11,412,411,262,1085,2689
1,500,200,50,750,2690
2,462,219,104,785,2690
3,432,270,128,830,2690
4,417,302,145,864,2690
5,427,319,175,921,2690
6,406,342,207,955,2690
7,404,363,235,1002,2690
8,370,391,246,1007,2690
9,374,387,265,1026,2690
10,379,397,294,1070,2690
11,387,407,286,1080,2690
1,500,200,50,750,2691
2,484,210,92,786,2691
3,460,229,133,822,2691
4,474,270,146,890,2691
5,430,317,162,909,2691
6,424,336,194,954,2691
7,434,351,216,1001,2691
8,411,362,236,1009,2691
9,411,363,260,1034,2691
10,396,387,268,1051,2691
11,398,419,254,1071,2691
1,500,200,50,750,2692
2,440,236,116,792,2692
3,414,260,153,827,2692
4,401,290,173,864,2692
5,402,302,200,904,2692
6,390,358,209,957,2692
7,370,376,219,965,2692
8,386,377,242,1005,2692
9,398,375,254,1027,2692
10,410,378,273,1061,2692
11,416,399,276,1091,2692
1,500,200,50,750,2693
2,461,222,93,776,2693
3,397,273,146,816,2693
4,387,305,177,869,2693
5,354,332,208,894,2693
6,358,339,238,935,2693
7,378,374,240,992,2693
8,389,371,250,1010,2693
9,388,389,251,1028,2693
10,407,404,249,1060,2693
11,397,396,277,1070,2693
1,500,200,50,750,2694
2,485,224,87,796,2694
3,455,237,136,828,2694
4,437,266,155,858,2694
5,417,309,193,919,2694
6,419,324,212,955,2694
7,408,352,225,985,2694
8,395,356,250,1001,2694
9,386,364,265,1015,2694
10,408,391,275,1074,2694
11,397,392,306,1095,2694
1,500,200,50,750,2695
2,470,238,101,809,2695
3,425,263,144,832,2695
4,439,286,168,893,2695
5,404,318,181,903,2695
6,411,357,189,957,2695
7,415,378,195,988,2695
8,412,375,217,1004,2695
9,406,400,235,1041,2695
10,406,401,245,1052,2695
11,434,412,256,1102,2695
1,500,200,50,750,2696
2,458,234,96,788,2696
3,446,251,134,831,2696
4,418,298,150,866,2696
5,406,320,187,913,2696
6,392,339,229,960,2696
7,373,352,238,963,2696
8,371,346,287,1004,2696
9,380,365,270,1015,2696
10,361,396,283,1040,2696
11,373,409,288,1070,2696
1,500,200,50,750,2697
2,453,232,101,786,2697
3,399,287,131,817,2697
4,389,319,163,871,2697
5,379,339,187,905,2697
6,413,343,212,968,2697
7,403,357,220,980,2697
8,385,375,242,1002,2697
9,392,380,275,1047,2697
10,392,409,258,1059,2697
11,388,402,278,1068,2697
1,500,200,50,750,2698
2,452,216,117,785,2698
3,430,239,157,826,2698
4,441,278,160,879,2698
5,427,316,175,918,2698
6,424,325,214,963,2698
7,392,348,250,990,2698
8,393,383,235,1011,2698
9,398,374,253,1025,2698
10,424,372,268,1064,2698
11,418,400,259,1077,2698
1,500,200,50,750,2699
2,456,232,101,789,2699
3,418,263,144,825,2699
4,405,297,167,869,2699
5,423,285,207,915,2699
6,417,318,230,965,2699
7,410,322,245,977,2699
8,406,345,247,998,2699
9,409,366,260,1035,2699
10,405,380,268,1053,2699
11,416,416,255,1087,2699
1,500,200,50,750,2700
2,473,225,97,795,2700
3,439,237,141,817,2700
4,415,284,177,876,2700
5,398,297,204,899,2700
6,413,316,213,942,2700
7,394,336,241,971,2700
8,393,369,241,1003,2700
9,393,388,255,1036,2700
10,396,398,265,1059,2700
11,409,386,298,1093,2700
1,500,200,50,750,2701
2,446,246,89,781,2701
3,401,266,134,801,2701
4,389,303,177,869,2701
5,399,321,188,908,2701
6,396,320,238,954,2701
7,404,349,240,993,2701
8,388,364,247,999,2701
9,403,381,252,1036,2701
10,403,368,271,1042,2701
11,417,390,288,1095,2701
1,500,200,50,750,2702
2,429,255,100,784,2702
3,416,262,147,825,2702
4,418,291,155,864,2702
5,437,335,179,951,2702
6,393,351,219,963,2702
7,389,385,227,1001,2702
8,389,396,233,1018,2702
9,401,377,256,1034,2702
10,378,413,266,1057,2702
11,381,400,298,1079,2702
1,500,200,50,750,2703
2,457,228,96,781,2703
3,445,248,132,825,2703
4,414,284,158,856,2703
5,413,313,180,906,2703
6,404,334,215,953,2703
7,380,348,237,965,2703
8,384,364,262,1010,2703
9,361,401,257,1019,2703
10,366,398,276,1040,2703
11,381,431,270,1082,2703
1,500,200,50,750,2704
2,460,239,86,785,2704
3,432,263,132,827,2704
4,412,295,163,870,2704
5,418,316,178,912,2704
6,410,353,200,963,2704
7,392,364,230,986,2704
8,369,371,269,1009,2704
9,355,395,273,1023,2704
10,368,416,270,1054,2704
11,367,429,287,1083,2704
1,500,200,50,750,2705
2,461,232,97,790,2705
3,447,253,138,838,2705
4,433,279,170,882,2705
5,425,307,186,918,2705
6,423,350,195,968,2705
7,405,353,227,985,2705
8,381,375,242,998,2705
9,381,383,266,1030,2705
10,391,412,266,1069,2705
11,394,445,268,1107,2705
1,500,200,50,750,2706
2,471,232,93,796,2706
3,413,282,128,823,2706
4,382,297,176,855,2706
5,385,349,191,925,2706
6,379,337,227,943,2706
7,398,338,259,995,2706
8,366,359,280,1005,2706
9,367,369,272,1008,2706
10,378,412,269,1059,2706
11,381,401,288,1070,2706
1,500,200,50,750,2707
2,454,232,94,780,2707
3,426,263,148,837,2707
4,401,294,166,861,2707
5,395,326,196,917,2707
6,395,345,215,955,2707
7,391,360,235,986,2707
8,392,373,234,999,2707
9,393,367,262,1022,2707
10,423,372,280,1075,2707
11,408,380,282,1070,2707
1,500,200,50,750,2708
2,449,239,93,781,2708
3,424,289,137,850,2708
4,405,305,161,871,2708
5,406,321,184,911,2708
6,385,362,195,942,2708
7,388,371,203,962,2708
8,393,398,203,994,2708
9,404,404,229,1037,2708
10,406,387,271,1064,2708
11,403,399,274,1076,2708
1,500,200,50,750,2709
2,455,244,94,793,2709
3,430,277,131,838,2709
4,414,301,168,883,2709
5,392,318,195,905,2709
6,391,317,238,946,2709
7,386,350,248,984,2709
8,379,361,269,1009,2709
9,378,398,255,1031,2709
10,368,423,272,1063,2709
11,388,408,281,1077,2709
1,500,200,50,750,2710
2,477,223,97,797,2710
3,443,252,141,836,2710
4,445,272,167,884,2710
5,439,307,177,923,2710
6,413,350,192,955,2710
7,385,385,212,982,2710
8,398,374,243,1015,2710
9,408,380,245,1033,2710
10,400,406,243,1049,2710
11,395,416,262,1073,2710
1,500,200,50,750,2711
2,451,224,106,781,2711
3,416,273,136,825,2711
4,420,299,162,881,2711
5,408,332,167,907,2711
6,400,356,197,953,2711
7,389,362,241,992,2711
8,374,346,261,981,2711
9,382,361,280,1023,2711
10,396,352,315,1063,2711
11,378,388,300,1066,2711
1,500,200,50,750,2712
2,453,237,103,793,2712
3,425,267,140,832,2712
4,432,304,153,889,2712
5,415,308,189,912,2712
6,390,356,193,939,2712
7,390,356,237,983,2712
8,387,383,238,1008,2712
9,388,385,245,1018,2712
10,410,402,254,1066,2712
11,411,406,284,1101,2712
1,500,200,50,750,2713
2,470,224,98,792,2713
3,436,255,140,831,2713
4,411,281,179,871,2713
5,400,302,200,902,2713
6,422,327,219,968,2713
7,396,351,227,974,2713
8,402,367,239,1008,2713
9,385,374,276,1035,2713
10,402,391,269,1062,2713
11,379,398,304,1081,2713
1,500,200,50,750,2714
2,453,252,85,790,2714
3,424,270,136,830,2714
4,390,297,166,853,2714
5,399,309,184,892,2714
6,425,333,197,955,2714
7,404,349,228,981,2714
8,387,367,258,1012,2714
9,379,381,283,1043,2714
10,377,389,281,1047,2714
11,387,405,285,1077,2714
1,500,200,50,750,2715
2,475,220,85,780,2715
3,424,277,113,814,2715
4,419,298,154,871,2715
5,401,326,185,912,2715
6,418,333,219,970,2715
7,392,357,226,975,2715
8,407,373,253,1033,2715
9,394,371,262,1027,2715
10,394,383,275,1052,2715
11,403,413,276,1092,2715
1,500,200,50,750,2716
2,458,230,102,790,2716
3,447,251,129,827,2716
4,416,295,157,868,2716
5,379,324,194,897,2716
6,384,352,222,958,2716
7,373,366,244,983,2716
8,374,384,253,1011,2716
9,362,408,258,1028,2716
10,370,430,255,1055,2716
11,377,458,262,1097,2716
1,500,200,50,750,2717
2,461,241,99,801,2717
3,436,267,127,830,2717
4,419,303,155,877,2717
5,406,314,192,912,2717
6,401,336,211,948,2717
7,394,341,232,967,2717
8,403,359,233,995,2717
9,428,365,251,1044,2717
10,420,381,251,1052,2717
11,430,399,259,1088,2717
1,500,200,50,750,2718
2,477,227,85,789,2718
3,433,251,144,828,2718
4,412,298,159,869,2718
5,409,333,175,917,2718
6,426,352,200,978,2718
7,398,353,232,983,2718
8,398,359,251,1008,2718
9,389,387,258,1034,2718
10,397,388,278,1063,2718
11,408,397,274,1079,2718
1,500,200,50,750,2719
2,460,224,115,799,2719
3,418,264,146,828,2719
4,394,288,181,863,2719
5,385,303,213,901,2719
6,386,340,219,945,2719
7,390,357,244,991,2719
8,367,385,260,1012,2719
9,372,384,271,1027,2719
10,381,396,272,1049,2719
11,382,430,274,1086,2719
1,500,200,50,750,2720
2,471,225,102,798,2720
3,452,246,138,836,2720
4,415,280,163,858,2720
5,420,313,187,920,2720
6,415,323,214,952,2720
7,396,350,227,973,2720
8,400,359,228,987,2720
9,405,412,231,1048,2720
10,381,420,240,1041,2720
11,397,407,274,1078,2720
1,500,200,50,750,2721
2,451,214,108,773,2721
3,454,249,140,843,2721
4,426,284,163,873,2721
5,422,297,189,908,2721
6,437,332,206,975,2721
7,418,346,231,995,2721
8,408,358,242,1008,2721
9,387,394,251,1032,2721
10,376,397,262,1035,2721
11,402,403,290,1095,2721
1,500,200,50,750,2722
2,463,247,90,800,2722
3,423,241,154,818,2722
4,398,284,176,858,2722
5,420,321,187,928,2722
6,398,348,212,958,2722
7,378,361,247,986,2722
8,368,355,281,1004,2722
9,345,379,295,1019,2722
10,373,397,294,1064,2722
11,356,422,302,1080,2722
1,500,200,50,750,2723
2,466,236,87,789,2723
3,437,252,125,814,2723
4,396,277,171,844,2723
5,404,295,211,910,2723
6,389,339,221,949,2723
7,392,370,229,991,2723
8,393,377,243,1013,2723
9,382,373,276,1031,2723
10,387,408,266,1061,2723
11,408,417,276,1101,2723
1,500,200,50,750,2724
2,477,210,106,793,2724
3,430,247,146,823,2724
4,404,301,166,871,2724
5,387,330,179,896,2724
6,404,352,207,963,2724
7,398,356,233,987,2724
8,395,370,246,1011,2724
9,386,394,243,1023,2724
10,396,422,245,1063,2724
11,408,426,243,1077,2724
1,500,200,50,750,2725
2,450,244,98,792,2725
3,430,254,131,815,2725
4,433,262,172,867,2725
5,429,292,191,912,2725
6,431,316,195,942,2725
7,426,331,211,968,2725
8,438,341,233,1012,2725
9,425,357,237,1019,2725
10,432,397,226,1055,2725
11,428,383,252,1063,2725
1,500,200,50,750,2726
2,463,225,107,795,2726
3,434,250,139,823,2726
4,419,295,160,874,2726
5,413,303,191,907,2726
6,413,347,202,962,2726
7,400,357,217,974,2726
8,389,368,246,1003,2726
9,393,365,257,1015,2726
10,398,386,256,1040,2726
11,412,412,266,1090,2726
1,500,200,50,750,2727
2,428,231,110,769,2727
3,436,252,143,831,2727
4,432,297,154,883,2727
5,417,298,181,896,2727
6,408,342,195,945,2727
7,409,367,213,989,2727
8,403,378,225,1006,2727
9,426,363,257,1046,2727
10,411,366,287,1064,2727
11,408,384,306,1098,2727
1,500,200,50,750,2728
2,459,234,102,795,2728
3,416,266,136,818,2728
4,420,296,163,879,2728
5,436,304,183,923,2728
6,417,322,213,952,2728
7,409,322,242,973,2728
8,398,347,263,1008,2728
9,383,387,269,1039,2728
10,370,386,289,1045,2728
11,367,412,297,1076,2728
1,500,200,50,750,2729
2,443,226,115,784,2729
3,423,257,145,825,2729
4,392,277,179,848,2729
5,388,318,209,915,2729
6,388,346,220,954,2729
7,389,355,234,978,2729
8,380,355,250,985,2729
9,391,362,276,1029,2729
10,413,360,291,1064,2729
11,388,380,311,1079,2729
1,500,200,50,750,2730
2,456,227,106,789,2730
3,420,273,145,838,2730
4,405,295,176,876,2730
5,393,318,192,903,2730
6,430,320,218,968,2730
7,408,341,232,981,2730
8,399,353,238,990,2730
9,404,377,250,1031,2730
10,414,394,259,1067,2730
11,395,415,271,1081,2730
1,500,200,50,750,2731
2,459,246,90,795,2731
3,449,257,139,845,2731
4,418,291,160,869,2731
5,412,296,197,905,2731
6,409,317,211,937,2731
7,433,359,213,1005,2731
8,408,365,216,989,2731
9,431,375,247,1053,2731
10,420,383,263,1066,2731
11,402,410,276,1088,2731
1,500,200,50,750,2732
2,462,230,94,786,2732
3,449,261,126,836,2732
4,443,285,152,880,2732
5,427,300,187,914,2732
6,419,324,210,953,2732
7,409,361,203,973,2732
8,418,360,230,1008,2732
9,413,371,251,1035,2732
10,396,393,269,1058,2732
11,382,398,287,1067,2732
1,500,200,50,750,2733
2,459,231,91,781,2733
3,431,279,123,833,2733
4,416,284,164,864,2733
5,406,307,185,898,2733
6,412,342,206,960,2733
7,419,350,228,997,2733
8,394,344,257,995,2733
9,391,371,258,1020,2733
10,411,392,244,1047,2733
11,406,391,283,1080,2733
1,500,200,50,750,2734
2,439,245,92,776,2734
3,433,256,147,836,2734
4,407,254,191,852,2734
5,425,268,215,908,2734
6,434,313,215,962,2734
7,415,335,241,991,2734
8,391,362,253,1006,2734
9,400,387,258,1045,2734
10,370,417,263,1050,2734
11,375,427,279,1081,2734
1,500,200,50,750,2735
2,449,253,88,790,2735
3,410,276,144,830,2735
4,402,282,188,872,2735
5,379,307,219,905,2735
6,391,347,221,959,2735
7,382,372,228,982,2735
8,377,409,231,1017,2735
9,373,395,252,1020,2735
10,385,397,280,1062,2735
11,414,415,269,1098,2735
1,500,200,50,750,2736
2,461,238,88,787,2736
3,450,256,129,835,2736
4,418,271,177,866,2736
5,429,280,206,915,2736
6,430,313,222,965,2736
7,410,353,225,988,2736
8,408,362,246,1016,2736
9,397,379,267,1043,2736
10,407,387,261,1055,2736
11,410,398,291,1099,2736
1,500,200,50,750,2737
2,468,221,90,779,2737
3,440,254,131,825,2737
4,420,283,167,870,2737
5,404,302,202,908,2737
6,401,327,220,948,2737
7,408,355,232,995,2737
8,387,374,247,1008,2737
9,373,385,274,1032,2737
10,392,383,280,1055,2737
11,398,410,269,1077,2737
1,500,200,50,750,2738
2,448,219,107,774,2738
3,436,244,139,819,2738
4,426,277,154,857,2738
5,411,311,193,915,2738
6,406,339,208,953,2738
7,389,368,220,977,2738
8,391,392,241,1024,2738
9,396,399,240,1035,2738
10,420,389,256,1065,2738
11,423,414,257,1094,2738
1,500,200,50,750,2739
2,467,210,105,782,2739
3,442,250,132,824,2739
4,418,290,156,864,2739
5,415,314,179,908,2739
6,423,317,207,947,2739
7,424,339,237,1000,2739
8,416,354,246,1016,2739
9,394,397,263,1054,2739
10,402,397,257,1056,2739
11,400,425,273,1098,2739
1,500,200,50,750,2740
2,463,241,93,797,2740
3,421,263,137,821,2740
4,415,286,160,861,2740
5,416,294,186,896,2740
6,408,334,215,957,2740
7,374,353,249,976,2740
8,408,357,264,1029,2740
9,381,381,268,1030,2740
10,390,397,269,1056,2740
11,394,431,269,1094,2740
1,500,200,50,750,2741
2,451,229,101,781,2741
3,430,246,146,822,2741
4,424,279,175,878,2741
5,431,303,186,920,2741
6,437,309,214,960,2741
7,438,334,218,990,2741
8,434,337,234,1005,2741
9,431,358,241,1030,2741
10,444,378,243,1065,2741
11,442,385,251,1078,2741
1,500,200,50,750,2742
2,451,227,100,778,2742
3,430,273,128,831,2742
4,411,284,162,857,2742
5,410,325,177,912,2742
6,392,320,219,931,2742
7,409,331,237,977,2742
8,411,348,247,1006,2742
9,410,388,244,1042,2742
10,410,402,268,1080,2742
11,368,429,287,1084,2742
1,500,200,50,750,2743
2,451,226,94,771,2743
3,415,260,138,813,2743
4,415,303,155,873,2743
5,413,312,185,910,2743
6,422,344,202,968,2743
7,399,360,216,975,2743
8,404,355,244,1003,2743
9,399,381,268,1048,2743
10,387,375,296,1058,2743
11,400,391,297,1088,2743
1,500,200,50,750,2744
2,484,227,92,803,2744
3,425,269,137,831,2744
4,409,297,165,871,2744
5,402,323,186,911,2744
6,394,335,208,937,2744
7,384,363,220,967,2744
8,395,384,227,1006,2744
9,395,384,250,1029,2744
10,391,398,266,1055,2744
11,369,404,296,1069,2744
1,500,200,50,750,2745
2,466,242,100,808,2745
3,429,271,130,830,2745
4,409,291,175,875,2745
5,410,327,186,923,2745
6,381,384,191,956,2745
7,365,391,221,977,2745
8,383,395,237,1015,2745
9,398,395,250,1043,2745
10,383,395,267,1045,2745
11,392,409,273,1074,2745
1,500,200,50,750,2746
2,462,237,85,784,2746
3,429,260,131,820,2746
4,413,288,169,870,2746
5,393,296,211,900,2746
6,388,333,218,939,2746
7,383,360,249,992,2746
8,398,353,260,1011,2746
9,410,379,258,1047,2746
10,406,390,261,1057,2746
11,435,401,265,1101,2746
1,500,200,50,750,2747
2,449,238,98,785,2747
3,420,260,136,816,2747
4,417,307,155,879,2747
5,415,322,177,914,2747
6,412,362,188,962,2747
7,390,374,206,970,2747
8,388,410,207,1005,2747
9,394,398,249,1041,2747
10,373,385,291,1049,2747
11,396,404,281,1081,2747
1,500,200,50,750,2748
2,449,231,99,779,2748
3,434,249,133,816,2748
4,430,285,153,868,2748
5,430,319,179,928,2748
6,416,343,208,967,2748
7,402,368,217,987,2748
8,400,358,251,1009,2748
9,400,368,263,1031,2748
10,411,372,277,1060,2748
11,429,382,279,1090,2748
1,500,200,50,750,2749
2,449,234,95,778,2749
3,418,271,133,822,2749
4,442,288,147,877,2749
5,435,311,166,912,2749
6,430,329,195,954,2749
7,400,338,239,977,2749
8,393,379,247,1019,2749
9,410,353,280,1043,2749
10,408,379,268,1055,2749
11,405,407,261,1073,2749
1,500,200,50,750,2750
2,467,213,100,780,2750
3,441,244,137,822,2750
4,418,270,169,857,2750
5,426,295,200,921,2750
6,427,325,214,966,2750
7,419,357,209,985,2750
8,412,371,223,1006,2750
9,404,381,251,1036,2750
10,411,412,241,1064,2750
11,416,398,253,1067,2750
1,500,200,50,750,2751
2,457,229,106,792,2751
3,425,258,140,823,2751
4,418,281,181,880,2751
5,429,314,183,926,2751
6,417,328,206,951,2751
7,389,354,218,961,2751
8,398,357,247,1002,2751
9,391,397,244,1032,2751
10,372,410,269,1051,2751
11,397,403,280,1080,2751
1,500,200,50,750,2752
2,444,246,95,785,2752
3,421,262,146,829,2752
4,399,282,180,861,2752
5,409,316,190,915,2752
6,395,347,224,966,2752
7,371,354,252,977,2752
8,370,389,252,1011,2752
9,374,393,267,1034,2752
10,387,385,299,1071,2752
11,395,393,297,1085,2752
1,500,200,50,750,2753
2,459,242,83,784,2753
3,423,287,128,838,2753
4,390,305,152,847,2753
5,399,328,171,898,2753
6,414,352,195,961,2753
7,392,351,232,975,2753
8,409,351,245,1005,2753
9,412,390,232,1034,2753
10,413,405,245,1063,2753
11,388,410,264,1062,2753
1,500,200,50,750,2754
2,434,243,112,789,2754
3,435,281,127,843,2754
4,431,289,155,875,2754
5,422,316,182,920,2754
6,420,326,202,948,2754
7,417,363,207,987,2754
8,408,349,249,1006,2754
9,400,355,270,1025,2754
10,399,396,270,1065,2754
11,385,428,270,1083,2754
1,500,200,50,750,2755
2,447,225,106,778,2755
3,429,267,129,825,2755
4,427,283,157,867,2755
5,388,331,179,898,2755
6,400,357,198,955,2755
7,387,371,231,989,2755
8,360,389,254,1003,2755
9,354,406,270,1030,2755
10,371,403,272,1046,2755
11,376,423,275,1074,2755
1,500,200,50,750,2756
2,452,218,113,783,2756
3,423,257,154,834,2756
4,417,283,177,877,2756
5,416,286,191,893,2756
6,447,334,202,983,2756
7,418,356,202,976,2756
8,423,385,210,1018,2756
9,421,366,246,1033,2756
10,417,377,255,1049,2756
11,438,404,253,1095,2756
1,500,200,50,750,2757
2,462,219,102,783,2757
3,447,242,143,832,2757
4,411,295,165,871,2757
5,394,306,195,895,2757
6,410,331,214,955,2757
7,403,345,241,989,2757
8,386,371,244,1001,2757
9,380,397,253,1030,2757
10,393,381,274,1048,2757
11,410,386,299,1095,2757
1,500,200,50,750,2758
2,464,239,96,799,2758
3,439,255,141,835,2758
4,407,282,167,856,2758
5,419,302,182,903,2758
6,420,349,189,958,2758
7,397,373,203,973,2758
8,395,372,242,1009,2758
9,409,401,237,1047,2758
10,401,405,255,1061,2758
11,417,404,274,1095,2758
1,500,200,50,750,2759
2,452,233,92,777,2759
3,439,262,143,844,2759
4,402,293,167,862,2759
5,420,326,169,915,2759
6,425,333,204,962,2759
7,414,353,222,989,2759
8,399,365,238,1002,2759
9,401,379,251,1031,2759
10,417,403,247,1067,2759
11,383,420,275,1078,2759
1,500,200,50,750,2760
2,466,238,85,789,2760
3,437,270,127,834,2760
4,419,310,148,877,2760
5,404,320,183,907,2760
6,395,360,208,963,2760
7,410,369,218,997,2760
8,406,367,238,1011,2760
9,384,391,254,1029,2760
10,377,414,258,1049,2760
11,396,405,272,1073,2760
1,500,200,50,750,2761
2,454,251,94,799,2761
3,443,263,131,837,2761
4,407,295,174,876,2761
5,380,327,191,898,2761
6,379,338,220,937,2761
7,410,335,257,1002,2761
8,410,333,251,994,2761
9,430,361,246,1037,2761
10,429,392,240,1061,2761
11,423,408,259,1090,2761
1,500,200,50,750,2762
2,471,217,102,790,2762
3,422,265,134,821,2762
4,420,290,163,873,2762
5,411,322,190,923,2762
6,405,334,208,947,2762
7,401,351,219,971,2762
8,402,343,246,991,2762
9,399,371,255,1025,2762
10,390,385,272,1047,2762
11,421,388,284,1093,2762
1,500,200,50,750,2763
2,465,232,104,801,2763
3,451,255,124,830,2763
4,447,275,153,875,2763
5,428,314,160,902,2763
6,417,344,190,951,2763
7,410,345,211,966,2763
8,405,395,213,1013,2763
9,402,393,226,1021,2763
10,424,381,248,1053,2763
11,407,391,272,1070,2763
1,500,200,50,750,2764
2,466,222,90,778,2764
3,443,260,122,825,2764
4,422,291,159,872,2764
5,423,316,164,903,2764
6,427,349,187,963,2764
7,394,374,215,983,2764
8,372,400,230,1002,2764
9,369,403,263,1035,2764
10,372,405,275,1052,2764
11,406,399,282,1087,2764
1,500,200,50,750,2765
2,471,216,102,789,2765
3,448,240,128,816,2765
4,435,258,165,858,2765
5,431,290,186,907,2765
6,429,333,197,959,2765
7,415,339,226,980,2765
8,399,350,245,994,2765
9,393,372,271,1036,2765
10,420,391,278,1089,2765
11,413,394,274,1081,2765
1,500,200,50,750,2766
2,463,220,99,782,2766
3,454,260,133,847,2766
4,406,300,167,873,2766
5,417,304,196,917,2766
6,426,324,214,964,2766
7,415,360,200,975,2766
8,390,389,225,1004,2766
9,393,387,251,1031,2766
10,390,423,250,1063,2766
11,389,434,269,1092,2766
1,500,200,50,750,2767
2,454,231,105,790,2767
3,431,276,128,835,2767
4,414,296,163,873,2767
5,408,325,179,912,2767
6,412,336,197,945,2767
7,402,371,206,979,2767
8,385,377,234,996,2767
9,408,374,249,1031,2767
10,422,395,263,1080,2767
11,419,404,270,1093,2767
1,500,200,50,750,2768
2,449,233,105,787,2768
3,433,260,140,833,2768
4,410,293,159,862,2768
5,422,327,171,920,2768
6,401,339,207,947,2768
7,403,362,219,984,2768
8,393,379,235,1007,2768
9,408,399,237,1044,2768
10,398,401,245,1044,2768
11,404,404,279,1087,2768
1,500,200,50,750,2769
2,462,225,106,793,2769
3,436,247,145,828,2769
4,418,266,189,873,2769
5,406,301,199,906,2769
6,414,317,222,953,2769
7,397,336,247,980,2769
8,386,372,257,1015,2769
9,368,415,246,1029,2769
10,362,422,256,1040,2769
11,384,440,258,1082,2769
1,500,200,50,750,2770
2,455,221,112,788,2770
3,409,254,174,837,2770
4,392,293,185,870,2770
5,394,310,218,922,2770
6,394,322,232,948,2770
7,383,359,228,970,2770
8,401,393,234,1028,2770
9,379,421,240,1040,2770
10,363,448,249,1060,2770
11,364,454,255,1073,2770
1,500,200,50,750,2771
2,466,220,98,784,2771
3,442,261,127,830,2771
4,423,286,158,867,2771
5,430,313,175,918,2771
6,438,330,192,960,2771
7,436,348,220,1004,2771
8,403,368,232,1003,2771
9,425,365,245,1035,2771
10,407,380,256,1043,2771
11,437,387,278,1102,2771
1,500,200,50,750,2772
2,463,239,86,788,2772
3,439,270,122,831,2772
4,438,283,147,868,2772
5,422,289,192,903,2772
6,416,325,222,963,2772
7,395,361,230,986,2772
8,363,383,253,999,2772
9,379,384,258,1021,2772
10,376,413,267,1056,2772
11,376,438,273,1087,2772
1,500,200,50,750,2773
2,458,229,94,781,2773
3,421,257,144,822,2773
4,431,273,179,883,2773
5,426,298,194,918,2773
6,435,324,208,967,2773
7,410,322,247,979,2773
8,417,361,232,1010,2773
9,405,373,245,1023,2773
10,407,380,258,1045,2773
11,428,390,266,1084,2773
1,500,200,50,750,2774
2,469,236,107,812,2774
3,414,250,150,814,2774
4,412,287,170,869,2774
5,409,309,204,922,2774
6,393,351,208,952,2774
7,374,381,230,985,2774
8,358,382,257,997,2774
9,356,380,282,1018,2774
10,391,382,268,1041,2774
11,411,405,277,1093,2774
1,500,200,50,750,2775
2,441,248,93,782,2775
3,417,252,147,816,2775
4,421,275,164,860,2775
5,397,310,187,894,2775
6,384,349,211,944,2775
7,376,371,238,985,2775
8,382,380,240,1002,2775
9,393,395,245,1033,2775
10,393,403,254,1050,2775
11,411,398,264,1073,2775
1,500,200,50,750,2776
2,472,220,93,785,2776
3,441,242,145,828,2776
4,418,284,151,853,2776
5,416,331,178,925,2776
6,413,343,196,952,2776
7,430,340,215,985,2776
8,429,364,231,1024,2776
9,403,370,245,1018,2776
10,421,395,243,1059,2776
11,423,406,256,1085,2776
1,500,200,50,750,2777
2,458,228,107,793,2777
3,407,262,156,825,2777
4,404,288,176,868,2777
5,401,334,182,917,2777
6,415,346,204,965,2777
7,408,380,212,1000,2777
8,392,381,241,1014,2777
9,384,390,265,1039,2777
10,387,428,250,1065,2777
11,403,430,251,1084,2777
1,500,200,50,750,2778
2,460,237,100,797,2778
3,445,270,130,845,2778
4,419,299,146,864,2778
5,410,325,175,910,2778
6,391,354,204,949,2778
7,403,359,230,992,2778
8,392,376,232,1000,2778
9,405,389,233,1027,2778
10,392,401,252,1045,2778
11,428,387,273,1088,2778
1,500,200,50,750,2779
2,457,238,94,789,2779
3,440,269,124,833,2779
4,408,298,172,878,2779
5,394,328,192,914,2779
6,406,342,204,952,2779
7,412,351,222,985,2779
8,416,347,237,1000,2779
9,415,369,246,1030,2779
10,400,396,244,1040,2779
11,415,428,243,1086,2779
1,500,200,50,750,2780
2,458,225,102,785,2780
3,443,261,127,831,2780
4,402,298,148,848,2780
5,379,337,181,897,2780
6,392,361,204,957,2780
7,364,377,226,967,2780
8,379,383,239,1001,2780
9,384,404,254,1042,2780
10,398,416,275,1089,2780
11,413,402,280,1095,2780
1,500,200,50,750,2781
2,455,241,92,788,2781
3,432,262,140,834,2781
4,430,265,179,874,2781
5,423,296,212,931,2781
6,417,298,239,954,2781
7,419,338,232,989,2781
8,407,361,256,1024,2781
9,398,372,254,1024,2781
10,376,395,267,1038,2781
11,409,399,278,1086,2781
1,500,200,50,750,2782
2,455,232,102,789,2782
3,433,264,139,836,2782
4,410,287,169,866,2782
5,399,316,181,896,2782
6,389,352,192,933,2782
7,392,371,204,967,2782
8,410,381,225,1016,2782
9,414,405,224,1043,2782
10,387,414,245,1046,2782
11,405,399,275,1079,2782
1,500,200,50,750,2783
2,457,228,96,781,2783
3,432,251,150,833,2783
4,425,275,173,873,2783
5,413,319,180,912,2783
6,411,337,211,959,2783
7,390,363,219,972,2783
8,368,363,258,989,2783
9,385,391,252,1028,2783
10,373,396,262,1031,2783
11,415,384,288,1087,2783
1,500,200,50,750,2784
2,455,221,108,784,2784
3,424,265,124,813,2784
4,427,290,153,870,2784
5,394,326,173,893,2784
6,396,338,200,934,2784
7,408,348,224,980,2784
8,414,370,228,1012,2784
9,400,388,233,1021,2784
10,424,406,238,1068,2784
11,419,396,258,1073,2784
1,500,200,50,750,2785
2,477,216,86,779,2785
3,420,255,129,804,2785
4,421,297,150,868,2785
5,408,319,184,911,2785
6,404,354,211,969,2785
7,410,350,217,977,2785
8,404,376,230,1010,2785
9,394,384,234,1012,2785
10,406,387,256,1049,2785
11,406,409,271,1086,2785
1,500,200,50,750,2786
2,464,230,106,800,2786
3,431,256,133,820,2786
4,415,275,168,858,2786
5,414,307,197,918,2786
6,413,324,217,954,2786
7,403,358,226,987,2786
8,386,366,248,1000,2786
9,383,402,239,1024,2786
10,387,424,252,1063,2786
11,371,441,264,1076,2786
1,500,200,50,750,2787
2,480,233,90,803,2787
3,440,248,132,820,2787
4,425,268,172,865,2787
5,409,322,179,910,2787
6,400,356,193,949,2787
7,384,378,234,996,2787
8,380,376,250,1006,2787
9,393,378,260,1031,2787
10,407,412,255,1074,2787
11,391,402,284,1077,2787
1,500,200,50,750,2788
2,454,237,107,798,2788
3,410,288,117,815,2788
4,412,294,160,866,2788
5,413,317,194,924,2788
6,414,312,234,960,2788
7,398,348,234,980,2788
8,406,366,225,997,2788
9,413,371,229,1013,2788
10,431,382,232,1045,2788
11,420,393,260,1073,2788
1,500,200,50,750,2789
2,462,238,94,794,2789
3,439,252,132,823,2789
4,422,285,159,866,2789
5,413,314,186,913,2789
6,412,327,225,964,2789
7,389,356,234,979,2789
8,396,364,241,1001,2789
9,409,387,237,1033,2789
10,399,413,248,1060,2789
11,395,420,267,1082,2789
1,500,200,50,750,2790
2,447,241,95,783,2790
3,397,267,156,820,2790
4,400,299,184,883,2790
5,389,327,196,912,2790
6,395,369,210,974,2790
7,368,384,231,983,2790
8,396,398,229,1023,2790
9,395,407,231,1033,2790
10,402,398,257,1057,2790
11,408,397,273,1078,2790
1,500,200,50,750,2791
2,458,212,117,787,2791
3,434,235,148,817,2791
4,429,272,177,878,2791
5,402,296,203,901,2791
6,412,315,226,953,2791
7,408,341,240,989,2791
8,428,347,246,1021,2791
9,382,383,266,1031,2791
10,390,391,270,1051,2791
11,413,403,277,1093,2791
1,500,200,50,750,2792
2,465,223,91,779,2792
3,429,254,139,822,2792
4,401,303,155,859,2792
5,407,330,161,898,2792
6,427,334,208,969,2792
7,407,320,247,974,2792
8,421,358,252,1031,2792
9,412,370,263,1045,2792
10,395,372,288,1055,2792
11,415,394,270,1079,2792
1,500,200,50,750,2793
2,456,230,112,798,2793
3,424,256,151,831,2793
4,432,274,172,878,2793
5,435,302,188,925,2793
6,424,318,210,952,2793
7,401,346,225,972,2793
8,398,372,223,993,2793
9,405,395,241,1041,2793
10,415,390,253,1058,2793
11,410,411,267,1088,2793
1,500,200,50,750,2794
2,470,241,98,809,2794
3,434,246,145,825,2794
4,423,289,163,875,2794
5,401,305,193,899,2794
6,405,344,210,959,2794
7,378,336,239,953,2794
8,404,347,271,1022,2794
9,405,372,256,1033,2794
10,392,392,258,1042,2794
11,399,406,280,1085,2794
1,500,200,50,750,2795
2,470,230,105,805,2795
3,423,257,137,817,2795
4,409,282,170,861,2795
5,393,320,191,904,2795
6,410,336,211,957,2795
7,410,364,211,985,2795
8,368,373,246,987,2795
9,377,401,257,1035,2795
10,397,414,267,1078,2795
11,379,407,290,1076,2795
1,500,200,50,750,2796
2,439,242,99,780,2796
3,426,279,135,840,2796
4,419,306,155,880,2796
5,406,314,187,907,2796
6,404,337,209,950,2796
7,404,332,239,975,2796
8,403,356,247,1006,2796
9,411,371,251,1033,2796
10,409,403,254,1066,2796
11,405,410,277,1092,2796
1,500,200,50,750,2797
2,456,234,96,786,2797
3,437,274,128,839,2797
4,403,275,169,847,2797
5,392,331,192,915,2797
6,379,373,210,962,2797
7,384,376,223,983,2797
8,386,384,242,1012,2797
9,388,399,253,1040,2797
10,395,382,274,1051,2797
11,401,396,286,1083,2797
1,500,200,50,750,2798
2,465,217,98,780,2798
3,437,257,124,818,2798
4,440,294,152,886,2798
5,414,321,179,914,2798
6,409,336,226,971,2798
7,411,348,235,994,2798
8,409,346,254,1009,2798
9,398,360,274,1032,2798
10,399,383,270,1052,2798
11,418,403,270,1091,2798
1,500,200,50,750,2799
2,446,237,97,780,2799
3,427,267,136,830,2799
4,407,289,155,851,2799
5,397,334,179,910,2799
6,417,363,187,967,2799
7,395,351,226,972,2799
8,402,376,243,1021,2799
9,397,375,263,1035,2799
10,387,414,260,1061,2799
11,382,429,270,1081,2799
1,500,200,50,750,2800
2,461,224,97,782,2800
3,415,278,140,833,2800
4,416,283,177,876,2800
5,422,316,191,929,2800
6,418,323,221,962,2800
7,398,368,232,998,2800
8,385,384,227,996,2800
9,380,407,242,1029,2800
10,371,434,262,1067,2800
11,377,438,269,1084,2800
1,500,200,50,750,2801
2,435,238,109,782,2801
3,433,262,150,845,2801
4,413,272,178,863,2801
5,432,290,196,918,2801
6,415,339,202,956,2801
7,412,350,218,980,2801
8,401,368,238,1007,2801
9,400,378,249,1027,2801
10,381,416,250,1047,2801
11,369,420,270,1059,2801
1,500,200,50,750,2802
2,473,224,96,793,2802
3,453,256,119,828,2802
4,441,287,154,882,2802
5,423,313,182,918,2802
6,415,313,217,945,2802
7,411,332,235,978,2802
8,393,348,258,999,2802
9,401,370,271,1042,2802
10,409,354,286,1049,2802
11,413,389,275,1077,2802
1,500,200,50,750,2803
2,449,230,112,791,2803
3,420,249,141,810,2803
4,429,260,171,860,2803
5,435,283,189,907,2803
6,429,320,201,950,2803
7,419,316,225,960,2803
8,412,370,226,1008,2803
9,405,387,244,1036,2803
10,421,398,255,1074,2803
11,420,396,262,1078,2803
1,500,200,50,750,2804
2,456,224,98,778,2804
3,442,259,141,842,2804
4,390,297,175,862,2804
5,404,315,187,906,2804
6,427,350,207,984,2804
7,402,341,240,983,2804
8,410,354,243,1007,2804
9,412,376,240,1028,2804
10,433,388,258,1079,2804
11,432,387,284,1103,2804
1,500,200,50,750,2805
2,457,232,103,792,2805
3,435,245,140,820,2805
4,426,290,162,878,2805
5,415,314,192,921,2805
6,402,333,221,956,2805
7,402,364,221,987,2805
8,392,355,236,983,2805
9,410,389,233,1032,2805
10,402,409,253,1064,2805
11,408,398,269,1075,2805
1,500,200,50,750,2806
2,458,226,94,778,2806
3,427,246,151,824,2806
4,403,290,188,881,2806
5,399,308,200,907,2806
6,406,323,229,958,2806
7,388,349,238,975,2806
8,400,377,234,1011,2806
9,413,373,259,1045,2806
10,397,405,261,1063,2806
11,411,396,282,1089,2806
1,500,200,50,750,2807
2,458,224,106,788,2807
3,434,241,152,827,2807
4,425,293,154,872,2807
5,415,290,202,907,2807
6,412,336,206,954,2807
7,395,348,225,968,2807
8,391,373,233,997,2807
9,402,385,241,1028,2807
10,389,402,257,1048,2807
11,383,427,274,1084,2807
1,500,200,50,750,2808
2,451,232,96,779,2808
3,433,280,118,831,2808
4,408,293,164,865,2808
5,411,325,172,908,2808
6,417,355,178,950,2808
7,402,351,220,973,2808
8,403,353,239,995,2808
9,411,368,245,1024,2808
10,424,372,253,1049,2808
11,435,376,276,1087,2808
1,500,200,50,750,2809
2,477,215,96,788,2809
3,447,255,135,837,2809
4,426,282,151,859,2809
5,424,297,192,913,2809
6,416,316,207,939,2809
7,399,352,221,972,2809
8,392,363,240,995,2809
9,402,369,272,1043,2809
10,385,404,263,1052,2809
11,377,400,287,1064,2809
1,500,200,50,750,2810
2,451,242,96,789,2810
3,426,252,145,823,2810
4,408,285,178,871,2810
5,376,330,202,908,2810
6,384,337,225,946,2810
7,387,360,232,979,2810
8,365,389,258,1012,2810
9,364,392,273,1029,2810
10,356,405,294,1055,2810
11,368,419,283,1070,2810
1,500,200,50,750,2811
2,462,227,100,789,2811
3,425,271,130,826,2811
4,407,306,149,862,2811
5,407,329,167,903,2811
6,410,383,178,971,2811
7,403,369,205,977,2811
8,382,387,217,986,2811
9,398,408,229,1035,2811
10,392,399,263,1054,2811
11,376,425,274,1075,2811
1,500,200,50,750,2812
2,452,237,94,783,2812
3,427,270,132,829,2812
4,410,303,164,877,2812
5,383,332,187,902,2812
6,403,338,230,971,2812
7,362,372,239,973,2812
8,365,365,263,993,2812
9,400,369,259,1028,2812
10,406,383,272,1061,2812
11,383,425,293,1101,2812
1,500,200,50,750,2813
2,468,230,96,794,2813
3,436,249,148,833,2813
4,417,281,168,866,2813
5,420,305,179,904,2813
6,411,319,234,964,2813
7,382,332,258,972,2813
8,370,352,272,994,2813
9,379,378,261,1018,2813
10,385,379,277,1041,2813
11,406,412,275,1093,2813
1,500,200,50,750,2814
2,446,231,101,778,2814
3,439,255,140,834,2814
4,418,288,157,863,2814
5,423,320,173,916,2814
6,428,357,187,972,2814
7,416,368,195,979,2814
8,407,392,205,1004,2814
9,380,409,229,1018,2814
10,378,424,262,1064,2814
11,373,422,279,1074,2814
1,500,200,50,750,2815
2,445,230,103,778,2815
3,446,234,146,826,2815
4,402,292,160,854,2815
5,408,316,183,907,2815
6,396,340,223,959,2815
7,385,354,247,986,2815
8,367,389,246,1002,2815
9,381,426,244,1051,2815
10,380,412,268,1060,2815
11,385,438,267,1090,2815
1,500,200,50,750,2816
2,441,229,112,782,2816
3,431,237,152,820,2816
4,421,279,178,878,2816
5,411,328,187,926,2816
6,416,341,201,958,2816
7,408,368,208,984,2816
8,400,382,234,1016,2816
9,394,382,254,1030,2816
10,397,370,291,1058,2816
11,400,386,290,1076,2816
1,500,200,50,750,2817
2,461,228,97,786,2817
3,438,263,121,822,2817
4,426,291,169,886,2817
5,386,320,186,892,2817
6,398,341,214,953,2817
7,390,360,224,974,2817
8,404,358,249,1011,2817
9,389,368,272,1029,2817
10,401,383,280,1064,2817
11,375,410,290,1075,2817
1,500,200,50,750,2818
2,450,234,103,787,2818
3,443,251,141,835,2818
4,431,275,166,872,2818
5,435,278,191,904,2818
6,432,318,207,957,2818
7,419,344,227,990,2818
8,395,375,230,1000,2818
9,410,396,240,1046,2818
10,403,417,247,1067,2818
11,425,406,253,1084,2818
1,500,200,50,750,2819
2,459,253,81,793,2819
3,427,269,132,828,2819
4,426,283,159,868,2819
5,417,319,179,915,2819
6,441,322,214,977,2819
7,425,312,242,979,2819
8,408,358,236,1002,2819
9,392,380,260,1032,2819
10,384,426,252,1062,2819
11,367,433,263,1063,2819
1,500,200,50,750,2820
2,457,225,110,792,2820
3,429,237,149,815,2820
4,426,261,173,860,2820
5,424,313,194,931,2820
6,403,328,215,946,2820
7,403,346,228,977,2820
8,411,347,240,998,2820
9,389,382,258,1029,2820
10,378,359,292,1029,2820
11,399,433,289,1121,2820
1,500,200,50,750,2821
2,454,231,95,780,2821
3,422,252,144,818,2821
4,412,287,165,864,2821
5,423,296,190,909,2821
6,408,309,231,948,2821
7,396,346,236,978,2821
8,376,375,240,991,2821
9,357,393,257,1007,2821
10,405,389,263,1057,2821
11,409,411,251,1071,2821
1,500,200,50,750,2822
2,454,236,105,795,2822
3,407,271,140,818,2822
4,410,303,158,871,2822
5,398,323,190,911,2822
6,393,335,221,949,2822
7,395,337,227,959,2822
8,402,395,220,1017,2822
9,384,405,248,1037,2822
10,350,436,265,1051,2822
11,382,429,285,1096,2822
1,500,200,50,750,2823
2,435,245,115,795,2823
3,410,272,153,835,2823
4,380,299,180,859,2823
5,386,328,201,915,2823
6,398,349,205,952,2823
7,383,383,214,980,2823
8,383,399,232,1014,2823
9,380,398,240,1018,2823
10,404,414,239,1057,2823
11,409,406,247,1062,2823
1,500,200,50,750,2824
2,474,224,91,789,2824
3,458,266,106,830,2824
4,427,285,149,861,2824
5,398,310,204,912,2824
6,406,334,219,959,2824
7,399,352,235,986,2824
8,394,358,248,1000,2824
9,406,380,260,1046,2824
10,415,386,259,1060,2824
11,419,382,282,1083,2824
1,500,200,50,750,2825
2,465,228,93,786,2825
3,442,263,127,832,2825
4,411,288,157,856,2825
5,408,298,183,889,2825
6,407,344,197,948,2825
7,402,373,225,1000,2825
8,388,379,237,1004,2825
9,391,373,278,1042,2825
10,411,357,293,1061,2825
11,404,383,285,1072,2825
1,500,200,50,750,2826
2,458,231,97,786,2826
3,423,243,141,807,2826
4,441,267,174,882,2826
5,429,281,206,916,2826
6,404,329,228,961,2826
7,388,354,253,995,2826
8,370,375,263,1008,2826
9,401,385,262,1048,2826
10,366,396,279,1041,2826
11,410,413,275,1098,2826
1,500,200,50,750,2827
2,465,231,85,781,2827
3,453,248,124,825,2827
4,422,281,159,862,2827
5,424,315,178,917,2827
6,418,352,200,970,2827
7,391,356,241,988,2827
8,416,341,255,1012,2827
9,418,368,264,1050,2827
10,411,383,266,1060,2827
11,430,399,260,1089,2827
1,500,200,50,750,2828
2,454,218,111,783,2828
3,420,256,143,819,2828
4,424,293,153,870,2828
5,427,310,187,924,2828
6,396,340,216,952,2828
7,406,351,232,989,2828
8,393,372,245,1010,2828
9,397,378,262,1037,2828
10,383,403,265,1051,2828
11,377,416,284,1077,2828
1,500,200,50,750,2829
2,452,234,95,781,2829
3,431,266,142,839,2829
4,382,298,171,851,2829
5,403,301,207,911,2829
6,401,320,218,939,2829
7,395,334,253,982,2829
8,389,370,252,1011,2829
9,384,401,248,1033,2829
10,405,394,269,1068,2829
11,423,389,271,1083,2829
1,500,200,50,750,2830
2,435,259,104,798,2830
3,412,266,152,830,2830
4,407,286,171,864,2830
5,404,298,209,911,2830
6,397,324,225,946,2830
7,394,368,221,983,2830
8,388,406,219,1013,2830
9,389,412,236,1037,2830
10,397,389,267,1053,2830
11,423,387,270,1080,2830
1,500,200,50,750,2831
2,442,237,109,788,2831
3,416,277,137,830,2831
4,422,297,156,875,2831
5,417,291,201,909,2831
6,408,322,218,948,2831
7,389,360,232,981,2831
8,382,380,240,1002,2831
9,381,373,267,1021,2831
10,388,410,265,1063,2831
11,391,415,293,1099,2831
1,500,200,50,750,2832
2,458,235,94,787,2832
3,438,280,111,829,2832
4,424,282,164,870,2832
5,395,317,183,895,2832
6,442,341,201,984,2832
7,398,339,242,979,2832
8,396,341,250,987,2832
9,397,395,251,1043,2832
10,384,420,257,1061,2832
11,377,416,280,1073,2832
1,500,200,50,750,2833
2,448,241,96,785,2833
3,432,275,134,841,2833
4,409,289,177,875,2833
5,400,330,195,925,2833
6,386,345,217,948,2833
7,384,352,241,977,2833
8,380,362,265,1007,2833
9,405,367,282,1054,2833
10,393,385,294,1072,2833
11,391,388,290,1069,2833
1,500,200,50,750,2834
2,451,237,100,788,2834
3,438,255,127,820,2834
4,415,282,162,859,2834
5,401,314,194,909,2834
6,400,344,221,965,2834
7,384,362,221,967,2834
8,413,364,221,998,2834
9,430,374,220,1024,2834
10,433,392,244,1069,2834
11,406,402,257,1065,2834
1,500,200,50,750,2835
2,474,238,85,797,2835
3,436,251,129,816,2835
4,427,278,159,864,2835
5,415,331,174,920,2835
6,402,364,181,947,2835
7,396,369,205,970,2835
8,409,364,239,1012,2835
9,401,371,258,1030,2835
10,395,370,286,1051,2835
11,408,378,300,1086,2835
1,500,200,50,750,2836
2,443,240,100,783,2836
3,420,272,132,824,2836
4,412,298,172,882,2836
5,391,322,190,903,2836
6,392,350,207,949,2836
7,382,355,232,969,2836
8,405,359,244,1008,2836
9,403,361,257,1021,2836
10,406,401,263,1070,2836
11,389,396,308,1093,2836
1,500,200,50,750,2837
2,454,238,103,795,2837
3,417,281,124,822,2837
4,397,286,168,851,2837
5,408,316,184,908,2837
6,419,329,195,943,2837
7,432,357,216,1005,2837
8,410,368,226,1004,2837
9,418,368,244,1030,2837
10,440,371,259,1070,2837
11,420,373,275,1068,2837
1,500,200,50,750,2838
2,457,218,102,777,2838
3,422,264,136,822,2838
4,424,291,170,885,2838
5,397,315,205,917,2838
6,405,327,221,953,2838
7,405,334,249,988,2838
8,398,354,260,1012,2838
9,393,356,278,1027,2838
10,398,403,261,1062,2838
11,396,420,264,1080,2838
1,500,200,50,750,2839
2,470,226,95,791,2839
3,449,260,131,840,2839
4,428,270,165,863,2839
5,417,302,183,902,2839
6,421,339,204,964,2839
7,402,353,233,988,2839
8,381,366,240,987,2839
9,389,370,266,1025,2839
10,365,412,269,1046,2839
11,387,419,283,1089,2839
1,500,200,50,750,2840
2,440,235,92,767,2840
3,426,260,129,815,2840
4,436,258,174,868,2840
5,433,299,195,927,2840
6,427,297,229,953,2840
7,419,317,238,974,2840
8,398,371,249,1018,2840
9,388,375,261,1024,2840
10,399,376,268,1043,2840
11,394,404,286,1084,2840
1,500,200,50,750,2841
2,443,243,96,782,2841
3,409,266,152,827,2841
4,404,281,179,864,2841
5,400,279,205,884,2841
6,425,324,200,949,2841
7,411,360,222,993,2841
8,389,380,236,1005,2841
9,385,400,250,1035,2841
10,393,389,280,1062,2841
11,413,399,276,1088,2841
1,500,200,50,750,2842
2,456,222,99,777,2842
3,441,263,132,836,2842
4,422,294,156,872,2842
5,407,313,190,910,2842
6,390,324,225,939,2842
7,403,340,239,982,2842
8,413,347,261,1021,2842
9,381,373,271,1025,2842
10,391,390,276,1057,2842
11,406,412,284,1102,2842
1,500,200,50,750,2843
2,442,235,93,770,2843
3,424,270,131,825,2843
4,417,294,157,868,2843
5,403,325,176,904,2843
6,402,344,207,953,2843
7,403,364,214,981,2843
8,408,374,234,1016,2843
9,395,406,241,1042,2843
10,395,410,262,1067,2843
11,390,412,270,1072,2843
1,500,200,50,750,2844
2,445,242,106,793,2844
3,407,284,124,815,2844
4,396,317,159,872,2844
5,384,345,184,913,2844
6,368,352,219,939,2844
7,383,384,223,990,2844
8,388,388,237,1013,2844
9,377,399,264,1040,2844
10,387,402,263,1052,2844
11,383,400,292,1075,2844
1,500,200,50,750,2845
2,458,232,95,785,2845
3,428,271,139,838,2845
4,399,294,177,870,2845
5,410,320,187,917,2845
6,393,344,210,947,2845
7,383,340,234,957,2845
8,403,343,262,1008,2845
9,396,379,261,1036,2845
10,389,387,281,1057,2845
11,385,390,288,1063,2845
1,500,200,50,750,2846
2,451,231,104,786,2846
3,426,253,139,818,2846
4,406,288,182,876,2846
5,411,309,185,905,2846
6,431,322,223,976,2846
7,410,353,214,977,2846
8,404,353,239,996,2846
9,400,391,240,1031,2846
10,387,394,262,1043,2846
11,410,418,276,1104,2846
1,500,200,50,750,2847
2,465,238,92,795,2847
3,443,248,127,818,2847
4,434,296,146,876,2847
5,414,323,162,899,2847
6,431,331,197,959,2847
7,424,343,221,988,2847
8,410,371,223,1004,2847
9,418,387,231,1036,2847
10,409,393,257,1059,2847
11,415,426,260,1101,2847
1,500,200,50,750,2848
2,444,225,101,770,2848
3,428,259,140,827,2848
4,407,291,178,876,2848
5,395,327,205,927,2848
6,386,349,217,952,2848
7,406,338,243,987,2848
8,421,315,272,1008,2848
9,413,351,263,1027,2848
10,405,380,259,1044,2848
11,417,401,279,1097,2848
1,500,200,50,750,2849
2,471,229,90,790,2849
3,437,246,137,820,2849
4,442,288,151,881,2849
5,410,309,196,915,2849
6,414,335,222,971,2849
7,405,355,228,988,2849
8,383,365,257,1005,2849
9,363,387,264,1014,2849
10,349,399,287,1035,2849
11,381,410,300,1091,2849
1,500,200,50,750,2850
2,468,226,107,801,2850
3,435,250,150,835,2850
4,409,278,181,868,2850
5,393,292,201,886,2850
6,417,319,216,952,2850
7,416,328,233,977,2850
8,420,333,260,1013,2850
9,408,350,269,1027,2850
10,424,378,277,1079,2850
11,397,386,303,1086,2850
1,500,200,50,750,2851
2,469,250,85,804,2851
3,421,251,136,808,2851
4,406,298,154,858,2851
5,404,312,202,918,2851
6,409,333,212,954,2851
7,421,343,222,986,2851
8,399,350,223,972,2851
9,421,371,264,1056,2851
10,402,391,262,1055,2851
11,393,409,284,1086,2851
1,500,200,50,750,2852
2,473,227,89,789,2852
3,448,239,141,828,2852
4,425,271,163,859,2852
5,430,297,183,910,2852
6,417,341,195,953,2852
7,409,339,220,968,2852
8,401,370,234,1005,2852
9,404,389,232,1025,2852
10,403,404,256,1063,2852
11,409,422,272,1103,2852
1,500,200,50,750,2853
2,459,212,113,784,2853
3,431,248,139,818,2853
4,423,297,160,880,2853
5,418,309,181,908,2853
6,424,333,204,961,2853
7,417,361,214,992,2853
8,419,351,232,1002,2853
9,416,387,234,1037,2853
10,416,390,249,1055,2853
11,427,391,254,1072,2853
1,500,200,50,750,2854
2,470,212,103,785,2854
3,468,249,122,839,2854
4,436,284,152,872,2854
5,422,304,180,906,2854
6,418,345,197,960,2854
7,385,344,241,970,2854
8,377,366,251,994,2854
9,376,366,264,1006,2854
10,404,391,268,1063,2854
11,398,408,271,1077,2854
1,500,200,50,750,2855
2,447,237,108,792,2855
3,405,268,154,827,2855
4,396,291,191,878,2855
5,354,346,194,894,2855
6,382,359,210,951,2855
7,388,373,224,985,2855
8,389,401,231,1021,2855
9,386,397,242,1025,2855
10,386,408,264,1058,2855
11,384,429,274,1087,2855
1,500,200,50,750,2856
2,451,248,108,807,2856
3,416,258,145,819,2856
4,398,293,188,879,2856
5,406,296,206,908,2856
6,395,353,208,956,2856
7,378,366,240,984,2856
8,363,377,260,1000,2856
9,354,415,264,1033,2856
10,377,429,269,1075,2856
11,399,430,267,1096,2856
1,500,200,50,750,2857
2,453,231,91,775,2857
3,457,277,120,854,2857
4,423,294,147,864,2857
5,394,325,187,906,2857
6,376,342,222,940,2857
7,396,350,246,992,2857
8,398,385,230,1013,2857
9,389,380,259,1028,2857
10,403,397,273,1073,2857
11,409,429,246,1084,2857
1,500,200,50,750,2858
2,463,235,102,800,2858
3,428,256,132,816,2858
4,419,308,143,870,2858
5,396,322,184,902,2858
6,414,354,203,971,2858
7,409,341,229,979,2858
8,402,365,248,1015,2858
9,387,380,263,1030,2858
10,389,386,279,1054,2858
11,398,430,267,1095,2858
1,500,200,50,750,2859
2,454,235,104,793,2859
3,429,259,146,834,2859
4,411,280,178,869,2859
5,397,307,209,913,2859
6,398,326,233,957,2859
7,398,355,242,995,2859
8,377,383,252,1012,2859
9,379,392,251,1022,2859
10,348,422,262,1032,2859
11,401,431,263,1095,2859
1,500,200,50,750,2860
2,468,243,92,803,2860
3,416,286,139,841,2860
4,385,305,175,865,2860
5,389,327,181,897,2860
6,388,363,209,960,2860
7,360,374,242,976,2860
8,359,385,255,999,2860
9,376,371,272,1019,2860
10,384,388,279,1051,2860
11,365,424,286,1075,2860
1,500,200,50,750,2861
2,467,230,85,782,2861
3,428,273,119,820,2861
4,434,295,129,858,2861
5,451,324,149,924,2861
6,429,322,203,954,2861
7,408,343,221,972,2861
8,397,370,239,1006,2861
9,393,387,250,1030,2861
10,381,402,282,1065,2861
11,388,397,301,1086,2861
1,500,200,50,750,2862
2,471,229,99,799,2862
3,431,252,138,821,2862
4,411,290,175,876,2862
5,392,292,220,904,2862
6,381,336,243,960,2862
7,383,337,259,979,2862
8,387,340,259,986,2862
9,392,363,262,1017,2862
10,400,402,263,1065,2862
11,398,414,264,1076,2862
1,500,200,50,750,2863
2,462,239,91,792,2863
3,416,272,132,820,2863
4,402,281,171,854,2863
5,415,312,191,918,2863
6,419,347,201,967,2863
7,413,353,207,973,2863
8,390,394,223,1007,2863
9,379,402,235,1016,2863
10,391,404,262,1057,2863
11,388,406,281,1075,2863
1,500,200,50,750,2864
2,470,229,103,802,2864
3,435,255,135,825,2864
4,430,275,163,868,2864
5,421,322,187,930,2864
6,432,338,203,973,2864
7,414,367,213,994,2864
8,388,371,248,1007,2864
9,370,408,233,1011,2864
10,417,395,239,1051,2864
11,449,402,246,1097,2864
1,500,200,50,750,2865
2,461,229,96,786,2865
3,414,274,146,834,2865
4,411,288,159,858,2865
5,421,320,168,909,2865
6,412,343,194,949,2865
7,401,360,214,975,2865
8,400,354,240,994,2865
9,403,393,244,1040,2865
10,377,415,265,1057,2865
11,374,416,284,1074,2865
1,500,200,50,750,2866
2,463,225,101,789,2866
3,440,250,141,831,2866
4,427,280,159,866,2866
5,437,304,182,923,2866
6,445,330,189,964,2866
7,416,365,206,987,2866
8,416,355,235,1006,2866
9,405,375,248,1028,2866
10,413,375,270,1058,2866
11,431,399,258,1088,2866
1,500,200,50,750,2867
2,480,222,104,806,2867
3,435,252,141,828,2867
4,399,300,163,862,2867
5,408,320,179,907,2867
6,417,346,203,966,2867
7,388,364,217,969,2867
8,391,382,236,1009,2867
9,384,402,243,1029,2867
10,392,411,254,1057,2867
11,408,437,251,1096,2867
1,500,200,50,750,2868
2,458,217,105,780,2868
3,427,261,137,825,2868
4,413,297,167,877,2868
5,403,317,194,914,2868
6,405,345,212,962,2868
7,392,357,225,974,2868
8,371,394,247,1012,2868
9,385,398,255,1038,2868
10,390,409,261,1060,2868
11,368,444,265,1077,2868
1,500,200,50,750,2869
2,480,210,106,796,2869
3,450,236,144,830,2869
4,427,276,169,872,2869
5,424,290,192,906,2869
6,422,347,199,968,2869
7,409,339,242,990,2869
8,412,360,236,1008,2869
9,407,360,264,1031,2869
10,427,342,278,1047,2869
11,434,375,275,1084,2869
1,500,200,50,750,2870
2,467,231,93,791,2870
3,444,255,129,828,2870
4,419,295,154,868,2870
5,426,328,164,918,2870
6,428,340,190,958,2870
7,409,361,208,978,2870
8,403,376,233,1012,2870
9,401,375,261,1037,2870
10,416,394,260,1070,2870
11,416,401,272,1089,2870
1,500,200,50,750,2871
2,444,227,102,773,2871
3,417,266,142,825,2871
4,415,287,169,871,2871
5,404,323,189,916,2871
6,419,336,205,960,2871
7,422,343,222,987,2871
8,404,372,241,1017,2871
9,408,371,271,1050,2871
10,397,410,254,1061,2871
11,374,411,291,1076,2871
1,500,200,50,750,2872
2,460,228,98,786,2872
3,414,259,142,815,2872
4,422,283,165,870,2872
5,410,304,181,895,2872
6,419,348,205,972,2872
7,396,364,227,987,2872
8,399,352,256,1007,2872
9,401,364,279,1044,2872
10,398,376,280,1054,2872
11,400,411,273,1084,2872
1,500,200,50,750,2873
2,453,231,106,790,2873
3,417,272,143,832,2873
4,425,278,173,876,2873
5,431,300,178,909,2873
6,424,346,196,966,2873
7,418,361,211,990,2873
8,411,363,224,998,2873
9,405,379,238,1022,2873
10,384,393,278,1055,2873
11,379,412,292,1083,2873
1,500,200,50,750,2874
2,459,233,102,794,2874
3,415,259,134,808,2874
4,400,300,178,878,2874
5,400,318,194,912,2874
6,403,334,217,954,2874
7,395,376,227,998,2874
8,394,389,218,1001,2874
9,389,397,243,1029,2874
10,410,396,258,1064,2874
11,399,422,259,1080,2874
1,500,200,50,750,2875
2,460,227,95,782,2875
3,443,248,145,836,2875
4,421,273,180,874,2875
5,405,297,209,911,2875
6,412,336,214,962,2875
7,403,357,220,980,2875
8,402,372,222,996,2875
9,411,385,241,1037,2875
10,413,411,245,1069,2875
11,424,394,254,1072,2875
1,500,200,50,750,2876
2,462,235,103,800,2876
3,422,254,143,819,2876
4,382,285,179,846,2876
5,367,329,189,885,2876
6,384,344,221,949,2876
7,390,347,231,968,2876
8,411,359,238,1008,2876
9,400,381,251,1032,2876
10,411,386,255,1052,2876
11,410,374,288,1072,2876
1,500,200,50,750,2877
2,461,228,98,787,2877
3,425,249,153,827,2877
4,414,280,178,872,2877
5,401,297,205,903,2877
6,398,347,217,962,2877
7,401,355,224,980,2877
8,395,378,237,1010,2877
9,408,365,265,1038,2877
10,420,373,271,1064,2877
11,418,377,291,1086,2877
1,500,200,50,750,2878
2,469,222,98,789,2878
3,425,262,141,828,2878
4,412,287,170,869,2878
5,398,355,163,916,2878
6,383,377,195,955,2878
7,390,362,226,978,2878
8,387,376,243,1006,2878
9,405,399,231,1035,2878
10,388,386,275,1049,2878
11,406,427,247,1080,2878
1,500,200,50,750,2879
2,453,235,100,788,2879
3,435,277,125,837,2879
4,411,292,157,860,2879
5,397,352,161,910,2879
6,399,365,190,954,2879
7,393,372,225,990,2879
8,393,380,229,1002,2879
9,407,416,222,1045,2879
10,412,389,257,1058,2879
11,412,396,276,1084,2879
1,500,200,50,750,2880
2,459,235,107,801,2880
3,440,256,134,830,2880
4,419,269,174,862,2880
5,394,317,187,898,2880
6,394,342,209,945,2880
7,384,351,230,965,2880
8,381,395,238,1014,2880
9,368,404,261,1033,2880
10,358,395,295,1048,2880
11,361,415,303,1079,2880
1,500,200,50,750,2881
2,460,234,88,782,2881
3,413,278,119,810,2881
4,425,293,164,882,2881
5,409,330,178,917,2881
6,404,353,191,948,2881
7,404,351,227,982,2881
8,391,375,241,1007,2881
9,375,397,249,1021,2881
10,389,406,255,1050,2881
11,403,423,273,1099,2881
1,500,200,50,750,2882
2,459,231,93,783,2882
3,414,268,150,832,2882
4,387,303,173,863,2882
5,366,327,210,903,2882
6,369,376,204,949,2882
7,380,370,224,974,2882
8,385,398,229,1012,2882
9,378,411,253,1042,2882
10,363,447,251,1061,2882
11,368,437,268,1073,2882
1,500,200,50,750,2883
2,469,219,106,794,2883
3,411,262,141,814,2883
4,405,284,167,856,2883
5,396,317,193,906,2883
6,413,348,196,957,2883
7,401,372,198,971,2883
8,401,372,231,1004,2883
9,391,367,256,1014,2883
10,386,404,271,1061,2883
11,387,419,283,1089,2883
1,500,200,50,750,2884
2,456,243,98,797,2884
3,413,272,142,827,2884
4,405,287,166,858,2884
5,421,300,208,929,2884
6,400,334,226,960,2884
7,391,334,249,974,2884
8,402,346,255,1003,2884
9,385,393,244,1022,2884
10,409,400,251,1060,2884
11,422,404,263,1089,2884
1,500,200,50,750,2885
2,462,231,97,790,2885
3,425,274,121,820,2885
4,425,306,147,878,2885
5,409,312,175,896,2885
6,414,334,208,956,2885
7,417,326,236,979,2885
8,440,358,225,1023,2885
9,412,353,258,1023,2885
10,415,387,245,1047,2885
11,424,404,259,1087,2885
1,500,200,50,750,2886
2,444,238,102,784,2886
3,417,283,131,831,2886
4,374,301,185,860,2886
5,381,325,213,919,2886
6,379,337,221,937,2886
7,376,355,234,965,2886
8,378,388,252,1018,2886
9,392,397,250,1039,2886
10,385,405,255,1045,2886
11,409,415,273,1097,2886
1,500,200,50,750,2887
2,450,244,97,791,2887
3,414,282,125,821,2887
4,407,294,163,864,2887
5,417,311,185,913,2887
6,405,329,227,961,2887
7,416,350,219,985,2887
8,395,370,230,995,2887
9,412,385,234,1031,2887
10,397,377,265,1039,2887
11,409,425,255,1089,2887
1,500,200,50,750,2888
2,459,214,105,778,2888
3,459,258,121,838,2888
4,407,293,173,873,2888
5,391,304,205,900,2888
6,405,343,222,970,2888
7,382,363,233,978,2888
8,393,378,240,1011,2888
9,373,407,256,1036,2888
10,376,409,266,1051,2888
11,394,411,273,1078,2888
1,500,200,50,750,2889
2,463,229,87,779,2889
3,439,267,121,827,2889
4,429,278,160,867,2889
5,420,296,205,921,2889
6,401,313,228,942,2889
7,409,342,239,990,2889
8,403,347,246,996,2889
9,391,370,263,1024,2889
10,379,415,257,1051,2889
11,397,418,267,1082,2889
1,500,200,50,750,2890
2,446,243,90,779,2890
3,440,262,134,836,2890
4,428,268,161,857,2890
5,441,305,176,922,2890
6,441,350,185,976,2890
7,422,355,211,988,2890
8,419,372,225,1016,2890
9,426,370,237,1033,2890
10,436,378,254,1068,2890
11,420,376,272,1068,2890
1,500,200,50,750,2891
2,467,235,86,788,2891
3,438,263,129,830,2891
4,399,301,169,869,2891
5,400,308,211,919,2891
6,416,329,222,967,2891
7,395,342,236,973,2891
8,404,335,244,983,2891
9,434,381,255,1070,2891
10,417,364,276,1057,2891
11,408,379,288,1075,2891
1,500,200,50,750,2892
2,456,244,105,805,2892
3,419,283,127,829,2892
4,400,291,169,860,2892
5,406,313,200,919,2892
6,416,335,211,962,2892
7,401,337,238,976,2892
8,386,369,249,1004,2892
9,399,395,238,1032,2892
10,408,376,272,1056,2892
11,388,399,277,1064,2892
1,500,200,50,750,2893
2,453,231,98,782,2893
3,406,280,138,824,2893
4,399,314,167,880,2893
5,370,344,186,900,2893
6,383,351,207,941,2893
7,394,359,228,981,2893
8,398,373,245,1016,2893
9,391,389,261,1041,2893
10,399,399,264,1062,2893
11,397,386,287,1070,2893
1,500,200,50,750,2894
2,470,211,95,776,2894
3,445,245,132,822,2894
4,422,291,159,872,2894
5,418,319,186,923,2894
6,393,349,212,954,2894
7,404,362,229,995,2894
8,385,370,242,997,2894
9,384,381,262,1027,2894
10,392,400,263,1055,2894
11,387,421,276,1084,2894
1,500,200,50,750,2895
2,457,238,95,790,2895
3,425,271,123,819,2895
4,414,311,133,858,2895
5,379,325,176,880,2895
6,420,345,211,976,2895
7,411,336,227,974,2895
8,394,345,249,988,2895
9,391,368,270,1029,2895
10,393,426,261,1080,2895
11,381,444,268,1093,2895
1,500,200,50,750,2896
2,444,239,86,769,2896
3,425,281,117,823,2896
4,406,304,144,854,2896
5,406,322,172,900,2896
6,405,353,188,946,2896
7,407,362,223,992,2896
8,405,364,244,1013,2896
9,400,371,248,1019,2896
10,378,403,267,1048,2896
11,412,402,272,1086,2896
1,500,200,50,750,2897
2,449,224,104,777,2897
3,432,271,129,832,2897
4,408,288,169,865,2897
5,409,318,187,914,2897
6,406,349,203,958,2897
7,400,363,226,989,2897
8,381,391,240,1012,2897
9,386,378,269,1033,2897
10,379,389,288,1056,2897
11,374,396,313,1083,2897
1,500,200,50,750,2898
2,453,223,110,786,2898
3,420,250,157,827,2898
4,415,274,183,872,2898
5,412,295,226,933,2898
6,406,317,219,942,2898
7,402,334,231,967,2898
8,393,374,243,1010,2898
9,393,395,263,1051,2898
10,379,414,270,1063,2898
11,376,419,282,1077,2898
1,500,200,50,750,2899
2,436,254,95,785,2899
3,399,274,120,793,2899
4,450,292,146,888,2899
5,433,312,175,920,2899
6,414,353,182,949,2899
7,395,364,219,978,2899
8,397,365,233,995,2899
9,395,394,247,1036,2899
10,409,405,246,1060,2899
11,413,416,264,1093,2899
1,500,200,50,750,2900
2,467,237,97,801,2900
3,432,275,136,843,2900
4,414,300,163,877,2900
5,393,329,187,909,2900
6,389,354,204,947,2900
7,381,366,215,962,2900
8,388,363,236,987,2900
9,385,384,254,1023,2900
10,403,390,266,1059,2900
11,419,411,265,1095,2900
1,500,200,50,750,2901
2,466,230,95,791,2901
3,445,240,137,822,2901
4,443,277,162,882,2901
5,414,317,189,920,2901
6,401,368,200,969,2901
7,377,397,211,985,2901
8,369,411,230,1010,2901
9,377,424,234,1035,2901
10,387,412,273,1072,2901
11,379,415,279,1073,2901
1,500,200,50,750,2902
2,459,214,107,780,2902
3,421,257,145,823,2902
4,418,292,151,861,2902
5,406,336,168,910,2902
6,396,346,207,949,2902
7,383,333,249,965,2902
8,390,367,249,1006,2902
9,402,374,284,1060,2902
10,388,389,277,1054,2902
11,397,400,297,1094,2902
1,500,200,50,750,2903
2,474,212,95,781,2903
3,426,234,159,819,2903
4,400,271,189,860,2903
5,400,318,203,921,2903
6,371,338,219,928,2903
7,373,356,228,957,2903
8,379,366,235,980,2903
9,397,369,258,1024,2903
10,405,384,265,1054,2903
11,399,414,253,1066,2903
1,500,200,50,750,2904
2,471,228,86,785,2904
3,440,245,130,815,2904
4,432,285,159,876,2904
5,414,324,165,903,2904
6,420,329,209,958,2904
7,404,359,227,990,2904
8,405,357,244,1006,2904
9,384,389,255,1028,2904
10,379,398,265,1042,2904
11,399,406,277,1082,2904
1,500,200,50,750,2905
2,475,224,100,799,2905
3,438,256,132,826,2905
4,395,307,149,851,2905
5,417,340,167,924,2905
6,403,346,201,950,2905
7,412,358,219,989,2905
8,394,361,257,1012,2905
9,380,389,259,1028,2905
10,379,391,286,1056,2905
11,382,415,291,1088,2905
1,500,200,50,750,2906
2,459,243,101,803,2906
3,433,276,122,831,2906
4,408,297,148,853,2906
5,399,335,166,900,2906
6,419,334,198,951,2906
7,426,352,208,986,2906
8,401,375,219,995,2906
9,390,396,245,1031,2906
10,403,386,273,1062,2906
11,411,387,288,1086,2906
1,500,200,50,750,2907
2,447,243,99,789,2907
3,415,268,148,831,2907
4,393,302,163,858,2907
5,405,303,190,898,2907
6,421,322,209,952,2907
7,403,342,234,979,2907
8,417,373,228,1018,2907
9,397,397,252,1046,2907
10,376,405,278,1059,2907
11,392,398,300,1090,2907
1,500,200,50,750,2908
2,462,233,98,793,2908
3,418,266,152,836,2908
4,406,294,165,865,2908
5,426,299,196,921,2908
6,410,315,208,933,2908
7,445,346,211,1002,2908
8,413,358,224,995,2908
9,411,380,229,1020,2908
10,415,407,245,1067,2908
11,410,413,263,1086,2908
1,500,200,50,750,2909
2,463,225,103,791,2909
3,411,261,139,811,2909
4,411,270,186,867,2909
5,385,305,201,891,2909
6,405,335,215,955,2909
7,396,355,226,977,2909
8,391,370,239,1000,2909
9,375,382,274,1031,2909
10,376,381,288,1045,2909
11,405,416,269,1090,2909
1,500,200,50,750,2910
2,441,232,111,784,2910
3,404,276,147,827,2910
4,387,315,168,870,2910
5,369,336,182,887,2910
6,389,360,213,962,2910
7,382,371,227,980,2910
8,376,390,245,1011,2910
9,374,412,249,1035,2910
10,385,381,283,1049,2910
11,383,426,277,1086,2910
1,500,200,50,750,2911
2,464,222,98,784,2911
3,443,253,122,818,2911
4,414,300,148,862,2911
5,425,327,169,921,2911
6,425,341,207,973,2911
7,393,351,239,983,2911
8,399,350,259,1008,2911
9,412,365,265,1042,2911
10,407,388,271,1066,2911
11,403,388,271,1062,2911
1,500,200,50,750,2912
2,449,241,95,785,2912
3,426,252,133,811,2912
4,395,308,159,862,2912
5,389,343,174,906,2912
6,382,355,220,957,2912
7,387,364,239,990,2912
8,391,376,237,1004,2912
9,393,377,262,1032,2912
10,390,392,267,1049,2912
11,373,397,296,1066,2912
1,500,200,50,750,2913
2,464,229,101,794,2913
3,437,253,140,830,2913
4,420,278,151,849,2913
5,427,293,162,882,2913
6,436,327,181,944,2913
7,447,334,197,978,2913
8,443,353,210,1006,2913
9,417,376,219,1012,2913
10,429,409,247,1085,2913
11,415,397,275,1087,2913
1,500,200,50,750,2914
2,473,217,88,778,2914
3,460,254,111,825,2914
4,451,270,138,859,2914
5,441,325,178,944,2914
6,410,345,203,958,2914
7,392,344,230,966,2914
8,392,376,243,1011,2914
9,402,381,246,1029,2914
10,399,367,273,1039,2914
11,411,378,287,1076,2914
1,500,200,50,750,2915
2,456,234,88,778,2915
3,437,278,116,831,2915
4,407,327,145,879,2915
5,382,346,185,913,2915
6,397,333,211,941,2915
7,400,344,220,964,2915
8,391,359,252,1002,2915
9,398,350,272,1020,2915
10,410,374,281,1065,2915
11,395,398,298,1091,2915
1,500,200,50,750,2916
2,440,228,113,781,2916
3,451,229,153,833,2916
4,425,275,184,884,2916
5,422,302,184,908,2916
6,421,336,209,966,2916
7,386,383,220,989,2916
8,379,391,243,1013,2916
9,376,392,274,1042,2916
10,383,407,267,1057,2916
11,390,408,281,1079,2916
1,500,200,50,750,2917
2,443,232,96,771,2917
3,427,254,140,821,2917
4,425,287,150,862,2917
5,416,305,183,904,2917
6,435,318,219,972,2917
7,423,331,230,984,2917
8,407,357,237,1001,2917
9,423,351,260,1034,2917
10,411,378,261,1050,2917
11,410,401,281,1092,2917
1,500,200,50,750,2918
2,466,225,101,792,2918
3,427,254,146,827,2918
4,423,287,155,865,2918
5,431,330,165,926,2918
6,402,366,191,959,2918
7,397,372,214,983,2918
8,393,394,236,1023,2918
9,404,363,274,1041,2918
10,419,356,286,1061,2918
11,419,389,286,1094,2918
1,500,200,50,750,2919
2,449,234,100,783,2919
3,462,245,128,835,2919
4,421,277,154,852,2919
5,454,295,169,918,2919
6,436,334,195,965,2919
7,396,350,226,972,2919
8,399,359,246,1004,2919
9,399,375,248,1022,2919
10,395,401,248,1044,2919
11,418,399,257,1074,2919
1,500,200,50,750,2920
2,438,225,121,784,2920
3,424,260,145,829,2920
4,408,292,158,858,2920
5,424,313,181,918,2920
6,411,328,206,945,2920
7,393,342,247,982,2920
8,374,386,239,999,2920
9,400,385,263,1048,2920
10,390,384,287,1061,2920
11,395,408,275,1078,2920
1,500,200,50,750,2921
2,491,219,90,800,2921
3,450,251,126,827,2921
4,410,282,169,861,2921
5,391,308,200,899,2921
6,381,363,221,965,2921
7,365,381,245,991,2921
8,361,363,275,999,2921
9,378,386,272,1036,2921
10,375,420,270,1065,2921
11,380,419,289,1088,2921
1,500,200,50,750,2922
2,454,239,87,780,2922
3,438,264,128,830,2922
4,431,272,166,869,2922
5,406,286,204,896,2922
6,391,329,230,950,2922
7,377,385,227,989,2922
8,400,376,237,1013,2922
9,394,388,252,1034,2922
10,382,421,254,1057,2922
11,398,420,267,1085,2922
1,500,200,50,750,2923
2,464,226,104,794,2923
3,407,268,146,821,2923
4,409,304,158,871,2923
5,377,332,206,915,2923
6,388,341,238,967,2923
7,384,358,247,989,2923
8,400,364,253,1017,2923
9,397,381,249,1027,2923
10,383,406,252,1041,2923
11,400,404,271,1075,2923
1,500,200,50,750,2924
2,476,227,93,796,2924
3,432,269,123,824,2924
4,424,297,152,873,2924
5,421,301,184,906,2924
6,414,333,206,953,2924
7,420,366,204,990,2924
8,407,379,225,1011,2924
9,397,386,252,1035,2924
10,385,405,277,1067,2924
11,388,393,293,1074,2924
1,500,200,50,750,2925
2,450,239,91,780,2925
3,425,271,126,822,2925
4,416,307,151,874,2925
5,410,327,179,916,2925
6,397,355,204,956,2925
7,377,371,242,990,2925
8,377,374,258,1009,2925
9,384,389,276,1049,2925
10,380,387,285,1052,2925
11,379,372,315,1066,2925
1,500,200,50,750,2926
2,456,220,102,778,2926
3,432,250,139,821,2926
4,434,278,161,873,2926
5,393,327,185,905,2926
6,384,322,224,930,2926
7,404,358,235,997,2926
8,408,372,234,1014,2926
9,407,390,234,1031,2926
10,391,415,252,1058,2926
11,408,434,235,1077,2926
1,500,200,50,750,2927
2,454,225,108,787,2927
3,448,237,143,828,2927
4,428,271,179,878,2927
5,403,318,197,918,2927
6,395,333,220,948,2927
7,401,368,224,993,2927
8,374,369,257,1000,2927
9,384,387,266,1037,2927
10,398,395,286,1079,2927
11,396,381,306,1083,2927
1,500,200,50,750,2928
2,465,222,106,793,2928
3,442,247,142,831,2928
4,421,249,190,860,2928
5,413,288,210,911,2928
6,422,314,222,958,2928
7,412,332,241,985,2928
8,391,354,259,1004,2928
9,373,383,264,1020,2928
10,377,395,277,1049,2928
11,385,414,276,1075,2928
1,500,200,50,750,2929
2,468,220,107,795,2929
3,425,249,145,819,2929
4,412,288,152,852,2929
5,415,314,168,897,2929
6,422,337,199,958,2929
7,387,345,243,975,2929
8,396,366,249,1011,2929
9,374,382,266,1022,2929
10,387,381,282,1050,2929
11,382,414,286,1082,2929
1,500,200,50,750,2930
2,457,238,97,792,2930
3,415,251,151,817,2930
4,426,262,178,866,2930
5,395,302,202,899,2930
6,403,341,204,948,2930
7,384,374,225,983,2930
8,392,375,241,1008,2930
9,388,378,262,1028,2930
10,419,403,258,1080,2930
11,408,415,258,1081,2930
1,500,200,50,750,2931
2,454,237,96,787,2931
3,409,278,124,811,2931
4,407,286,164,857,2931
5,417,301,191,909,2931
6,414,336,206,956,2931
7,403,345,228,976,2931
8,394,374,226,994,2931
9,405,364,252,1021,2931
10,385,391,270,1046,2931
11,413,399,290,1102,2931
1,500,200,50,750,2932
2,454,220,102,776,2932
3,437,264,140,841,2932
4,418,273,181,872,2932
5,412,305,201,918,2932
6,409,352,212,973,2932
7,398,345,244,987,2932
8,384,382,237,1003,2932
9,398,372,259,1029,2932
10,396,397,258,1051,2932
11,414,406,261,1081,2932
1,500,200,50,750,2933
2,444,223,115,782,2933
3,438,254,158,850,2933
4,385,291,190,866,2933
5,381,329,207,917,2933
6,375,360,206,941,2933
7,420,350,224,994,2933
8,416,344,243,1003,2933
9,411,358,261,1030,2933
10,428,372,279,1079,2933
11,399,415,265,1079,2933
1,500,200,50,750,2934
2,459,228,107,794,2934
3,426,259,139,824,2934
4,417,289,172,878,2934
5,404,310,205,919,2934
6,410,322,219,951,2934
7,391,354,232,977,2934
8,398,366,253,1017,2934
9,397,372,251,1020,2934
10,410,393,254,1057,2934
11,407,411,263,1081,2934
1,500,200,50,750,2935
2,443,238,90,771,2935
3,429,274,129,832,2935
4,406,306,150,862,2935
5,420,320,187,927,2935
6,379,337,225,941,2935
7,366,356,249,971,2935
8,385,396,235,1016,2935
9,370,404,259,1033,2935
10,359,424,272,1055,2935
11,364,422,288,1074,2935
1,500,200,50,750,2936
2,439,244,95,778,2936
3,441,286,118,845,2936
4,417,275,168,860,2936
5,452,300,189,941,2936
6,425,333,210,968,2936
7,428,336,223,987,2936
8,419,343,235,997,2936
9,417,358,253,1028,2936
10,401,392,247,1040,2936
11,397,417,250,1064,2936
1,500,200,50,750,2937
2,454,238,103,795,2937
3,416,266,142,824,2937
4,416,287,172,875,2937
5,391,315,210,916,2937
6,408,347,215,970,2937
7,372,358,254,984,2937
8,355,359,284,998,2937
9,367,368,297,1032,2937
10,384,404,286,1074,2937
11,380,416,281,1077,2937
1,500,200,50,750,2938
2,466,238,87,791,2938
3,438,260,123,821,2938
4,436,280,162,878,2938
5,407,298,198,903,2938
6,423,323,206,952,2938
7,415,343,223,981,2938
8,415,352,245,1012,2938
9,401,359,259,1019,2938
10,379,389,296,1064,2938
11,401,409,292,1102,2938
1,500,200,50,750,2939
2,464,245,88,797,2939
3,437,258,128,823,2939
4,436,282,166,884,2939
5,407,309,187,903,2939
6,413,337,194,944,2939
7,413,367,217,997,2939
8,397,364,236,997,2939
9,403,396,234,1033,2939
10,415,371,268,1054,2939
11,421,388,275,1084,2939
1,500,200,50,750,2940
2,467,221,106,794,2940
3,441,250,140,831,2940
4,411,281,167,859,2940
5,427,310,200,937,2940
6,401,350,201,952,2940
7,390,347,236,973,2940
8,372,361,266,999,2940
9,402,376,265,1043,2940
10,396,390,288,1074,2940
11,415,402,278,1095,2940
1,500,200,50,750,2941
2,486,239,87,812,2941
3,433,247,137,817,2941
4,410,266,177,853,2941
5,392,309,207,908,2941
6,405,355,210,970,2941
7,382,403,215,1000,2941
8,357,406,231,994,2941
9,373,411,253,1037,2941
10,390,412,263,1065,2941
11,385,412,275,1072,2941
1,500,200,50,750,2942
2,459,232,105,796,2942
3,440,264,129,833,2942
4,426,281,158,865,2942
5,407,317,187,911,2942
6,396,363,193,952,2942
7,396,373,214,983,2942
8,371,404,224,999,2942
9,378,412,254,1044,2942
10,390,397,266,1053,2942
11,400,413,266,1079,2942
1,500,200,50,750,2943
2,448,232,96,776,2943
3,452,267,115,834,2943
4,422,291,154,867,2943
5,415,317,181,913,2943
6,436,305,227,968,2943
7,404,346,232,982,2943
8,403,352,247,1002,2943
9,411,384,228,1023,2943
10,416,397,251,1064,2943
11,418,407,263,1088,2943
1,500,200,50,750,2944
2,459,240,101,800,2944
3,445,276,123,844,2944
4,412,302,163,877,2944
5,390,326,192,908,2944
6,399,349,214,962,2944
7,380,369,229,978,2944
8,414,361,241,1016,2944
9,413,377,245,1035,2944
10,418,376,250,1044,2944
11,431,397,262,1090,2944
1,500,200,50,750,2945
2,456,244,87,787,2945
3,417,294,106,817,2945
4,424,303,138,865,2945
5,430,315,175,920,2945
6,439,322,204,965,2945
7,425,336,226,987,2945
8,422,355,241,1018,2945
9,403,367,261,1031,2945
10,394,396,261,1051,2945
11,421,406,269,1096,2945
1,500,200,50,750,2946
2,470,221,104,795,2946
3,435,271,124,830,2946
4,426,281,149,856,2946
5,413,305,191,909,2946
6,415,336,213,964,2946
7,397,370,214,981,2946
8,407,355,245,1007,2946
9,374,350,285,1009,2946
10,378,391,283,1052,2946
11,377,405,277,1059,2946
1,500,200,50,750,2947
2,439,234,108,781,2947
3,408,288,134,830,2947
4,397,326,144,867,2947
5,401,339,177,917,2947
6,395,358,202,955,2947
7,404,365,203,972,2947
8,394,384,221,999,2947
9,396,369,255,1020,2947
10,413,378,253,1044,2947
11,434,413,249,1096,2947
1,500,200,50,750,2948
2,477,213,91,781,2948
3,451,261,134,846,2948
4,421,293,155,869,2948
5,408,330,169,907,2948
6,428,352,202,982,2948
7,398,342,242,982,2948
8,398,359,249,1006,2948
9,381,376,262,1019,2948
10,438,394,253,1085,2948
11,434,399,249,1082,2948
1,500,200,50,750,2949
2,461,233,100,794,2949
3,430,276,143,849,2949
4,400,290,167,857,2949
5,398,290,190,878,2949
6,428,326,191,945,2949
7,419,362,193,974,2949
8,394,387,217,998,2949
9,396,392,235,1023,2949
10,401,390,256,1047,2949
11,399,387,285,1071,2949
1,500,200,50,750,2950
2,453,230,95,778,2950
3,408,269,146,823,2950
4,398,292,169,859,2950
5,417,308,197,922,2950
6,412,344,213,969,2950
7,390,368,224,982,2950
8,392,368,240,1000,2950
9,376,409,251,1036,2950
10,374,406,269,1049,2950
11,394,417,278,1089,2950
1,500,200,50,750,2951
2,444,235,120,799,2951
3,420,255,151,826,2951
4,405,300,165,870,2951
5,404,325,189,918,2951
6,404,349,192,945,2951
7,403,351,214,968,2951
8,393,367,233,993,2951
9,401,365,261,1027,2951
10,399,397,262,1058,2951
11,420,406,265,1091,2951
1,500,200,50,750,2952
2,472,230,91,793,2952
3,454,249,130,833,2952
4,466,260,159,885,2952
5,446,288,171,905,2952
6,439,331,193,963,2952
7,412,349,226,987,2952
8,402,383,223,1008,2952
9,402,407,233,1042,2952
10,402,412,239,1053,2952
11,420,402,265,1087,2952
1,500,200,50,750,2953
2,476,219,94,789,2953
3,454,240,132,826,2953
4,429,260,173,862,2953
5,426,290,206,922,2953
6,412,314,230,956,2953
7,414,338,234,986,2953
8,404,372,225,1001,2953
9,409,415,221,1045,2953
10,392,411,258,1061,2953
11,393,424,280,1097,2953
1,500,200,50,750,2954
2,453,232,106,791,2954
3,414,275,128,817,2954
4,407,295,167,869,2954
5,411,303,206,920,2954
6,425,333,208,966,2954
7,406,352,230,988,2954
8,410,350,235,995,2954
9,411,374,234,1019,2954
10,402,396,257,1055,2954
11,388,398,271,1057,2954
1,500,200,50,750,2955
2,461,225,99,785,2955
3,437,254,137,828,2955
4,399,290,175,864,2955
5,397,319,188,904,2955
6,412,332,205,949,2955
7,395,351,239,985,2955
8,386,366,263,1015,2955
9,389,376,270,1035,2955
10,405,372,278,1055,2955
11,398,383,304,1085,2955
1,500,200,50,750,2956
2,459,226,95,780,2956
3,438,242,138,818,2956
4,428,284,168,880,2956
5,408,318,181,907,2956
6,397,342,211,950,2956
7,395,357,221,973,2956
8,417,370,209,996,2956
9,413,384,235,1032,2956
10,413,394,252,1059,2956
11,413,402,255,1070,2956
1,500,200,50,750,2957
2,468,222,103,793,2957
3,444,251,132,827,2957
4,427,266,170,863,2957
5,414,318,181,913,2957
6,417,362,197,976,2957
7,404,352,217,973,2957
8,412,376,230,1018,2957
9,397,369,264,1030,2957
10,398,373,270,1041,2957
11,418,383,278,1079,2957
1,500,200,50,750,2958
2,461,228,88,777,2958
3,448,246,131,825,2958
4,433,262,165,860,2958
5,437,280,203,920,2958
6,418,334,223,975,2958
7,385,356,241,982,2958
8,389,370,238,997,2958
9,396,399,252,1047,2958
10,397,393,257,1047,2958
11,402,408,260,1070,2958
1,500,200,50,750,2959
2,466,229,94,789,2959
3,441,262,128,831,2959
4,426,277,164,867,2959
5,419,309,182,910,2959
6,418,323,227,968,2959
7,396,322,248,966,2959
8,389,342,269,1000,2959
9,380,368,275,1023,2959
10,414,393,260,1067,2959
11,431,364,292,1087,2959
1,500,200,50,750,2960
2,467,231,102,800,2960
3,412,265,139,816,2960
4,414,295,171,880,2960
5,411,324,183,918,2960
6,412,345,205,962,2960
7,429,345,217,991,2960
8,415,345,229,989,2960
9,411,386,244,1041,2960
10,408,393,260,1061,2960
11,415,405,254,1074,2960
1,500,200,50,750,2961
2,458,223,93,774,2961
3,448,227,140,815,2961
4,437,252,165,854,2961
5,410,276,205,891,2961
6,420,317,220,957,2961
7,402,329,236,967,2961
8,416,373,244,1033,2961
9,383,387,256,1026,2961
10,392,395,262,1049,2961
11,394,430,252,1076,2961
1,500,200,50,750,2962
2,480,232,82,794,2962
3,446,255,119,820,2962
4,430,285,157,872,2962
5,422,296,192,910,2962
6,442,307,222,971,2962
7,418,341,219,978,2962
8,417,352,250,1019,2962
9,396,352,288,1036,2962
10,386,370,283,1039,2962
11,392,391,286,1069,2962
1,500,200,50,750,2963
2,471,226,92,789,2963
3,416,283,124,823,2963
4,412,298,146,856,2963
5,425,302,171,898,2963
6,434,346,196,976,2963
7,397,372,212,981,2963
8,391,374,221,986,2963
9,411,387,247,1045,2963
10,398,391,268,1057,2963
11,411,401,268,1080,2963
1,500,200,50,750,2964
2,481,221,93,795,2964
3,439,242,129,810,2964
4,432,280,160,872,2964
5,405,317,195,917,2964
6,403,342,216,961,2964
7,391,364,237,992,2964
8,374,380,242,996,2964
9,390,382,254,1026,2964
10,395,400,267,1062,2964
11,399,401,293,1093,2964
1,500,200,50,750,2965
2,447,239,97,783,2965
3,403,271,132,806,2965
4,408,290,158,856,2965
5,420,286,194,900,2965
6,426,316,225,967,2965
7,403,347,240,990,2965
8,413,353,244,1010,2965
9,405,372,248,1025,2965
10,396,370,279,1045,2965
11,397,393,303,1093,2965
1,500,200,50,750,2966
2,449,251,88,788,2966
3,435,267,128,830,2966
4,419,282,161,862,2966
5,410,296,199,905,2966
6,404,331,210,945,2966
7,386,352,252,990,2966
8,383,339,281,1003,2966
9,394,361,254,1009,2966
10,426,381,257,1064,2966
11,401,404,256,1061,2966
1,500,200,50,750,2967
2,439,252,101,792,2967
3,426,284,124,834,2967
4,406,311,159,876,2967
5,383,309,196,888,2967
6,410,342,213,965,2967
7,387,369,223,979,2967
8,377,396,241,1014,2967
9,401,386,237,1024,2967
10,380,410,248,1038,2967
11,400,405,272,1077,2967
1,500,200,50,750,2968
2,443,236,93,772,2968
3,432,260,135,827,2968
4,414,298,146,858,2968
5,413,336,177,926,2968
6,441,331,195,967,2968
7,407,361,209,977,2968
8,411,371,222,1004,2968
9,415,378,230,1023,2968
10,427,365,263,1055,2968
11,425,409,249,1083,2968
1,500,200,50,750,2969
2,458,234,94,786,2969
3,419,279,125,823,2969
4,396,305,155,856,2969
5,385,332,192,909,2969
6,391,380,204,975,2969
7,384,359,243,986,2969
8,388,390,245,1023,2969
9,386,373,275,1034,2969
10,379,369,301,1049,2969
11,386,403,288,1077,2969
1,500,200,50,750,2970
2,432,237,108,777,2970
3,421,273,147,841,2970
4,390,302,162,854,2970
5,402,306,195,903,2970
6,424,341,194,959,2970
7,387,349,233,969,2970
8,411,367,238,1016,2970
9,407,368,259,1034,2970
10,401,404,277,1082,2970
11,388,409,283,1080,2970
1,500,200,50,750,2971
2,480,230,91,801,2971
3,440,247,133,820,2971
4,409,289,154,852,2971
5,423,305,197,925,2971
6,400,342,214,956,2971
7,379,372,229,980,2971
8,368,413,228,1009,2971
9,365,399,254,1018,2971
10,381,415,266,1062,2971
11,388,411,296,1095,2971
1,500,200,50,750,2972
2,449,255,87,791,2972
3,417,260,135,812,2972
4,407,289,161,857,2972
5,410,299,193,902,2972
6,409,345,198,952,2972
7,406,369,218,993,2972
8,390,365,244,999,2972
9,386,395,257,1038,2972
10,380,419,248,1047,2972
11,386,410,274,1070,2972
1,500,200,50,750,2973
2,478,231,91,800,2973
3,441,244,143,828,2973
4,422,273,166,861,2973
5,409,303,196,908,2973
6,431,349,202,982,2973
7,402,349,230,981,2973
8,404,336,265,1005,2973
9,401,377,246,1024,2973
10,407,388,256,1051,2973
11,389,395,293,1077,2973
1,500,200,50,750,2974
2,466,231,101,798,2974
3,455,250,120,825,2974
4,431,284,162,877,2974
5,440,298,187,925,2974
6,451,333,190,974,2974
7,426,339,215,980,2974
8,417,364,229,1010,2974
9,410,372,246,1028,2974
10,417,413,231,1061,2974
11,416,431,230,1077,2974
1,500,200,50,750,2975
2,453,235,112,800,2975
3,423,275,128,826,2975
4,402,309,161,872,2975
5,380,326,199,905,2975
6,390,359,211,960,2975
7,389,365,229,983,2975
8,385,374,239,998,2975
9,399,398,245,1042,2975
10,377,411,258,1046,2975
11,402,420,262,1084,2975
1,500,200,50,750,2976
2,432,224,111,767,2976
3,421,267,148,836,2976
4,389,290,180,859,2976
5,396,300,226,922,2976
6,410,321,240,971,2976
7,378,354,253,985,2976
8,391,365,257,1013,2976
9,393,381,251,1025,2976
10,409,401,251,1061,2976
11,401,419,270,1090,2976
1,500,200,50,750,2977
2,458,234,106,798,2977
3,422,243,148,813,2977
4,407,258,188,853,2977
5,411,292,207,910,2977
6,426,330,199,955,2977
7,423,352,208,983,2977
8,387,364,245,996,2977
9,392,373,256,1021,2977
10,403,382,266,1051,2977
11,404,401,285,1090,2977
1,500,200,50,750,2978
2,463,216,117,796,2978
3,417,237,158,812,2978
4,424,254,193,871,2978
5,419,279,210,908,2978
6,398,325,226,949,2978
7,384,337,261,982,2978
8,384,355,264,1003,2978
9,401,393,245,1039,2978
10,407,412,256,1075,2978
11,407,421,261,1089,2978
1,500,200,50,750,2979
2,451,230,110,791,2979
3,413,273,141,827,2979
4,381,321,162,864,2979
5,391,334,196,921,2979
6,383,367,212,962,2979
7,375,380,228,983,2979
8,395,384,223,1002,2979
9,395,409,224,1028,2979
10,387,416,243,1046,2979
11,412,406,276,1094,2979
1,500,200,50,750,2980
2,479,218,99,796,2980
3,439,250,132,821,2980
4,420,275,174,869,2980
5,420,308,197,925,2980
6,414,314,226,954,2980
7,414,342,235,991,2980
8,395,370,246,1011,2980
9,401,367,263,1031,2980
10,379,385,270,1034,2980
11,382,430,287,1099,2980
1,500,200,50,750,2981
2,466,235,98,799,2981
3,426,280,133,839,2981
4,403,292,168,863,2981
5,422,318,173,913,2981
6,417,330,203,950,2981
7,395,351,239,985,2981
8,409,352,255,1016,2981
9,389,372,261,1022,2981
10,394,400,271,1065,2981
11,378,431,277,1086,2981
1,500,200,50,750,2982
2,479,219,93,791,2982
3,456,253,116,825,2982
4,440,288,155,883,2982
5,420,309,177,906,2982
6,414,327,200,941,2982
7,415,364,210,989,2982
8,396,371,241,1008,2982
9,417,382,255,1054,2982
10,395,378,272,1045,2982
11,415,381,268,1064,2982
1,500,200,50,750,2983
2,465,224,95,784,2983
3,443,251,133,827,2983
4,429,280,163,872,2983
5,440,297,173,910,2983
6,429,325,198,952,2983
7,419,347,216,982,2983
8,405,366,229,1000,2983
9,403,366,253,1022,2983
10,422,377,274,1073,2983
11,411,390,278,1079,2983
1,500,200,50,750,2984
2,473,222,90,785,2984
3,423,267,127,817,2984
4,447,272,159,878,2984
5,421,301,179,901,2984
6,432,330,195,957,2984
7,438,337,218,993,2984
8,429,346,240,1015,2984
9,415,349,271,1035,2984
10,425,349,284,1058,2984
11,431,370,279,1080,2984
1,500,200,50,750,2985
2,470,232,94,796,2985
3,438,256,135,829,2985
4,420,290,164,874,2985
5,410,318,195,923,2985
6,397,336,233,966,2985
7,392,352,238,982,2985
8,393,353,258,1004,2985
9,416,383,243,1042,2985
10,408,408,240,1056,2985
11,420,411,258,1089,2985
1,500,200,50,750,2986
2,454,225,105,784,2986
3,454,252,143,849,2986
4,402,292,179,873,2986
5,396,318,204,918,2986
6,380,326,233,939,2986
7,407,343,234,984,2986
8,406,363,249,1018,2986
9,388,395,253,1036,2986
10,392,397,272,1061,2986
11,397,420,270,1087,2986
1,500,200,50,750,2987
2,446,243,93,782,2987
3,411,267,146,824,2987
4,410,291,161,862,2987
5,426,297,168,891,2987
6,421,327,206,954,2987
7,430,336,228,994,2987
8,417,362,228,1007,2987
9,429,378,254,1061,2987
10,414,350,294,1058,2987
11,402,386,292,1080,2987
1,500,200,50,750,2988
2,471,237,95,803,2988
3,420,275,125,820,2988
4,402,291,163,856,2988
5,404,334,175,913,2988
6,406,354,203,963,2988
7,404,358,223,985,2988
8,384,365,261,1010,2988
9,383,392,258,1033,2988
10,401,400,267,1068,2988
11,397,420,270,1087,2988
1,500,200,50,750,2989
2,464,229,88,781,2989
3,431,263,140,834,2989
4,421,283,168,872,2989
5,407,298,191,896,2989
6,393,347,198,938,2989
7,416,351,233,1000,2989
8,396,368,236,1000,2989
9,389,390,250,1029,2989
10,380,408,261,1049,2989
11,379,417,263,1059,2989
1,500,200,50,750,2990
2,461,231,110,802,2990
3,426,272,133,831,2990
4,416,276,184,876,2990
5,420,301,195,916,2990
6,431,340,204,975,2990
7,412,361,205,978,2990
8,435,370,213,1018,2990
9,419,362,250,1031,2990
10,417,391,251,1059,2990
11,404,408,269,1081,2990
1,500,200,50,750,2991
2,478,215,99,792,2991
3,450,240,127,817,2991
4,427,271,169,867,2991
5,407,309,193,909,2991
6,409,334,224,967,2991
7,422,334,236,992,2991
8,406,346,248,1000,2991
9,403,355,270,1028,2991
10,392,371,290,1053,2991
11,404,401,279,1084,2991
1,500,200,50,750,2992
2,466,236,88,790,2992
3,427,264,133,824,2992
4,412,301,157,870,2992
5,388,333,183,904,2992
6,412,337,221,970,2992
7,404,360,208,972,2992
8,405,369,227,1001,2992
9,389,383,245,1017,2992
10,392,381,257,1030,2992
11,399,401,280,1080,2992
1,500,200,50,750,2993
2,459,238,100,797,2993
3,419,282,141,842,2993
4,395,285,174,854,2993
5,391,318,191,900,2993
6,401,344,221,966,2993
7,368,356,254,978,2993
8,361,360,258,979,2993
9,376,387,260,1023,2993
10,386,401,267,1054,2993
11,394,403,297,1094,2993
1,500,200,50,750,2994
2,457,243,98,798,2994
3,405,266,146,817,2994
4,403,298,175,876,2994
5,398,306,207,911,2994
6,389,337,220,946,2994
7,380,361,249,990,2994
8,374,357,267,998,2994
9,386,376,256,1018,2994
10,378,386,283,1047,2994
11,381,379,308,1068,2994
1,500,200,50,750,2995
2,441,246,93,780,2995
3,419,275,132,826,2995
4,415,289,164,868,2995
5,418,306,188,912,2995
6,430,304,207,941,2995
7,407,345,225,977,2995
8,396,361,238,995,2995
9,390,391,232,1013,2995
10,407,412,239,1058,2995
11,396,417,247,1060,2995
1,500,200,50,750,2996
2,460,232,81,773,2996
3,457,253,133,843,2996
4,406,300,161,867,2996
5,398,304,203,905,2996
6,397,342,214,953,2996
7,406,353,227,986,2996
8,412,348,257,1017,2996
9,411,358,260,1029,2996
10,415,387,256,1058,2996
11,422,384,285,1091,2996
1,500,200,50,750,2997
2,463,246,86,795,2997
3,430,256,131,817,2997
4,415,286,161,862,2997
5,418,302,183,903,2997
6,415,321,217,953,2997
7,422,335,214,971,2997
8,404,383,220,1007,2997
9,397,396,233,1026,2997
10,404,404,262,1070,2997
11,403,414,277,1094,2997
1,500,200,50,750,2998
2,458,237,101,796,2998
3,412,263,140,815,2998
4,414,297,157,868,2998
5,398,314,202,914,2998
6,417,335,211,963,2998
7,376,370,231,977,2998
8,375,365,256,996,2998
9,412,379,273,1064,2998
10,399,389,259,1047,2998
11,399,414,280,1093,2998
1,500,200,50,750,2999
2,469,217,109,795,2999
3,441,246,141,828,2999
4,427,279,165,871,2999
5,410,303,189,902,2999
6,417,337,192,946,2999
7,405,354,218,977,2999
8,395,378,237,1010,2999
9,373,388,260,1021,2999
10,388,409,270,1067,2999
11,381,428,277,1086,2999
1,500,200,50,750,3000
2,449,234,99,782,3000
3,422,262,150,834,3000
4,402,290,174,866,3000
5,389,320,198,907,3000
6,398,347,213,958,3000
7,388,369,236,993,3000
8,373,391,244,1008,3000
9,374,393,257,1024,3000
10,368,414,263,1045,3000
11,369,442,265,1076,3000
1,500,200,50,750,3001
2,472,223,100,795,3001
3,420,261,137,818,3001
4,414,296,155,865,3001
5,434,323,152,909,3001
6,422,355,170,947,3001
7,400,380,207,987,3001
8,388,403,218,1009,3001
9,392,404,244,1040,3001
10,372,427,258,1057,3001
11,375,428,274,1077,3001
1,500,200,50,750,3002
2,471,230,87,788,3002
3,447,264,125,836,3002
4,408,283,170,861,3002
5,392,331,194,917,3002
6,389,370,195,954,3002
7,390,350,234,974,3002
8,405,362,240,1007,3002
9,390,391,254,1035,3002
10,378,406,262,1046,3002
11,381,404,279,1064,3002
1,500,200,50,750,3003
2,475,225,100,800,3003
3,443,256,137,836,3003
4,418,276,176,870,3003
5,407,321,202,930,3003
6,378,344,215,937,3003
7,401,372,215,988,3003
8,387,374,221,982,3003
9,416,406,239,1061,3003
10,389,405,247,1041,3003
11,396,438,250,1084,3003
1,500,200,50,750,3004
2,459,213,103,775,3004
3,438,253,140,831,3004
4,420,285,165,870,3004
5,422,313,179,914,3004
6,422,345,191,958,3004
7,410,350,227,987,3004
8,413,356,237,1006,3004
9,406,382,240,1028,3004
10,407,392,255,1054,3004
11,394,415,256,1065,3004
1,500,200,50,750,3005
2,445,233,115,793,3005
3,432,258,142,832,3005
4,424,284,160,868,3005
5,411,317,186,914,3005
6,416,336,210,962,3005
7,392,339,242,973,3005
8,382,361,257,1000,3005
9,395,378,264,1037,3005
10,402,388,266,1056,3005
11,411,399,269,1079,3005
1,500,200,50,750,3006
2,463,241,99,803,3006
3,417,263,137,817,3006
4,388,286,183,857,3006
5,400,291,203,894,3006
6,422,318,224,964,3006
7,408,325,239,972,3006
8,412,367,248,1027,3006
9,397,372,260,1029,3006
10,380,424,254,1058,3006
11,386,428,271,1085,3006
1,500,200,50,750,3007
2,457,237,104,798,3007
3,433,263,137,833,3007
4,416,292,170,878,3007
5,360,336,200,896,3007
6,370,358,211,939,3007
7,391,368,223,982,3007
8,377,377,247,1001,3007
9,387,371,281,1039,3007
10,375,405,272,1052,3007
11,378,433,284,1095,3007
1,500,200,50,750,3008
2,457,236,89,782,3008
3,451,261,133,845,3008
4,421,294,158,873,3008
5,407,326,174,907,3008
6,411,319,208,938,3008
7,420,345,205,970,3008
8,432,363,233,1028,3008
9,414,370,232,1016,3008
10,417,383,240,1040,3008
11,428,423,255,1106,3008
1,500,200,50,750,3009
2,467,234,101,802,3009
3,445,263,130,838,3009
4,432,270,165,867,3009
5,419,305,177,901,3009
6,410,331,205,946,3009
7,409,344,242,995,3009
8,393,365,235,993,3009
9,385,388,261,1034,3009
10,380,405,273,1058,3009
11,394,397,288,1079,3009
1,500,200,50,750,3010
2,445,223,106,774,3010
3,439,266,121,826,3010
4,417,290,149,856,3010
5,401,315,196,912,3010
6,402,329,224,955,3010
7,382,356,228,966,3010
8,368,370,248,986,3010
9,416,383,240,1039,3010
10,399,401,264,1064,3010
11,405,421,258,1084,3010
1,500,200,50,750,3011
2,463,242,90,795,3011
3,440,258,131,829,3011
4,434,278,158,870,3011
5,420,310,183,913,3011
6,397,344,209,950,3011
7,392,353,237,982,3011
8,367,367,265,999,3011
9,377,377,267,1021,3011
10,382,405,278,1065,3011
11,381,419,278,1078,3011
1,500,200,50,750,3012
2,447,232,102,781,3012
3,432,244,141,817,3012
4,422,280,163,865,3012
5,414,309,184,907,3012
6,409,329,224,962,3012
7,395,358,229,982,3012
8,393,351,246,990,3012
9,377,395,241,1013,3012
10,386,414,263,1063,3012
11,391,414,273,1078,3012
1,500,200,50,750,3013
2,454,235,103,792,3013
3,426,257,150,833,3013
4,407,279,171,857,3013
5,403,305,193,901,3013
6,420,325,215,960,3013
7,395,362,223,980,3013
8,402,401,218,1021,3013
9,374,424,235,1033,3013
10,395,399,248,1042,3013
11,427,417,253,1097,3013
1,500,200,50,750,3014
2,464,227,96,787,3014
3,412,264,149,825,3014
4,415,282,170,867,3014
5,414,311,184,909,3014
6,425,344,204,973,3014
7,398,364,219,981,3014
8,394,376,228,998,3014
9,423,361,242,1026,3014
10,428,373,256,1057,3014
11,400,405,267,1072,3014
1,500,200,50,750,3015
2,454,242,91,787,3015
3,423,280,124,827,3015
4,412,308,157,877,3015
5,405,330,172,907,3015
6,399,341,214,954,3015
7,420,339,221,980,3015
8,389,370,250,1009,3015
9,423,379,245,1047,3015
10,424,362,264,1050,3015
11,426,385,265,1076,3015
1,500,200,50,750,3016
2,465,234,102,801,3016
3,421,267,132,820,3016
4,395,311,157,863,3016
5,397,311,208,916,3016
6,386,381,181,948,3016
7,381,391,217,989,3016
8,379,389,230,998,3016
9,370,393,259,1022,3016
10,388,410,272,1070,3016
11,392,403,302,1097,3016
1,500,200,50,750,3017
2,472,212,103,787,3017
3,434,255,133,822,3017
4,411,280,170,861,3017
5,420,311,193,924,3017
6,410,328,207,945,3017
7,414,339,216,969,3017
8,407,356,223,986,3017
9,432,370,246,1048,3017
10,422,380,258,1060,3017
11,414,402,254,1070,3017
1,500,200,50,750,3018
2,461,229,98,788,3018
3,454,251,130,835,3018
4,454,264,151,869,3018
5,425,299,191,915,3018
6,416,325,215,956,3018
7,393,356,235,984,3018
8,380,391,233,1004,3018
9,380,389,253,1022,3018
10,390,400,267,1057,3018
11,396,409,275,1080,3018
1,500,200,50,750,3019
2,453,228,97,778,3019
3,436,267,120,823,3019
4,415,283,151,849,3019
5,415,331,169,915,3019
6,402,344,203,949,3019
7,401,369,208,978,3019
8,413,371,223,1007,3019
9,428,370,236,1034,3019
10,404,394,243,1041,3019
11,439,411,248,1098,3019
1,500,200,50,750,3020
2,452,243,100,795,3020
3,438,265,139,842,3020
4,415,294,168,877,3020
5,403,320,184,907,3020
6,404,342,199,945,3020
7,426,359,221,1006,3020
8,399,381,225,1005,3020
9,400,391,237,1028,3020
10,405,402,253,1060,3020
11,411,408,255,1074,3020
1,500,200,50,750,3021
2,443,231,109,783,3021
3,408,249,154,811,3021
4,407,267,191,865,3021
5,400,317,210,927,3021
6,403,347,214,964,3021
7,388,352,228,968,3021
8,376,378,232,986,3021
9,400,395,247,1042,3021
10,392,385,261,1038,3021
11,399,383,276,1058,3021
1,500,200,50,750,3022
2,457,239,92,788,3022
3,430,273,131,834,3022
4,401,284,186,871,3022
5,392,304,207,903,3022
6,407,342,199,948,3022
7,405,354,216,975,3022
8,420,359,235,1014,3022
9,406,388,236,1030,3022
10,393,391,264,1048,3022
11,415,400,286,1101,3022
1,500,200,50,750,3023
2,446,214,118,778,3023
3,435,244,158,837,3023
4,419,273,181,873,3023
5,406,294,197,897,3023
6,397,341,209,947,3023
7,403,355,211,969,3023
8,395,374,236,1005,3023
9,378,377,257,1012,3023
10,412,380,275,1067,3023
11,377,393,303,1073,3023
1,500,200,50,750,3024
2,475,214,108,797,3024
3,436,253,148,837,3024
4,394,278,184,856,3024
5,390,310,214,914,3024
6,386,315,243,944,3024
7,395,347,233,975,3024
8,406,379,226,1011,3024
9,397,392,244,1033,3024
10,406,393,267,1066,3024
11,412,392,285,1089,3024
1,500,200,50,750,3025
2,451,239,94,784,3025
3,414,278,127,819,3025
4,398,301,175,874,3025
5,390,321,195,906,3025
6,389,368,208,965,3025
7,381,363,231,975,3025
8,376,361,256,993,3025
9,383,379,262,1024,3025
10,386,405,276,1067,3025
11,372,418,282,1072,3025
1,500,200,50,750,3026
2,465,228,86,779,3026
3,431,253,126,810,3026
4,443,273,157,873,3026
5,434,303,190,927,3026
6,426,319,207,952,3026
7,423,321,236,980,3026
8,408,347,241,996,3026
9,397,352,262,1011,3026
10,413,362,269,1044,3026
11,417,403,256,1076,3026
1,500,200,50,750,3027
2,436,240,109,785,3027
3,436,241,153,830,3027
4,432,269,170,871,3027
5,416,294,197,907,3027
6,427,314,221,962,3027
7,408,331,240,979,3027
8,403,365,247,1015,3027
9,409,342,277,1028,3027
10,417,374,280,1071,3027
11,428,375,275,1078,3027
1,500,200,50,750,3028
2,460,249,95,804,3028
3,430,255,147,832,3028
4,408,297,172,877,3028
5,409,305,203,917,3028
6,382,356,221,959,3028
7,384,374,221,979,3028
8,379,418,204,1001,3028
9,399,417,228,1044,3028
10,414,414,250,1078,3028
11,389,439,265,1093,3028
1,500,200,50,750,3029
2,456,231,97,784,3029
3,430,256,153,839,3029
4,418,298,161,877,3029
5,391,327,174,892,3029
6,426,349,191,966,3029
7,400,363,226,989,3029
8,406,380,236,1022,3029
9,396,397,245,1038,3029
10,399,402,261,1062,3029
11,392,412,271,1075,3029
1,500,200,50,750,3030
2,457,241,88,786,3030
3,416,248,152,816,3030
4,430,275,175,880,3030
5,409,301,193,903,3030
6,423,338,202,963,3030
7,397,347,239,983,3030
8,395,376,238,1009,3030
9,389,382,247,1018,3030
10,398,405,263,1066,3030
11,389,443,253,1085,3030
1,500,200,50,750,3031
2,461,234,100,795,3031
3,400,275,137,812,3031
4,395,313,164,872,3031
5,392,333,178,903,3031
6,408,345,212,965,3031
7,387,359,238,984,3031
8,384,370,264,1018,3031
9,372,390,276,1038,3031
10,387,392,284,1063,3031
11,389,413,277,1079,3031
1,500,200,50,750,3032
2,471,240,85,796,3032
3,432,259,130,821,3032
4,395,291,179,865,3032
5,403,321,202,926,3032
6,410,322,238,970,3032
7,419,323,242,984,3032
8,402,336,256,994,3032
9,398,362,273,1033,3032
10,400,391,271,1062,3032
11,391,399,290,1080,3032
1,500,200,50,750,3033
2,454,230,101,785,3033
3,417,267,123,807,3033
4,418,282,158,858,3033
5,415,308,174,897,3033
6,432,339,204,975,3033
7,395,356,225,976,3033
8,403,391,220,1014,3033
9,410,387,236,1033,3033
10,410,414,243,1067,3033
11,390,428,268,1086,3033
1,500,200,50,750,3034
2,451,240,104,795,3034
3,443,258,128,829,3034
4,432,274,160,866,3034
5,426,293,190,909,3034
6,444,321,203,968,3034
7,408,346,227,981,3034
8,405,354,253,1012,3034
9,412,364,258,1034,3034
10,396,390,267,1053,3034
11,405,390,269,1064,3034
1,500,200,50,750,3035
2,454,233,109,796,3035
3,410,264,155,829,3035
4,407,286,180,873,3035
5,403,320,193,916,3035
6,421,326,212,959,3035
7,408,364,211,983,3035
8,407,372,231,1010,3035
9,401,375,266,1042,3035
10,395,379,264,1038,3035
11,409,424,261,1094,3035
1,500,200,50,750,3036
2,459,214,114,787,3036
3,438,241,151,830,3036
4,428,284,160,872,3036
5,406,308,192,906,3036
6,401,334,202,937,3036
7,411,347,237,995,3036
8,411,357,242,1010,3036
9,390,379,260,1029,3036
10,389,391,277,1057,3036
11,395,431,267,1093,3036
1,500,200,50,750,3037
2,460,215,112,787,3037
3,428,263,137,828,3037
4,414,295,142,851,3037
5,406,329,162,897,3037
6,389,354,212,955,3037
7,398,357,229,984,3037
8,394,381,240,1015,3037
9,399,401,232,1032,3037
10,389,403,257,1049,3037
11,427,394,262,1083,3037
1,500,200,50,750,3038
2,449,218,101,768,3038
3,438,269,118,825,3038
4,440,293,144,877,3038
5,428,326,167,921,3038
6,417,344,196,957,3038
7,406,371,221,998,3038
8,391,376,244,1011,3038
9,398,366,265,1029,3038
10,403,378,276,1057,3038
11,411,407,279,1097,3038
1,500,200,50,750,3039
2,464,234,94,792,3039
3,435,271,125,831,3039
4,412,303,153,868,3039
5,421,313,180,914,3039
6,407,331,213,951,3039
7,373,375,231,979,3039
8,401,371,249,1021,3039
9,367,389,272,1028,3039
10,383,423,272,1078,3039
11,386,429,265,1080,3039
1,500,200,50,750,3040
2,471,220,95,786,3040
3,440,240,143,823,3040
4,436,290,160,886,3040
5,410,315,192,917,3040
6,405,339,222,966,3040
7,398,355,221,974,3040
8,384,381,230,995,3040
9,405,388,246,1039,3040
10,408,400,252,1060,3040
11,413,393,270,1076,3040
1,500,200,50,750,3041
2,480,218,93,791,3041
3,459,254,117,830,3041
4,442,273,144,859,3041
5,419,283,174,876,3041
6,418,325,201,944,3041
7,423,335,224,982,3041
8,402,348,245,995,3041
9,401,374,247,1022,3041
10,405,383,265,1053,3041
11,429,381,282,1092,3041
1,500,200,50,750,3042
2,464,211,111,786,3042
3,429,247,143,819,3042
4,408,292,157,857,3042
5,418,313,185,916,3042
6,416,331,213,960,3042
7,402,343,245,990,3042
8,395,374,239,1008,3042
9,374,377,279,1030,3042
10,388,386,278,1052,3042
11,383,407,283,1073,3042
1,500,200,50,750,3043
2,447,243,96,786,3043
3,418,279,134,831,3043
4,376,324,172,872,3043
5,373,326,204,903,3043
6,374,364,216,954,3043
7,383,352,227,962,3043
8,397,340,253,990,3043
9,412,370,259,1041,3043
10,411,374,273,1058,3043
11,396,388,281,1065,3043
1,500,200,50,750,3044
2,457,235,99,791,3044
3,411,268,138,817,3044
4,399,267,167,833,3044
5,409,291,203,903,3044
6,414,329,207,950,3044
7,414,343,237,994,3044
8,393,358,251,1002,3044
9,365,386,261,1012,3044
10,387,398,281,1066,3044
11,396,418,266,1080,3044
1,500,200,50,750,3045
2,460,220,93,773,3045
3,443,262,120,825,3045
4,412,287,166,865,3045
5,411,339,168,918,3045
6,401,362,198,961,3045
7,399,356,220,975,3045
8,388,403,231,1022,3045
9,378,398,270,1046,3045
10,375,388,300,1063,3045
11,376,422,283,1081,3045
1,500,200,50,750,3046
2,476,221,92,789,3046
3,435,243,146,824,3046
4,427,282,159,868,3046
5,425,320,175,920,3046
6,424,317,211,952,3046
7,421,342,214,977,3046
8,408,354,241,1003,3046
9,407,355,272,1034,3046
10,379,369,283,1031,3046
11,408,389,285,1082,3046
1,500,200,50,750,3047
2,457,246,90,793,3047
3,418,259,136,813,3047
4,423,295,160,878,3047
5,405,320,167,892,3047
6,445,337,193,975,3047
7,403,362,207,972,3047
8,404,374,231,1009,3047
9,393,391,263,1047,3047
10,408,394,266,1068,3047
11,400,430,252,1082,3047
1,500,200,50,750,3048
2,453,245,93,791,3048
3,432,273,131,836,3048
4,401,302,159,862,3048
5,406,324,179,909,3048
6,402,341,201,944,3048
7,408,365,213,986,3048
8,406,363,241,1010,3048
9,392,396,240,1028,3048
10,381,404,270,1055,3048
11,378,421,282,1081,3048
1,500,200,50,750,3049
2,485,207,103,795,3049
3,453,235,134,822,3049
4,428,283,150,861,3049
5,431,314,181,926,3049
6,424,326,204,954,3049
7,401,378,214,993,3049
8,398,379,219,996,3049
9,398,388,250,1036,3049
10,385,405,247,1037,3049
11,393,413,279,1085,3049
1,500,200,50,750,3050
2,458,230,108,796,3050
3,420,261,153,834,3050
4,419,276,167,862,3050
5,403,314,205,922,3050
6,417,326,208,951,3050
7,420,359,215,994,3050
8,402,364,239,1005,3050
9,395,385,241,1021,3050
10,431,385,254,1070,3050
11,411,419,249,1079,3050
1,500,200,50,750,3051
2,462,236,75,773,3051
3,435,277,120,832,3051
4,416,308,151,875,3051
5,414,314,187,915,3051
6,412,321,224,957,3051
7,412,328,241,981,3051
8,397,350,252,999,3051
9,392,380,260,1032,3051
10,427,397,253,1077,3051
11,423,405,265,1093,3051
1,500,200,50,750,3052
2,476,218,106,800,3052
3,458,246,129,833,3052
4,450,275,155,880,3052
5,439,287,178,904,3052
6,443,319,205,967,3052
7,431,327,221,979,3052
8,413,349,241,1003,3052
9,427,376,264,1067,3052
10,404,395,263,1062,3052
11,409,397,279,1085,3052
1,500,200,50,750,3053
2,466,215,99,780,3053
3,451,222,145,818,3053
4,464,249,166,879,3053
5,428,293,193,914,3053
6,424,314,227,965,3053
7,391,353,228,972,3053
8,375,365,247,987,3053
9,398,378,270,1046,3053
10,385,399,261,1045,3053
11,421,405,266,1092,3053
1,500,200,50,750,3054
2,451,238,105,794,3054
3,412,267,141,820,3054
4,412,282,179,873,3054
5,410,316,181,907,3054
6,419,343,207,969,3054
7,426,347,210,983,3054
8,422,366,229,1017,3054
9,418,363,243,1024,3054
10,422,385,248,1055,3054
11,428,411,252,1091,3054
1,500,200,50,750,3055
2,473,214,104,791,3055
3,450,238,140,828,3055
4,412,295,157,864,3055
5,414,311,167,892,3055
6,418,336,205,959,3055
7,411,366,215,992,3055
8,389,364,251,1004,3055
9,403,382,244,1029,3055
10,405,397,244,1046,3055
11,435,392,262,1089,3055
1,500,200,50,750,3056
2,467,242,84,793,3056
3,428,269,124,821,3056
4,421,272,166,859,3056
5,412,320,188,920,3056
6,415,337,214,966,3056
7,435,334,224,993,3056
8,414,366,228,1008,3056
9,398,395,239,1032,3056
10,375,426,252,1053,3056
11,367,443,269,1079,3056
1,500,200,50,750,3057
2,457,226,103,786,3057
3,422,266,132,820,3057
4,411,285,170,866,3057
5,402,324,192,918,3057
6,385,356,211,952,3057
7,391,367,230,988,3057
8,394,386,232,1012,3057
9,411,375,240,1026,3057
10,416,377,258,1051,3057
11,433,391,264,1088,3057
1,500,200,50,750,3058
2,446,238,96,780,3058
3,431,253,129,813,3058
4,431,269,172,872,3058
5,420,314,185,919,3058
6,399,346,199,944,3058
7,400,353,235,988,3058
8,395,367,245,1007,3058
9,380,379,269,1028,3058
10,408,395,259,1062,3058
11,396,425,263,1084,3058
1,500,200,50,750,3059
2,456,240,100,796,3059
3,407,281,121,809,3059
4,405,305,157,867,3059
5,395,320,197,912,3059
6,389,356,222,967,3059
7,383,382,216,981,3059
8,391,394,231,1016,3059
9,398,382,246,1026,3059
10,414,382,264,1060,3059
11,397,392,287,1076,3059
1,500,200,50,750,3060
2,447,229,103,779,3060
3,417,274,135,826,3060
4,413,303,157,873,3060
5,397,322,195,914,3060
6,403,331,222,956,3060
7,394,336,247,977,3060
8,392,365,245,1002,3060
9,390,399,260,1049,3060
10,377,402,268,1047,3060
11,397,429,268,1094,3060
1,500,200,50,750,3061
2,449,240,99,788,3061
3,428,273,136,837,3061
4,415,285,156,856,3061
5,419,331,176,926,3061
6,414,321,220,955,3061
7,400,360,233,993,3061
8,399,360,250,1009,3061
9,402,368,262,1032,3061
10,399,385,280,1064,3061
11,405,383,291,1079,3061
1,500,200,50,750,3062
2,462,226,105,793,3062
3,437,255,125,817,3062
4,431,286,153,870,3062
5,405,313,183,901,3062
6,389,335,210,934,3062
7,405,361,207,973,3062
8,384,377,225,986,3062
9,382,391,237,1010,3062
10,390,419,256,1065,3062
11,396,415,273,1084,3062
1,500,200,50,750,3063
2,445,245,93,783,3063
3,433,263,135,831,3063
4,403,284,178,865,3063
5,403,313,198,914,3063
6,412,319,230,961,3063
7,404,333,244,981,3063
8,395,336,277,1008,3063
9,404,346,273,1023,3063
10,398,353,294,1045,3063
11,428,388,282,1098,3063
1,500,200,50,750,3064
2,453,227,101,781,3064
3,429,240,154,823,3064
4,410,287,161,858,3064
5,402,308,188,898,3064
6,413,344,198,955,3064
7,380,370,229,979,3064
8,417,357,239,1013,3064
9,396,388,253,1037,3064
10,393,400,271,1064,3064
11,411,399,270,1080,3064
1,500,200,50,750,3065
2,451,248,92,791,3065
3,403,279,131,813,3065
4,396,318,160,874,3065
5,372,342,192,906,3065
6,383,351,214,948,3065
7,380,361,240,981,3065
8,368,379,256,1003,3065
9,374,380,284,1038,3065
10,370,406,272,1048,3065
11,400,409,270,1079,3065
1,500,200,50,750,3066
2,482,213,96,791,3066
3,443,260,129,832,3066
4,420,293,173,886,3066
5,389,329,201,919,3066
6,389,357,209,955,3066
7,367,362,252,981,3066
8,355,370,280,1005,3066
9,368,387,288,1043,3066
10,383,395,287,1065,3066
11,378,422,283,1083,3066
1,500,200,50,750,3067
2,463,227,101,791,3067
3,426,243,151,820,3067
4,408,277,177,862,3067
5,421,306,194,921,3067
6,421,328,215,964,3067
7,425,339,229,993,3067
8,410,363,249,1022,3067
9,416,373,249,1038,3067
10,404,380,258,1042,3067
11,407,385,277,1069,3067
1,500,200,50,750,3068
2,454,222,105,781,3068
3,431,256,144,831,3068
4,415,296,164,875,3068
5,421,311,197,929,3068
6,421,342,199,962,3068
7,394,359,219,972,3068
8,391,390,226,1007,3068
9,381,402,247,1030,3068
10,401,414,252,1067,3068
11,402,425,258,1085,3068
1,500,200,50,750,3069
2,457,222,96,775,3069
3,426,262,138,826,3069
4,422,305,155,882,3069
5,409,331,188,928,3069
6,394,343,216,953,3069
7,377,368,235,980,3069
8,379,372,257,1008,3069
9,389,399,255,1043,3069
10,383,392,275,1050,3069
11,384,385,288,1057,3069
1,500,200,50,750,3070
2,459,223,98,780,3070
3,435,256,127,818,3070
4,430,276,175,881,3070
5,411,312,188,911,3070
6,411,355,195,961,3070
7,398,373,217,988,3070
8,403,393,227,1023,3070
9,395,383,244,1022,3070
10,409,420,245,1074,3070
11,390,420,274,1084,3070
1,500,200,50,750,3071
2,467,236,88,791,3071
3,442,250,131,823,3071
4,417,293,158,868,3071
5,414,312,184,910,3071
6,404,339,217,960,3071
7,404,344,235,983,3071
8,382,373,249,1004,3071
9,384,398,249,1031,3071
10,412,389,255,1056,3071
11,422,401,261,1084,3071
1,500,200,50,750,3072
2,440,234,115,789,3072
3,417,265,158,840,3072
4,397,300,194,891,3072
5,389,307,217,913,3072
6,371,343,230,944,3072
7,385,361,240,986,3072
8,354,384,262,1000,3072
9,375,381,268,1024,3072
10,407,397,261,1065,3072
11,395,416,264,1075,3072
1,500,200,50,750,3073
2,454,225,99,778,3073
3,417,257,146,820,3073
4,412,273,187,872,3073
5,391,294,214,899,3073
6,389,340,232,961,3073
7,369,373,238,980,3073
8,387,372,252,1011,3073
9,377,386,274,1037,3073
10,376,384,284,1044,3073
11,380,395,288,1063,3073
1,500,200,50,750,3074
2,460,231,98,789,3074
3,419,265,132,816,3074
4,419,294,159,872,3074
5,389,326,181,896,3074
6,382,364,214,960,3074
7,378,358,235,971,3074
8,383,364,255,1002,3074
9,375,390,260,1025,3074
10,405,394,278,1077,3074
11,380,404,300,1084,3074
1,500,200,50,750,3075
2,483,223,86,792,3075
3,452,257,117,826,3075
4,417,303,148,868,3075
5,403,317,162,882,3075
6,418,341,187,946,3075
7,433,354,194,981,3075
8,423,376,207,1006,3075
9,422,365,243,1030,3075
10,417,385,265,1067,3075
11,402,391,268,1061,3075
1,500,200,50,750,3076
2,489,212,95,796,3076
3,455,258,127,840,3076
4,433,276,165,874,3076
5,417,305,200,922,3076
6,399,343,217,959,3076
7,410,356,233,999,3076
8,399,371,231,1001,3076
9,389,381,248,1018,3076
10,404,414,261,1079,3076
11,394,426,265,1085,3076
1,500,200,50,750,3077
2,458,232,94,784,3077
3,440,260,135,835,3077
4,435,274,157,866,3077
5,426,297,172,895,3077
6,426,328,198,952,3077
7,424,346,213,983,3077
8,428,350,221,999,3077
9,431,357,232,1020,3077
10,433,376,249,1058,3077
11,422,378,278,1078,3077
1,500,200,50,750,3078
2,477,208,105,790,3078
3,430,273,137,840,3078
4,410,317,153,880,3078
5,402,315,205,922,3078
6,419,333,211,963,3078
7,404,358,220,982,3078
8,398,367,252,1017,3078
9,394,384,255,1033,3078
10,397,393,278,1068,3078
11,401,404,288,1093,3078
1,500,200,50,750,3079
2,465,216,106,787,3079
3,463,250,129,842,3079
4,419,295,148,862,3079
5,423,320,170,913,3079
6,408,341,195,944,3079
7,419,347,223,989,3079
8,397,369,237,1003,3079
9,395,396,245,1036,3079
10,416,390,256,1062,3079
11,424,398,259,1081,3079
1,500,200,50,750,3080
2,459,240,87,786,3080
3,426,263,134,823,3080
4,416,280,164,860,3080
5,411,302,188,901,3080
6,407,327,207,941,3080
7,400,361,213,974,3080
8,406,376,239,1021,3080
9,405,367,261,1033,3080
10,421,413,244,1078,3080
11,428,409,251,1088,3080
1,500,200,50,750,3081
2,465,205,105,775,3081
3,436,259,137,832,3081
4,416,293,156,865,3081
5,420,318,188,926,3081
6,415,339,203,957,3081
7,386,351,231,968,3081
8,369,369,247,985,3081
9,377,387,262,1026,3081
10,406,385,267,1058,3081
11,424,388,274,1086,3081
1,500,200,50,750,3082
2,467,231,94,792,3082
3,457,236,134,827,3082
4,431,272,161,864,3082
5,406,308,184,898,3082
6,408,355,191,954,3082
7,402,358,215,975,3082
8,389,377,250,1016,3082
9,386,402,248,1036,3082
10,368,410,271,1049,3082
11,385,398,290,1073,3082
1,500,200,50,750,3083
2,453,221,103,777,3083
3,443,249,125,817,3083
4,445,275,160,880,3083
5,420,298,186,904,3083
6,421,321,214,956,3083
7,402,351,229,982,3083
8,406,360,239,1005,3083
9,425,354,262,1041,3083
10,421,369,264,1054,3083
11,419,379,282,1080,3083
1,500,200,50,750,3084
2,467,211,100,778,3084
3,432,273,125,830,3084
4,399,294,157,850,3084
5,399,321,189,909,3084
6,401,362,211,974,3084
7,400,361,225,986,3084
8,408,368,240,1016,3084
9,397,378,255,1030,3084
10,384,409,270,1063,3084
11,397,417,275,1089,3084
1,500,200,50,750,3085
2,475,230,97,802,3085
3,433,276,130,839,3085
4,408,292,163,863,3085
5,380,326,192,898,3085
6,387,341,227,955,3085
7,386,337,249,972,3085
8,394,333,278,1005,3085
9,394,374,277,1045,3085
10,385,394,282,1061,3085
11,376,392,295,1063,3085
1,500,200,50,750,3086
2,444,243,108,795,3086
3,420,268,132,820,3086
4,402,311,162,875,3086
5,383,324,202,909,3086
6,398,343,222,963,3086
7,395,360,247,1002,3086
8,362,384,249,995,3086
9,373,392,262,1027,3086
10,367,402,266,1035,3086
11,381,414,289,1084,3086
1,500,200,50,750,3087
2,449,231,104,784,3087
3,432,266,138,836,3087
4,421,289,171,881,3087
5,387,311,195,893,3087
6,392,329,228,949,3087
7,375,376,224,975,3087
8,383,388,243,1014,3087
9,358,405,247,1010,3087
10,382,419,269,1070,3087
11,398,419,285,1102,3087
1,500,200,50,750,3088
2,454,226,103,783,3088
3,420,257,136,813,3088
4,428,281,168,877,3088
5,405,309,196,910,3088
6,395,349,208,952,3088
7,384,364,235,983,3088
8,380,378,251,1009,3088
9,356,383,279,1018,3088
10,374,403,285,1062,3088
11,399,408,271,1078,3088
1,500,200,50,750,3089
2,459,236,93,788,3089
3,442,267,123,832,3089
4,418,306,145,869,3089
5,419,318,176,913,3089
6,397,358,208,963,3089
7,380,369,226,975,3089
8,371,393,228,992,3089
9,386,361,271,1018,3089
10,394,394,262,1050,3089
11,427,391,279,1097,3089
1,500,200,50,750,3090
2,455,237,93,785,3090
3,428,287,124,839,3090
4,418,309,145,872,3090
5,410,316,167,893,3090
6,434,351,180,965,3090
7,413,381,193,987,3090
8,390,401,210,1001,3090
9,365,393,245,1003,3090
10,372,403,282,1057,3090
11,395,419,268,1082,3090
1,500,200,50,750,3091
2,454,241,96,791,3091
3,423,265,131,819,3091
4,428,282,155,865,3091
5,410,328,170,908,3091
6,393,339,209,941,3091
7,373,359,252,984,3091
8,387,372,248,1007,3091
9,401,377,261,1039,3091
10,400,387,277,1064,3091
11,381,398,301,1080,3091
1,500,200,50,750,3092
2,477,227,95,799,3092
3,450,252,121,823,3092
4,436,275,155,866,3092
5,399,311,180,890,3092
6,402,344,218,964,3092
7,394,367,213,974,3092
8,399,387,226,1012,3092
9,420,386,247,1053,3092
10,407,414,249,1070,3092
11,400,404,286,1090,3092
1,500,200,50,750,3093
2,454,223,106,783,3093
3,431,270,131,832,3093
4,428,272,176,876,3093
5,426,287,183,896,3093
6,408,328,205,941,3093
7,404,363,217,984,3093
8,365,379,259,1003,3093
9,369,368,291,1028,3093
10,370,385,289,1044,3093
11,384,395,306,1085,3093
1,500,200,50,750,3094
2,454,230,97,781,3094
3,438,250,148,836,3094
4,416,280,174,870,3094
5,390,312,189,891,3094
6,420,327,205,952,3094
7,417,328,231,976,3094
8,429,357,234,1020,3094
9,406,379,249,1034,3094
10,399,380,269,1048,3094
11,397,394,288,1079,3094
1,500,200,50,750,3095
2,454,244,97,795,3095
3,416,273,134,823,3095
4,394,303,163,860,3095
5,396,319,183,898,3095
6,416,326,239,981,3095
7,400,322,254,976,3095
8,398,355,268,1021,3095
9,390,381,249,1020,3095
10,385,365,283,1033,3095
11,397,402,289,1088,3095
1,500,200,50,750,3096
2,468,231,98,797,3096
3,438,272,132,842,3096
4,408,287,187,882,3096
5,390,343,187,920,3096
6,410,342,209,961,3096
7,416,352,219,987,3096
8,434,362,216,1012,3096
9,414,380,235,1029,3096
10,419,408,253,1080,3096
11,394,404,266,1064,3096
1,500,200,50,750,3097
2,473,238,77,788,3097
3,442,253,134,829,3097
4,425,300,160,885,3097
5,414,328,177,919,3097
6,403,329,226,958,3097
7,383,347,250,980,3097
8,379,362,283,1024,3097
9,361,369,292,1022,3097
10,371,381,305,1057,3097
11,368,403,309,1080,3097
1,500,200,50,750,3098
2,467,220,100,787,3098
3,426,270,139,835,3098
4,389,303,173,865,3098
5,400,335,185,920,3098
6,405,361,199,965,3098
7,383,380,211,974,3098
8,384,388,228,1000,3098
9,369,412,248,1029,3098
10,371,425,250,1046,3098
11,416,418,254,1088,3098
1,500,200,50,750,3099
2,458,237,86,781,3099
3,425,290,113,828,3099
4,425,304,146,875,3099
5,423,319,176,918,3099
6,418,337,195,950,3099
7,395,370,215,980,3099
8,377,384,232,993,3099
9,400,393,252,1045,3099
10,386,400,265,1051,3099
11,406,404,270,1080,3099
1,500,200,50,750,3100
2,465,241,82,788,3100
3,427,267,142,836,3100
4,390,306,172,868,3100
5,375,331,204,910,3100
6,396,331,234,961,3100
7,377,369,240,986,3100
8,370,396,243,1009,3100
9,384,413,242,1039,3100
10,378,405,257,1040,3100
11,399,404,283,1086,3100
1,500,200,50,750,3101
2,473,210,127,810,3101
3,425,248,148,821,3101
4,425,275,168,868,3101
5,417,298,196,911,3101
6,381,333,227,941,3101
7,390,335,242,967,3101
8,405,356,260,1021,3101
9,406,364,264,1034,3101
10,420,391,253,1064,3101
11,423,409,257,1089,3101
1,500,200,50,750,3102
2,484,221,97,802,3102
3,439,259,127,825,3102
4,394,310,145,849,3102
5,376,348,173,897,3102
6,396,370,191,957,3102
7,397,362,215,974,3102
8,403,378,228,1009,3102
9,433,375,247,1055,3102
10,405,379,256,1040,3102
11,413,410,256,1079,3102
1,500,200,50,750,3103
2,453,244,88,785,3103
3,431,276,127,834,3103
4,400,291,167,858,3103
5,394,325,190,909,3103
6,399,361,188,948,3103
7,398,373,220,991,3103
8,379,393,244,1016,3103
9,373,418,247,1038,3103
10,371,423,256,1050,3103
11,386,436,267,1089,3103
1,500,200,50,750,3104
2,470,215,93,778,3104
3,448,254,121,823,3104
4,426,287,160,873,3104
5,408,306,195,909,3104
6,412,327,216,955,3104
7,415,348,224,987,3104
8,406,361,245,1012,3104
9,429,363,246,1038,3104
10,412,376,267,1055,3104
11,413,407,272,1092,3104
1,500,200,50,750,3105
2,445,219,100,764,3105
3,447,247,132,826,3105
4,439,288,142,869,3105
5,428,316,165,909,3105
6,426,329,206,961,3105
7,434,325,216,975,3105
8,428,339,231,998,3105
9,418,384,231,1033,3105
10,412,398,249,1059,3105
11,429,386,262,1077,3105
1,500,200,50,750,3106
2,445,244,101,790,3106
3,434,237,149,820,3106
4,402,291,172,865,3106
5,402,306,200,908,3106
6,415,345,209,969,3106
7,411,363,213,987,3106
8,410,372,229,1011,3106
9,402,380,253,1035,3106
10,399,381,268,1048,3106
11,402,386,292,1080,3106
1,500,200,50,750,3107
2,451,251,89,791,3107
3,414,261,144,819,3107
4,416,300,162,878,3107
5,395,344,176,915,3107
6,402,360,203,965,3107
7,378,382,218,978,3107
8,371,397,238,1006,3107
9,382,384,264,1030,3107
10,375,421,259,1055,3107
11,391,419,274,1084,3107
1,500,200,50,750,3108
2,436,244,110,790,3108
3,424,274,135,833,3108
4,413,290,154,857,3108
5,409,301,209,919,3108
6,428,316,216,960,3108
7,397,353,220,970,3108
8,434,363,225,1022,3108
9,412,364,256,1032,3108
10,412,380,273,1065,3108
11,401,415,273,1089,3108
1,500,200,50,750,3109
2,450,242,88,780,3109
3,434,280,115,829,3109
4,420,297,170,887,3109
5,388,314,196,898,3109
6,420,340,207,967,3109
7,395,360,229,984,3109
8,390,373,249,1012,3109
9,387,395,239,1021,3109
10,398,394,283,1075,3109
11,396,403,286,1085,3109
1,500,200,50,750,3110
2,446,231,100,777,3110
3,438,257,137,832,3110
4,402,281,168,851,3110
5,417,315,196,928,3110
6,420,330,215,965,3110
7,398,368,210,976,3110
8,393,376,231,1000,3110
9,390,386,252,1028,3110
10,394,408,255,1057,3110
11,400,425,260,1085,3110
1,500,200,50,750,3111
2,444,234,108,786,3111
3,425,258,153,836,3111
4,422,263,180,865,3111
5,420,297,190,907,3111
6,429,301,217,947,3111
7,417,345,236,998,3111
8,397,356,253,1006,3111
9,408,394,237,1039,3111
10,385,434,243,1062,3111
11,387,427,270,1084,3111
1,500,200,50,750,3112
2,454,226,103,783,3112
3,436,263,134,833,3112
4,420,275,167,862,3112
5,411,304,197,912,3112
6,435,343,196,974,3112
7,405,354,220,979,3112
8,410,350,245,1005,3112
9,406,383,242,1031,3112
10,408,397,247,1052,3112
11,418,419,263,1100,3112
1,500,200,50,750,3113
2,442,226,105,773,3113
3,418,258,144,820,3113
4,414,272,188,874,3113
5,397,296,217,910,3113
6,402,339,207,948,3113
7,402,339,246,987,3113
8,403,359,230,992,3113
9,384,394,230,1008,3113
10,380,416,238,1034,3113
11,404,426,261,1091,3113
1,500,200,50,750,3114
2,452,220,108,780,3114
3,437,261,124,822,3114
4,436,288,150,874,3114
5,427,288,191,906,3114
6,422,290,231,943,3114
7,418,317,246,981,3114
8,400,369,231,1000,3114
9,407,390,235,1032,3114
10,424,387,255,1066,3114
11,402,390,288,1080,3114
1,500,200,50,750,3115
2,465,232,92,789,3115
3,433,265,130,828,3115
4,444,265,163,872,3115
5,437,303,189,929,3115
6,422,342,182,946,3115
7,422,366,201,989,3115
8,410,368,221,999,3115
9,402,391,250,1043,3115
10,402,403,252,1057,3115
11,418,394,275,1087,3115
1,500,200,50,750,3116
2,457,227,107,791,3116
3,450,257,128,835,3116
4,424,290,159,873,3116
5,406,326,197,929,3116
6,402,325,228,955,3116
7,403,329,248,980,3116
8,383,359,260,1002,3116
9,375,391,264,1030,3116
10,372,412,274,1058,3116
11,390,410,279,1079,3116
1,500,200,50,750,3117
2,463,224,91,778,3117
3,432,237,139,808,3117
4,433,278,168,879,3117
5,435,290,188,913,3117
6,422,314,214,950,3117
7,417,325,239,981,3117
8,413,341,264,1018,3117
9,416,356,262,1034,3117
10,400,373,273,1046,3117
11,405,415,267,1087,3117
1,500,200,50,750,3118
2,455,240,90,785,3118
3,435,240,150,825,3118
4,415,288,161,864,3118
5,418,313,188,919,3118
6,411,327,219,957,3118
7,397,343,228,968,3118
8,385,376,241,1002,3118
9,403,391,234,1028,3118
10,399,397,282,1078,3118
11,378,408,285,1071,3118
1,500,200,50,750,3119
2,462,218,107,787,3119
3,446,255,146,847,3119
4,421,262,188,871,3119
5,429,284,205,918,3119
6,410,311,225,946,3119
7,401,337,247,985,3119
8,392,379,242,1013,3119
9,391,391,251,1033,3119
10,380,404,244,1028,3119
11,432,412,247,1091,3119
1,500,200,50,750,3120
2,473,220,91,784,3120
3,449,259,119,827,3120
4,411,306,170,887,3120
5,379,326,208,913,3120
6,400,357,218,975,3120
7,392,368,233,993,3120
8,387,381,229,997,3120
9,388,381,245,1014,3120
10,403,392,262,1057,3120
11,408,411,266,1085,3120
1,500,200,50,750,3121
2,459,252,95,806,3121
3,416,267,140,823,3121
4,407,275,166,848,3121
5,410,301,205,916,3121
6,406,347,199,952,3121
7,402,365,224,991,3121
8,384,370,256,1010,3121
9,393,397,249,1039,3121
10,392,387,276,1055,3121
11,402,374,301,1077,3121
1,500,200,50,750,3122
2,457,228,100,785,3122
3,432,261,139,832,3122
4,412,294,163,869,3122
5,397,293,201,891,3122
6,418,323,222,963,3122
7,401,347,228,976,3122
8,392,358,255,1005,3122
9,397,380,249,1026,3122
10,399,411,259,1069,3122
11,409,425,256,1090,3122
1,500,200,50,750,3123
2,465,237,74,776,3123
3,433,280,118,831,3123
4,419,300,163,882,3123
5,389,330,191,910,3123
6,423,342,216,981,3123
7,417,367,206,990,3123
8,410,351,238,999,3123
9,415,347,235,997,3123
10,428,383,252,1063,3123
11,418,405,263,1086,3123
1,500,200,50,750,3124
2,469,227,94,790,3124
3,429,253,146,828,3124
4,434,264,175,873,3124
5,409,303,206,918,3124
6,423,321,213,957,3124
7,404,350,229,983,3124
8,404,348,260,1012,3124
9,403,357,273,1033,3124
10,400,386,270,1056,3124
11,390,398,289,1077,3124
1,500,200,50,750,3125
2,455,233,101,789,3125
3,436,262,123,821,3125
4,423,295,155,873,3125
5,415,323,175,913,3125
6,410,329,221,960,3125
7,394,350,238,982,3125
8,387,378,239,1004,3125
9,403,390,251,1044,3125
10,380,400,266,1046,3125
11,407,409,287,1103,3125
1,500,200,50,750,3126
2,462,227,97,786,3126
3,425,248,155,828,3126
4,399,275,187,861,3126
5,388,312,203,903,3126
6,379,352,211,942,3126
7,387,357,242,986,3126
8,386,380,240,1006,3126
9,419,388,244,1051,3126
10,398,384,270,1052,3126
11,393,399,294,1086,3126
1,500,200,50,750,3127
2,464,227,96,787,3127
3,440,256,144,840,3127
4,406,292,161,859,3127
5,412,318,188,918,3127
6,392,367,214,973,3127
7,392,372,228,992,3127
8,392,365,256,1013,3127
9,399,368,258,1025,3127
10,391,400,272,1063,3127
11,374,412,296,1082,3127
1,500,200,50,750,3128
2,468,215,104,787,3128
3,432,262,140,834,3128
4,416,282,162,860,3128
5,425,310,190,925,3128
6,422,334,210,966,3128
7,390,353,245,988,3128
8,400,366,248,1014,3128
9,385,399,250,1034,3128
10,361,408,294,1063,3128
11,353,422,300,1075,3128
1,500,200,50,750,3129
2,463,242,95,800,3129
3,422,274,135,831,3129
4,421,301,164,886,3129
5,415,302,190,907,3129
6,425,336,205,966,3129
7,395,355,227,977,3129
8,393,355,244,992,3129
9,418,392,248,1058,3129
10,402,411,248,1061,3129
11,409,386,288,1083,3129
1,500,200,50,750,3130
2,461,244,96,801,3130
3,438,250,150,838,3130
4,427,288,161,876,3130
5,419,299,194,912,3130
6,409,351,197,957,3130
7,414,356,220,990,3130
8,433,361,222,1016,3130
9,411,360,266,1037,3130
10,400,387,275,1062,3130
11,416,395,286,1097,3130
1,500,200,50,750,3131
2,460,235,100,795,3131
3,426,246,144,816,3131
4,399,288,169,856,3131
5,395,310,201,906,3131
6,402,318,222,942,3131
7,404,360,211,975,3131
8,403,364,242,1009,3131
9,391,391,246,1028,3131
10,385,402,259,1046,3131
11,385,441,258,1084,3131
1,500,200,50,750,3132
2,464,232,83,779,3132
3,424,289,108,821,3132
4,402,320,136,858,3132
5,386,336,174,896,3132
6,378,357,196,931,3132
7,404,367,218,989,3132
8,383,371,241,995,3132
9,391,385,242,1018,3132
10,391,401,250,1042,3132
11,413,416,265,1094,3132
1,500,200,50,750,3133
2,468,236,102,806,3133
3,429,269,131,829,3133
4,407,285,169,861,3133
5,405,330,189,924,3133
6,391,366,194,951,3133
7,388,390,201,979,3133
8,384,378,226,988,3133
9,385,392,261,1038,3133
10,384,406,271,1061,3133
11,378,423,272,1073,3133
1,500,200,50,750,3134
2,455,231,97,783,3134
3,423,267,131,821,3134
4,423,290,153,866,3134
5,414,332,179,925,3134
6,437,333,199,969,3134
7,406,358,218,982,3134
8,406,369,229,1004,3134
9,384,389,235,1008,3134
10,379,398,257,1034,3134
11,416,388,267,1071,3134
1,500,200,50,750,3135
2,442,228,112,782,3135
3,417,274,128,819,3135
4,411,299,149,859,3135
5,409,305,200,914,3135
6,404,348,200,952,3135
7,381,375,227,983,3135
8,377,383,254,1014,3135
9,402,379,266,1047,3135
10,407,373,275,1055,3135
11,420,387,286,1093,3135
1,500,200,50,750,3136
2,432,250,97,779,3136
3,418,274,145,837,3136
4,386,312,161,859,3136
5,383,318,212,913,3136
6,396,349,216,961,3136
7,389,358,226,973,3136
8,393,365,245,1003,3136
9,398,385,240,1023,3136
10,411,370,268,1049,3136
11,433,397,262,1092,3136
1,500,200,50,750,3137
2,432,240,106,778,3137
3,422,252,149,823,3137
4,408,280,171,859,3137
5,422,292,190,904,3137
6,423,329,192,944,3137
7,392,366,224,982,3137
8,381,371,250,1002,3137
9,379,378,261,1018,3137
10,397,389,280,1066,3137
11,400,390,294,1084,3137
1,500,200,50,750,3138
2,460,225,101,786,3138
3,434,253,136,823,3138
4,410,292,170,872,3138
5,392,339,188,919,3138
6,400,349,203,952,3138
7,397,365,237,999,3138
8,404,374,238,1016,3138
9,382,378,270,1030,3138
10,380,371,292,1043,3138
11,388,389,296,1073,3138
1,500,200,50,750,3139
2,453,222,106,781,3139
3,424,264,125,813,3139
4,398,322,151,871,3139
5,391,336,187,914,3139
6,391,365,197,953,3139
7,373,401,207,981,3139
8,376,390,229,995,3139
9,369,395,270,1034,3139
10,374,384,289,1047,3139
11,383,398,297,1078,3139
1,500,200,50,750,3140
2,456,240,102,798,3140
3,425,251,138,814,3140
4,419,290,158,867,3140
5,420,316,188,924,3140
6,392,331,218,941,3140
7,400,355,218,973,3140
8,399,394,219,1012,3140
9,398,417,230,1045,3140
10,381,421,256,1058,3140
11,383,422,275,1080,3140
1,500,200,50,750,3141
2,461,236,93,790,3141
3,421,252,141,814,3141
4,425,286,161,872,3141
5,409,312,193,914,3141
6,405,342,206,953,3141
7,423,368,201,992,3141
8,417,371,214,1002,3141
9,415,398,217,1030,3141
10,416,392,257,1065,3141
11,435,404,256,1095,3141
1,500,200,50,750,3142
2,471,238,93,802,3142
3,453,245,124,822,3142
4,454,278,147,879,3142
5,434,287,193,914,3142
6,429,330,198,957,3142
7,438,345,211,994,3142
8,416,369,223,1008,3142
9,414,374,247,1035,3142
10,393,401,248,1042,3142
11,400,420,250,1070,3142
1,500,200,50,750,3143
2,441,248,92,781,3143
3,418,276,127,821,3143
4,386,313,161,860,3143
5,401,331,176,908,3143
6,389,356,221,966,3143
7,388,358,240,986,3143
8,392,365,249,1006,3143
9,407,358,264,1029,3143
10,410,385,263,1058,3143
11,406,391,284,1081,3143
1,500,200,50,750,3144
2,472,240,94,806,3144
3,414,271,133,818,3144
4,417,281,168,866,3144
5,418,319,182,919,3144
6,414,344,195,953,3144
7,423,350,211,984,3144
8,419,361,213,993,3144
9,404,363,236,1003,3144
10,399,400,238,1037,3144
11,423,436,233,1092,3144
1,500,200,50,750,3145
2,437,257,89,783,3145
3,424,278,131,833,3145
4,404,295,166,865,3145
5,415,320,191,926,3145
6,407,340,204,951,3145
7,386,367,215,968,3145
8,354,387,241,982,3145
9,380,396,249,1025,3145
10,395,404,263,1062,3145
11,401,412,263,1076,3145
1,500,200,50,750,3146
2,446,224,103,773,3146
3,443,254,128,825,3146
4,409,300,162,871,3146
5,400,326,168,894,3146
6,405,341,189,935,3146
7,418,342,226,986,3146
8,430,370,230,1030,3146
9,411,385,240,1036,3146
10,407,399,265,1071,3146
11,411,419,256,1086,3146
1,500,200,50,750,3147
2,461,221,99,781,3147
3,420,242,142,804,3147
4,439,269,165,873,3147
5,415,308,180,903,3147
6,411,335,208,954,3147
7,418,348,224,990,3147
8,415,364,242,1021,3147
9,404,384,264,1052,3147
10,377,383,287,1047,3147
11,405,381,273,1059,3147
1,500,200,50,750,3148
2,456,228,96,780,3148
3,432,254,136,822,3148
4,449,281,155,885,3148
5,419,292,192,903,3148
6,430,336,186,952,3148
7,428,337,221,986,3148
8,439,352,222,1013,3148
9,409,405,227,1041,3148
10,404,408,250,1062,3148
11,404,429,262,1095,3148
1,500,200,50,750,3149
2,458,221,93,772,3149
3,427,234,144,805,3149
4,438,262,174,874,3149
5,423,309,193,925,3149
6,437,311,213,961,3149
7,427,344,222,993,3149
8,394,371,239,1004,3149
9,379,391,252,1022,3149
10,394,397,274,1065,3149
11,411,424,257,1092,3149
1,500,200,50,750,3150
2,453,210,115,778,3150
3,426,245,153,824,3150
4,430,275,181,886,3150
5,414,309,188,911,3150
6,426,356,190,972,3150
7,427,365,195,987,3150
8,412,375,219,1006,3150
9,433,378,225,1036,3150
10,428,375,249,1052,3150
11,431,386,267,1084,3150
1,500,200,50,750,3151
2,457,223,107,787,3151
3,443,248,139,830,3151
4,430,302,153,885,3151
5,398,316,193,907,3151
6,408,346,206,960,3151
7,374,352,245,971,3151
8,377,369,265,1011,3151
9,407,366,269,1042,3151
10,408,373,278,1059,3151
11,401,408,290,1099,3151
1,500,200,50,750,3152
2,458,236,93,787,3152
3,426,247,147,820,3152
4,399,271,176,846,3152
5,413,294,193,900,3152
6,435,323,192,950,3152
7,406,352,224,982,3152
8,383,386,228,997,3152
9,382,382,271,1035,3152
10,378,361,308,1047,3152
11,380,407,288,1075,3152
1,500,200,50,750,3153
2,457,227,97,781,3153
3,454,250,128,832,3153
4,431,278,165,874,3153
5,420,309,181,910,3153
6,424,328,214,966,3153
7,415,354,216,985,3153
8,414,381,227,1022,3153
9,387,399,249,1035,3153
10,399,401,255,1055,3153
11,424,412,264,1100,3153
1,500,200,50,750,3154
2,470,238,93,801,3154
3,432,266,121,819,3154
4,405,286,173,864,3154
5,416,306,206,928,3154
6,393,327,222,942,3154
7,388,355,227,970,3154
8,403,372,246,1021,3154
9,412,395,232,1039,3154
10,407,399,246,1052,3154
11,413,391,274,1078,3154
1,500,200,50,750,3155
2,466,221,101,788,3155
3,435,249,133,817,3155
4,422,273,170,865,3155
5,392,311,206,909,3155
6,406,326,219,951,3155
7,416,342,224,982,3155
8,429,341,249,1019,3155
9,404,366,263,1033,3155
10,401,374,267,1042,3155
11,434,403,275,1112,3155
1,500,200,50,750,3156
2,467,230,95,792,3156
3,427,263,147,837,3156
4,389,298,172,859,3156
5,397,298,213,908,3156
6,396,345,223,964,3156
7,391,338,248,977,3156
8,365,360,272,997,3156
9,375,390,269,1034,3156
10,381,416,280,1077,3156
11,380,427,264,1071,3156
1,500,200,50,750,3157
2,453,237,98,788,3157
3,419,262,140,821,3157
4,416,301,159,876,3157
5,407,314,187,908,3157
6,403,366,195,964,3157
7,389,374,217,980,3157
8,373,380,240,993,3157
9,385,377,272,1034,3157
10,378,405,271,1054,3157
11,403,403,292,1098,3157
1,500,200,50,750,3158
2,455,227,103,785,3158
3,434,263,139,836,3158
4,408,285,168,861,3158
5,393,323,185,901,3158
6,401,331,214,946,3158
7,393,331,236,960,3158
8,421,355,244,1020,3158
9,410,354,277,1041,3158
10,402,349,302,1053,3158
11,417,374,305,1096,3158
1,500,200,50,750,3159
2,464,236,89,789,3159
3,441,257,130,828,3159
4,413,302,164,879,3159
5,386,312,200,898,3159
6,418,327,219,964,3159
7,373,374,227,974,3159
8,385,367,250,1002,3159
9,395,393,261,1049,3159
10,398,378,282,1058,3159
11,398,389,290,1077,3159
1,500,200,50,750,3160
2,454,228,104,786,3160
3,425,251,144,820,3160
4,437,270,174,881,3160
5,414,294,206,914,3160
6,431,335,211,977,3160
7,409,335,244,988,3160
8,394,355,258,1007,3160
9,369,384,264,1017,3160
10,388,374,300,1062,3160
11,384,399,289,1072,3160
1,500,200,50,750,3161
2,471,238,97,806,3161
3,412,266,139,817,3161
4,386,316,167,869,3161
5,359,348,192,899,3161
6,382,366,215,963,3161
7,380,385,218,983,3161
8,402,391,223,1016,3161
9,396,397,251,1044,3161
10,394,404,256,1054,3161
11,385,423,285,1093,3161
1,500,200,50,750,3162
2,468,232,97,797,3162
3,430,270,127,827,3162
4,393,287,167,847,3162
5,419,319,180,918,3162
6,412,328,213,953,3162
7,384,357,242,983,3162
8,370,362,264,996,3162
9,386,392,266,1044,3162
10,377,388,285,1050,3162
11,407,397,283,1087,3162
1,500,200,50,750,3163
2,464,223,99,786,3163
3,429,255,126,810,3163
4,417,274,154,845,3163
5,413,277,190,880,3163
6,420,332,207,959,3163
7,409,340,227,976,3163
8,417,352,237,1006,3163
9,398,370,255,1023,3163
10,414,388,267,1069,3163
11,399,402,271,1072,3163
1,500,200,50,750,3164
2,466,234,93,793,3164
3,443,263,125,831,3164
4,437,293,152,882,3164
5,418,315,178,911,3164
6,419,349,204,972,3164
7,415,353,221,989,3164
8,400,357,245,1002,3164
9,404,389,243,1036,3164
10,418,409,248,1075,3164
11,420,414,250,1084,3164
1,500,200,50,750,3165
2,459,242,86,787,3165
3,423,278,118,819,3165
4,418,301,154,873,3165
5,412,310,185,907,3165
6,400,333,212,945,3165
7,393,368,215,976,3165
8,385,396,230,1011,3165
9,368,388,262,1018,3165
10,394,398,274,1066,3165
11,382,429,275,1086,3165
1,500,200,50,750,3166
2,450,251,86,787,3166
3,401,293,137,831,3166
4,381,304,177,862,3166
5,388,298,200,886,3166
6,433,337,208,978,3166
7,397,368,209,974,3166
8,377,391,240,1008,3166
9,367,399,260,1026,3166
10,382,410,263,1055,3166
11,392,420,287,1099,3166
1,500,200,50,750,3167
2,469,228,101,798,3167
3,420,256,140,816,3167
4,389,300,160,849,3167
5,417,318,185,920,3167
6,415,330,218,963,3167
7,418,323,243,984,3167
8,393,372,237,1002,3167
9,404,390,246,1040,3167
10,396,424,237,1057,3167
11,413,397,279,1089,3167
1,500,200,50,750,3168
2,455,224,104,783,3168
3,439,264,138,841,3168
4,415,275,173,863,3168
5,396,304,207,907,3168
6,384,332,220,936,3168
7,400,361,229,990,3168
8,392,358,246,996,3168
9,422,368,250,1040,3168
10,395,413,257,1065,3168
11,423,400,271,1094,3168
1,500,200,50,750,3169
2,461,231,98,790,3169
3,441,267,127,835,3169
4,426,256,182,864,3169
5,418,295,195,908,3169
6,442,332,209,983,3169
7,405,347,228,980,3169
8,428,344,244,1016,3169
9,421,377,235,1033,3169
10,403,407,225,1035,3169
11,426,433,234,1093,3169
1,500,200,50,750,3170
2,481,227,100,808,3170
3,448,272,127,847,3170
4,428,294,148,870,3170
5,432,294,186,912,3170
6,425,318,202,945,3170
7,423,350,216,989,3170
8,401,372,224,997,3170
9,409,376,251,1036,3170
10,404,394,262,1060,3170
11,394,422,274,1090,3170
1,500,200,50,750,3171
2,467,224,95,786,3171
3,442,252,147,841,3171
4,417,278,163,858,3171
5,412,299,184,895,3171
6,435,326,212,973,3171
7,427,337,220,984,3171
8,421,333,233,987,3171
9,422,348,257,1027,3171
10,428,385,258,1071,3171
11,411,407,270,1088,3171
1,500,200,50,750,3172
2,464,231,100,795,3172
3,450,231,140,821,3172
4,447,272,158,877,3172
5,413,317,173,903,3172
6,450,330,214,994,3172
7,416,343,228,987,3172
8,428,346,233,1007,3172
9,409,350,259,1018,3172
10,409,388,270,1067,3172
11,371,402,290,1063,3172
1,500,200,50,750,3173
2,447,233,117,797,3173
3,412,261,158,831,3173
4,409,284,182,875,3173
5,383,314,195,892,3173
6,412,334,210,956,3173
7,399,341,249,989,3173
8,368,368,256,992,3173
9,408,349,276,1033,3173
10,407,384,270,1061,3173
11,396,386,289,1071,3173
1,500,200,50,750,3174
2,451,230,102,783,3174
3,419,237,159,815,3174
4,395,274,191,860,3174
5,387,302,210,899,3174
6,389,346,223,958,3174
7,396,366,231,993,3174
8,396,377,228,1001,3174
9,410,371,248,1029,3174
10,409,404,248,1061,3174
11,402,421,276,1099,3174
1,500,200,50,750,3175
2,441,230,110,781,3175
3,432,262,145,839,3175
4,414,281,161,856,3175
5,420,302,183,905,3175
6,417,318,202,937,3175
7,424,344,231,999,3175
8,402,357,242,1001,3175
9,387,397,228,1012,3175
10,384,393,268,1045,3175
11,393,417,282,1092,3175
1,500,200,50,750,3176
2,481,200,106,787,3176
3,459,219,147,825,3176
4,441,280,150,871,3176
5,439,298,183,920,3176
6,453,317,187,957,3176
7,442,329,214,985,3176
8,426,334,243,1003,3176
9,412,353,264,1029,3176
10,410,388,269,1067,3176
11,399,393,290,1082,3176
1,500,200,50,750,3177
2,461,240,104,805,3177
3,435,255,138,828,3177
4,406,283,186,875,3177
5,411,315,195,921,3177
6,417,317,212,946,3177
7,393,351,221,965,3177
8,412,386,213,1011,3177
9,408,390,236,1034,3177
10,430,383,237,1050,3177
11,433,412,235,1080,3177
1,500,200,50,750,3178
2,458,223,91,772,3178
3,432,276,133,841,3178
4,417,278,163,858,3178
5,408,312,184,904,3178
6,434,305,223,962,3178
7,417,331,236,984,3178
8,411,350,241,1002,3178
9,414,366,259,1039,3178
10,408,388,260,1056,3178
11,405,403,264,1072,3178
1,500,200,50,750,3179
2,447,219,113,779,3179
3,434,256,142,832,3179
4,428,288,168,884,3179
5,427,289,191,907,3179
6,452,319,212,983,3179
7,425,351,217,993,3179
8,407,369,226,1002,3179
9,388,381,252,1021,3179
10,404,397,253,1054,3179
11,405,411,275,1091,3179
1,500,200,50,750,3180
2,455,230,99,784,3180
3,419,275,132,826,3180
4,397,302,172,871,3180
5,365,331,205,901,3180
6,384,349,226,959,3180
7,382,354,235,971,3180
8,400,374,237,1011,3180
9,396,418,227,1041,3180
10,397,412,256,1065,3180
11,405,412,270,1087,3180
1,500,200,50,750,3181
2,470,214,99,783,3181
3,449,244,130,823,3181
4,438,271,158,867,3181
5,425,294,199,918,3181
6,410,336,207,953,3181
7,387,366,241,994,3181
8,391,368,238,997,3181
9,386,385,255,1026,3181
10,378,415,248,1041,3181
11,393,418,262,1073,3181
1,500,200,50,750,3182
2,472,220,93,785,3182
3,452,243,134,829,3182
4,427,255,178,860,3182
5,412,309,184,905,3182
6,425,327,208,960,3182
7,403,360,214,977,3182
8,390,388,220,998,3182
9,399,396,218,1013,3182
10,397,399,266,1062,3182
11,387,396,278,1061,3182
1,500,200,50,750,3183
2,460,218,98,776,3183
3,461,244,134,839,3183
4,424,275,159,858,3183
5,418,326,176,920,3183
6,430,331,192,953,3183
7,416,320,236,972,3183
8,407,344,247,998,3183
9,413,365,248,1026,3183
10,432,363,268,1063,3183
11,411,384,286,1081,3183
1,500,200,50,750,3184
2,470,201,113,784,3184
3,450,235,132,817,3184
4,413,277,166,856,3184
5,415,302,186,903,3184
6,404,339,194,937,3184
7,415,365,224,1004,3184
8,398,387,233,1018,3184
9,390,394,254,1038,3184
10,395,400,267,1062,3184
11,394,441,266,1101,3184
1,500,200,50,750,3185
2,455,242,103,800,3185
3,436,263,142,841,3185
4,387,283,183,853,3185
5,394,338,176,908,3185
6,370,357,209,936,3185
7,383,375,225,983,3185
8,377,389,240,1006,3185
9,377,406,235,1018,3185
10,392,420,241,1053,3185
11,421,432,256,1109,3185
1,500,200,50,750,3186
2,467,226,101,794,3186
3,432,251,131,814,3186
4,426,277,157,860,3186
5,436,308,180,924,3186
6,415,323,213,951,3186
7,387,346,253,986,3186
8,387,364,265,1016,3186
9,372,376,280,1028,3186
10,375,426,272,1073,3186
11,391,433,261,1085,3186
1,500,200,50,750,3187
2,463,239,91,793,3187
3,423,246,139,808,3187
4,414,278,171,863,3187
5,427,305,190,922,3187
6,440,308,209,957,3187
7,432,332,219,983,3187
8,426,349,234,1009,3187
9,448,358,243,1049,3187
10,429,387,245,1061,3187
11,427,394,253,1074,3187
1,500,200,50,750,3188
2,449,228,106,783,3188
3,439,242,152,833,3188
4,414,249,177,840,3188
5,438,299,188,925,3188
6,430,340,198,968,3188
7,431,338,214,983,3188
8,398,373,222,993,3188
9,398,392,237,1027,3188
10,406,404,262,1072,3188
11,390,411,276,1077,3188
1,500,200,50,750,3189
2,470,216,114,800,3189
3,427,257,136,820,3189
4,411,297,161,869,3189
5,401,307,198,906,3189
6,422,328,202,952,3189
7,401,345,234,980,3189
8,396,369,233,998,3189
9,393,377,261,1031,3189
10,394,385,275,1054,3189
11,398,386,297,1081,3189
1,500,200,50,750,3190
2,452,234,104,790,3190
3,424,262,155,841,3190
4,388,314,167,869,3190
5,390,321,193,904,3190
6,388,347,225,960,3190
7,367,372,241,980,3190
8,364,369,282,1015,3190
9,383,368,290,1041,3190
10,392,389,292,1073,3190
11,369,411,297,1077,3190
1,500,200,50,750,3191
2,466,215,105,786,3191
3,435,258,139,832,3191
4,414,299,159,872,3191
5,409,305,190,904,3191
6,422,340,192,954,3191
7,416,349,224,989,3191
8,399,364,246,1009,3191
9,407,360,266,1033,3191
10,414,372,269,1055,3191
11,428,351,299,1078,3191
1,500,200,50,750,3192
2,440,252,90,782,3192
3,431,289,126,846,3192
4,406,304,163,873,3192
5,416,326,182,924,3192
6,419,346,201,966,3192
7,411,358,213,982,3192
8,391,395,231,1017,3192
9,379,407,240,1026,3192
10,391,419,251,1061,3192
11,399,423,246,1068,3192
1,500,200,50,750,3193
2,451,218,110,779,3193
3,438,239,155,832,3193
4,428,268,188,884,3193
5,392,306,199,897,3193
6,410,331,224,965,3193
7,402,349,225,976,3193
8,406,364,238,1008,3193
9,413,376,249,1038,3193
10,407,387,263,1057,3193
11,418,399,255,1072,3193
1,500,200,50,750,3194
2,457,226,106,789,3194
3,408,271,139,818,3194
4,382,299,173,854,3194
5,379,346,190,915,3194
6,388,353,212,953,3194
7,405,373,220,998,3194
8,400,393,222,1015,3194
9,404,377,247,1028,3194
10,399,419,256,1074,3194
11,390,410,289,1089,3194
1,500,200,50,750,3195
2,451,235,100,786,3195
3,429,245,153,827,3195
4,400,283,179,862,3195
5,383,318,202,903,3195
6,381,359,205,945,3195
7,374,366,241,981,3195
8,371,381,247,999,3195
9,388,360,269,1017,3195
10,401,365,270,1036,3195
11,408,379,279,1066,3195
1,500,200,50,750,3196
2,465,229,98,792,3196
3,434,246,155,835,3196
4,402,268,192,862,3196
5,392,302,213,907,3196
6,398,334,226,958,3196
7,394,348,254,996,3196
8,402,371,243,1016,3196
9,409,372,264,1045,3196
10,423,377,266,1066,3196
11,419,391,278,1088,3196
1,500,200,50,750,3197
2,463,232,90,785,3197
3,425,267,128,820,3197
4,408,290,173,871,3197
5,409,330,185,924,3197
6,393,340,207,940,3197
7,412,356,223,991,3197
8,398,373,241,1012,3197
9,404,371,255,1030,3197
10,426,388,255,1069,3197
11,390,403,275,1068,3197
1,500,200,50,750,3198
2,439,248,107,794,3198
3,399,273,147,819,3198
4,382,289,194,865,3198
5,368,310,220,898,3198
6,387,356,230,973,3198
7,381,364,247,992,3198
8,370,401,231,1002,3198
9,371,399,259,1029,3198
10,374,445,259,1078,3198
11,367,420,288,1075,3198
1,500,200,50,750,3199
2,455,237,95,787,3199
3,416,264,123,803,3199
4,420,301,156,877,3199
5,420,319,189,928,3199
6,402,344,214,960,3199
7,411,352,222,985,3199
8,399,368,233,1000,3199
9,395,385,251,1031,3199
10,408,381,265,1054,3199
11,428,407,267,1102,3199
1,500,200,50,750,3200
2,469,200,109,778,3200
3,430,244,153,827,3200
4,421,269,181,871,3200
5,403,335,184,922,3200
6,416,331,220,967,3200
7,393,359,226,978,3200
8,405,346,242,993,3200
9,415,369,261,1045,3200
10,415,389,254,1058,3200
11,448,399,249,1096,3200
1,500,200,50,750,3201
2,451,230,107,788,3201
3,421,256,152,829,3201
4,406,288,183,877,3201
5,403,302,217,922,3201
6,377,341,234,952,3201
7,388,368,244,1000,3201
8,387,349,255,991,3201
9,419,367,256,1042,3201
10,429,376,266,1071,3201
11,418,408,271,1097,3201
1,500,200,50,750,3202
2,465,232,93,790,3202
3,457,261,126,844,3202
4,421,298,146,865,3202
5,415,330,168,913,3202
6,398,347,210,955,3202
7,372,363,234,969,3202
8,378,395,233,1006,3202
9,383,402,253,1038,3202
10,385,394,279,1058,3202
11,370,423,271,1064,3202
1,500,200,50,750,3203
2,454,238,94,786,3203
3,420,280,128,828,3203
4,398,295,166,859,3203
5,395,320,195,910,3203
6,417,341,217,975,3203
7,394,363,227,984,3203
8,377,391,231,999,3203
9,409,385,240,1034,3203
10,434,398,243,1075,3203
11,404,402,265,1071,3203
1,500,200,50,750,3204
2,467,232,102,801,3204
3,441,253,139,833,3204
4,431,278,161,870,3204
5,421,289,187,897,3204
6,409,334,185,928,3204
7,423,374,198,995,3204
8,377,386,234,997,3204
9,383,402,251,1036,3204
10,371,380,302,1053,3204
11,369,402,308,1079,3204
1,500,200,50,750,3205
2,444,239,104,787,3205
3,424,269,144,837,3205
4,405,303,159,867,3205
5,407,339,174,920,3205
6,419,361,189,969,3205
7,401,348,240,989,3205
8,401,369,246,1016,3205
9,399,368,264,1031,3205
10,403,392,267,1062,3205
11,399,395,285,1079,3205
1,500,200,50,750,3206
2,437,256,93,786,3206
3,417,292,131,840,3206
4,394,305,161,860,3206
5,407,330,177,914,3206
6,408,347,195,950,3206
7,386,365,227,978,3206
8,406,384,219,1009,3206
9,398,382,247,1027,3206
10,392,400,274,1066,3206
11,389,408,282,1079,3206
1,500,200,50,750,3207
2,464,219,110,793,3207
3,438,256,137,831,3207
4,405,303,164,872,3207
5,400,333,195,928,3207
6,403,337,212,952,3207
7,389,342,242,973,3207
8,384,371,247,1002,3207
9,405,404,246,1055,3207
10,409,411,241,1061,3207
11,428,423,236,1087,3207
1,500,200,50,750,3208
2,452,226,97,775,3208
3,432,269,132,833,3208
4,425,284,162,871,3208
5,407,322,196,925,3208
6,395,340,220,955,3208
7,393,359,225,977,3208
8,398,373,221,992,3208
9,397,384,258,1039,3208
10,406,406,255,1067,3208
11,422,400,261,1083,3208
1,500,200,50,750,3209
2,472,236,87,795,3209
3,447,244,133,824,3209
4,426,273,167,866,3209
5,425,307,184,916,3209
6,429,332,210,971,3209
7,398,351,238,987,3209
8,407,350,241,998,3209
9,398,371,258,1027,3209
10,383,388,275,1046,3209
11,382,426,283,1091,3209
1,500,200,50,750,3210
2,443,255,100,798,3210
3,420,264,135,819,3210
4,431,276,179,886,3210
5,402,298,206,906,3210
6,402,363,193,958,3210
7,398,354,229,981,3210
8,397,357,256,1010,3210
9,401,369,265,1035,3210
10,389,400,263,1052,3210
11,393,410,267,1070,3210
1,500,200,50,750,3211
2,453,220,109,782,3211
3,421,245,147,813,3211
4,423,272,163,858,3211
5,393,314,193,900,3211
6,397,346,215,958,3211
7,399,366,221,986,3211
8,394,377,226,997,3211
9,404,420,229,1053,3211
10,389,402,257,1048,3211
11,397,445,256,1098,3211
1,500,200,50,750,3212
2,455,225,99,779,3212
3,426,256,140,822,3212
4,417,285,164,866,3212
5,431,304,167,902,3212
6,435,340,193,968,3212
7,421,368,197,986,3212
8,412,372,221,1005,3212
9,393,374,248,1015,3212
10,395,395,269,1059,3212
11,395,394,285,1074,3212
1,500,200,50,750,3213
2,449,236,101,786,3213
3,407,295,129,831,3213
4,396,306,170,872,3213
5,402,320,210,932,3213
6,391,350,225,966,3213
7,377,344,260,981,3213
8,366,374,265,1005,3213
9,369,390,274,1033,3213
10,387,404,268,1059,3213
11,393,414,280,1087,3213
1,500,200,50,750,3214
2,466,229,90,785,3214
3,451,247,143,841,3214
4,424,274,171,869,3214
5,426,322,183,931,3214
6,412,334,211,957,3214
7,394,375,205,974,3214
8,397,375,226,998,3214
9,381,376,251,1008,3214
10,374,410,254,1038,3214
11,381,430,264,1075,3214
1,500,200,50,750,3215
2,449,224,113,786,3215
3,445,248,135,828,3215
4,422,278,176,876,3215
5,405,315,184,904,3215
6,426,360,196,982,3215
7,392,384,203,979,3215
8,394,398,228,1020,3215
9,361,419,246,1026,3215
10,365,433,258,1056,3215
11,381,432,278,1091,3215
1,500,200,50,750,3216
2,450,228,97,775,3216
3,427,262,138,827,3216
4,411,301,163,875,3216
5,396,317,201,914,3216
6,406,343,213,962,3216
7,381,363,242,986,3216
8,373,362,267,1002,3216
9,394,385,266,1045,3216
10,397,385,278,1060,3216
11,410,382,294,1086,3216
1,500,200,50,750,3217
2,468,214,107,789,3217
3,435,261,134,830,3217
4,410,289,161,860,3217
5,413,319,178,910,3217
6,413,340,197,950,3217
7,397,376,224,997,3217
8,364,402,234,1000,3217
9,390,398,239,1027,3217
10,393,409,247,1049,3217
11,399,428,251,1078,3217
1,500,200,50,750,3218
2,447,230,99,776,3218
3,431,243,147,821,3218
4,438,266,160,864,3218
5,413,316,181,910,3218
6,414,354,208,976,3218
7,396,353,217,966,3218
8,416,355,231,1002,3218
9,414,368,251,1033,3218
10,402,392,272,1066,3218
11,380,385,296,1061,3218
1,500,200,50,750,3219
2,463,222,101,786,3219
3,436,263,128,827,3219
4,437,248,181,866,3219
5,411,302,185,898,3219
6,413,348,192,953,3219
7,396,356,225,977,3219
8,409,370,244,1023,3219
9,396,385,254,1035,3219
10,383,382,272,1037,3219
11,423,386,284,1093,3219
1,500,200,50,750,3220
2,467,234,103,804,3220
3,427,260,131,818,3220
4,399,285,162,846,3220
5,393,337,190,920,3220
6,395,349,205,949,3220
7,370,392,222,984,3220
8,392,371,239,1002,3220
9,391,381,260,1032,3220
10,407,381,273,1061,3220
11,410,403,280,1093,3220
1,500,200,50,750,3221
2,446,230,101,777,3221
3,410,260,135,805,3221
4,401,289,181,871,3221
5,414,314,193,921,3221
6,395,347,215,957,3221
7,393,340,231,964,3221
8,417,360,218,995,3221
9,431,390,224,1045,3221
10,400,407,246,1053,3221
11,383,420,272,1075,3221
1,500,200,50,750,3222
2,461,220,117,798,3222
3,438,254,139,831,3222
4,414,263,191,868,3222
5,418,300,200,918,3222
6,413,333,205,951,3222
7,411,346,226,983,3222
8,396,352,251,999,3222
9,413,377,255,1045,3222
10,408,380,265,1053,3222
11,425,396,274,1095,3222
1,500,200,50,750,3223
2,465,227,99,791,3223
3,418,287,121,826,3223
4,386,312,151,849,3223
5,403,325,177,905,3223
6,397,366,197,960,3223
7,382,356,236,974,3223
8,367,387,249,1003,3223
9,376,393,266,1035,3223
10,351,395,287,1033,3223
11,385,404,308,1097,3223
1,500,200,50,750,3224
2,464,233,95,792,3224
3,423,259,139,821,3224
4,423,273,177,873,3224
5,412,308,201,921,3224
6,394,342,207,943,3224
7,388,371,224,983,3224
8,392,382,250,1024,3224
9,385,392,260,1037,3224
10,390,399,269,1058,3224
11,407,427,270,1104,3224
1,500,200,50,750,3225
2,471,218,97,786,3225
3,443,241,134,818,3225
4,411,273,171,855,3225
5,407,294,199,900,3225
6,402,333,209,944,3225
7,393,362,216,971,3225
8,402,378,231,1011,3225
9,389,400,241,1030,3225
10,402,410,261,1073,3225
11,413,413,268,1094,3225
1,500,200,50,750,3226
2,442,230,105,777,3226
3,434,268,142,844,3226
4,417,283,152,852,3226
5,422,305,192,919,3226
6,419,320,216,955,3226
7,433,334,221,988,3226
8,412,357,238,1007,3226
9,396,378,272,1046,3226
10,385,407,264,1056,3226
11,393,420,272,1085,3226
1,500,200,50,750,3227
2,469,246,90,805,3227
3,428,272,127,827,3227
4,407,276,174,857,3227
5,413,333,181,927,3227
6,387,347,208,942,3227
7,415,346,224,985,3227
8,396,378,229,1003,3227
9,398,389,255,1042,3227
10,398,392,279,1069,3227
11,389,407,291,1087,3227
1,500,200,50,750,3228
2,458,240,100,798,3228
3,440,245,151,836,3228
4,418,293,166,877,3228
5,411,303,192,906,3228
6,424,337,214,975,3228
7,414,361,214,989,3228
8,404,381,217,1002,3228
9,380,395,248,1023,3228
10,389,408,257,1054,3228
11,411,431,242,1084,3228
1,500,200,50,750,3229
2,459,220,111,790,3229
3,436,262,138,836,3229
4,417,291,157,865,3229
5,415,309,187,911,3229
6,410,343,201,954,3229
7,433,340,208,981,3229
8,426,360,214,1000,3229
9,413,378,240,1031,3229
10,430,360,270,1060,3229
11,440,364,284,1088,3229
1,500,200,50,750,3230
2,460,234,92,786,3230
3,422,259,144,825,3230
4,428,267,165,860,3230
5,435,322,174,931,3230
6,416,342,198,956,3230
7,408,372,203,983,3230
8,399,388,221,1008,3230
9,381,388,252,1021,3230
10,386,420,254,1060,3230
11,387,436,270,1093,3230
1,500,200,50,750,3231
2,454,228,99,781,3231
3,419,268,129,816,3231
4,397,291,173,861,3231
5,405,312,183,900,3231
6,419,317,204,940,3231
7,396,367,208,971,3231
8,405,375,231,1011,3231
9,399,393,247,1039,3231
10,394,394,260,1048,3231
11,404,413,269,1086,3231
1,500,200,50,750,3232
2,471,230,89,790,3232
3,441,255,137,833,3232
4,426,268,168,862,3232
5,415,323,169,907,3232
6,407,351,187,945,3232
7,393,370,220,983,3232
8,392,386,226,1004,3232
9,382,408,249,1039,3232
10,388,421,247,1056,3232
11,417,421,259,1097,3232
1,500,200,50,750,3233
2,459,236,85,780,3233
3,442,263,123,828,3233
4,410,300,156,866,3233
5,417,309,196,922,3233
6,425,338,198,961,3233
7,413,339,227,979,3233
8,396,355,249,1000,3233
9,403,358,263,1024,3233
10,403,403,260,1066,3233
11,414,413,249,1076,3233
1,500,200,50,750,3234
2,447,227,107,781,3234
3,430,261,131,822,3234
4,425,279,165,869,3234
5,409,309,203,921,3234
6,383,344,218,945,3234
7,392,364,223,979,3234
8,379,376,243,998,3234
9,380,406,244,1030,3234
10,367,411,267,1045,3234
11,371,431,273,1075,3234
1,500,200,50,750,3235
2,458,241,89,788,3235
3,440,262,127,829,3235
4,415,286,154,855,3235
5,395,337,181,913,3235
6,406,365,197,968,3235
7,413,372,222,1007,3235
8,397,356,251,1004,3235
9,380,397,254,1031,3235
10,398,407,253,1058,3235
11,403,410,264,1077,3235
1,500,200,50,750,3236
2,461,232,90,783,3236
3,437,243,141,821,3236
4,422,261,172,855,3236
5,427,308,187,922,3236
6,426,339,197,962,3236
7,407,359,211,977,3236
8,423,359,228,1010,3236
9,429,356,245,1030,3236
10,408,400,262,1070,3236
11,415,412,284,1111,3236
1,500,200,50,750,3237
2,463,224,105,792,3237
3,437,246,143,826,3237
4,408,303,146,857,3237
5,424,314,186,924,3237
6,427,324,208,959,3237
7,394,372,223,989,3237
8,383,389,238,1010,3237
9,359,407,267,1033,3237
10,357,419,273,1049,3237
11,355,439,281,1075,3237
1,500,200,50,750,3238
2,454,224,107,785,3238
3,456,258,136,850,3238
4,429,268,170,867,3238
5,396,293,217,906,3238
6,426,314,203,943,3238
7,416,328,231,975,3238
8,402,335,239,976,3238
9,424,377,241,1042,3238
10,397,378,271,1046,3238
11,416,394,283,1093,3238
1,500,200,50,750,3239
2,460,238,86,784,3239
3,408,290,121,819,3239
4,396,295,158,849,3239
5,416,314,195,925,3239
6,412,320,230,962,3239
7,393,344,246,983,3239
8,389,355,261,1005,3239
9,393,383,255,1031,3239
10,406,409,244,1059,3239
11,410,422,254,1086,3239
1,500,200,50,750,3240
2,457,235,92,784,3240
3,454,259,107,820,3240
4,435,296,152,883,3240
5,425,318,185,928,3240
6,399,343,222,964,3240
7,385,394,220,999,3240
8,371,411,224,1006,3240
9,381,403,249,1033,3240
10,384,412,270,1066,3240
11,390,413,266,1069,3240
1,500,200,50,750,3241
2,454,221,98,773,3241
3,448,246,138,832,3241
4,428,290,167,885,3241
5,423,298,190,911,3241
6,407,315,216,938,3241
7,402,347,224,973,3241
8,397,378,226,1001,3241
9,375,419,234,1028,3241
10,390,430,238,1058,3241
11,394,409,269,1072,3241
1,500,200,50,750,3242
2,456,232,110,798,3242
3,431,256,143,830,3242
4,423,280,179,882,3242
5,410,305,197,912,3242
6,421,316,225,962,3242
7,406,342,238,986,3242
8,380,372,250,1002,3242
9,388,389,260,1037,3242
10,386,388,272,1046,3242
11,403,392,282,1077,3242
1,500,200,50,750,3243
2,452,223,101,776,3243
3,420,262,148,830,3243
4,408,296,168,872,3243
5,401,303,194,898,3243
6,399,330,215,944,3243
7,381,347,250,978,3243
8,363,372,261,996,3243
9,360,391,261,1012,3243
10,358,400,277,1035,3243
11,373,407,294,1074,3243
1,500,200,50,750,3244
2,475,236,93,804,3244
3,411,257,141,809,3244
4,416,289,171,876,3244
5,397,319,188,904,3244
6,383,332,226,941,3244
7,372,375,226,973,3244
8,365,371,254,990,3244
9,382,416,245,1043,3244
10,358,424,273,1055,3244
11,355,437,289,1081,3244
1,500,200,50,750,3245
2,470,232,92,794,3245
3,428,249,148,825,3245
4,406,289,173,868,3245
5,416,305,194,915,3245
6,424,328,202,954,3245
7,404,348,233,985,3245
8,395,372,239,1006,3245
9,392,378,255,1025,3245
10,411,384,262,1057,3245
11,401,398,303,1102,3245
1,500,200,50,750,3246
2,442,230,98,770,3246
3,405,262,137,804,3246
4,419,276,173,868,3246
5,401,307,198,906,3246
6,390,339,211,940,3246
7,376,375,230,981,3246
8,367,379,256,1002,3246
9,389,396,254,1039,3246
10,381,419,276,1076,3246
11,401,402,298,1101,3246
1,500,200,50,750,3247
2,456,226,93,775,3247
3,459,259,128,846,3247
4,427,298,145,870,3247
5,426,314,177,917,3247
6,408,340,207,955,3247
7,395,381,220,996,3247
8,362,382,256,1000,3247
9,378,392,262,1032,3247
10,390,383,285,1058,3247
11,388,405,290,1083,3247
1,500,200,50,750,3248
2,463,212,94,769,3248
3,461,232,128,821,3248
4,434,274,162,870,3248
5,431,293,198,922,3248
6,419,350,205,974,3248
7,390,357,225,972,3248
8,375,363,259,997,3248
9,405,371,267,1043,3248
10,416,385,256,1057,3248
11,431,410,251,1092,3248
1,500,200,50,750,3249
2,455,255,98,808,3249
3,412,270,157,839,3249
4,372,298,185,855,3249
5,377,304,208,889,3249
6,413,343,214,970,3249
7,386,372,228,986,3249
8,378,385,241,1004,3249
9,379,399,249,1027,3249
10,395,382,271,1048,3249
11,408,388,285,1081,3249
1,500,200,50,750,3250
2,450,235,106,791,3250
3,443,265,133,841,3250
4,406,292,168,866,3250
5,411,302,186,899,3250
6,402,331,220,953,3250
7,409,333,237,979,3250
8,424,346,243,1013,3250
9,382,378,265,1025,3250
10,387,367,288,1042,3250
11,394,401,278,1073,3250
1,500,200,50,750,3251
2,453,233,87,773,3251
3,420,271,130,821,3251
4,418,278,164,860,3251
5,406,284,210,900,3251
6,404,312,240,956,3251
7,406,335,226,967,3251
8,414,331,255,1000,3251
9,403,356,267,1026,3251
10,386,388,283,1057,3251
11,397,385,298,1080,3251
1,500,200,50,750,3252
2,452,238,94,784,3252
3,406,263,130,799,3252
4,417,318,150,885,3252
5,392,338,191,921,3252
6,384,346,231,961,3252
7,386,368,245,999,3252
8,392,389,236,1017,3252
9,391,384,254,1029,3252
10,424,361,266,1051,3252
11,411,394,277,1082,3252
1,500,200,50,750,3253
2,465,213,102,780,3253
3,452,262,123,837,3253
4,426,281,164,871,3253
5,411,301,203,915,3253
6,400,349,223,972,3253
7,367,373,230,970,3253
8,352,390,258,1000,3253
9,381,383,270,1034,3253
10,377,389,286,1052,3253
11,387,407,297,1091,3253
1,500,200,50,750,3254
2,459,236,96,791,3254
3,427,272,124,823,3254
4,410,286,162,858,3254
5,411,318,184,913,3254
6,418,338,204,960,3254
7,420,350,223,993,3254
8,397,359,234,990,3254
9,405,398,241,1044,3254
10,398,402,260,1060,3254
11,391,408,274,1073,3254
1,500,200,50,750,3255
2,476,221,113,810,3255
3,434,241,141,816,3255
4,423,278,163,864,3255
5,445,315,174,934,3255
6,441,322,187,950,3255
7,436,337,214,987,3255
8,427,341,243,1011,3255
9,408,372,263,1043,3255
10,386,390,274,1050,3255
11,390,414,286,1090,3255
1,500,200,50,750,3256
2,482,227,98,807,3256
3,416,253,143,812,3256
4,434,290,157,881,3256
5,405,306,188,899,3256
6,441,340,198,979,3256
7,434,350,203,987,3256
8,441,367,208,1016,3256
9,422,362,241,1025,3256
10,399,385,263,1047,3256
11,413,400,269,1082,3256
1,500,200,50,750,3257
2,479,227,91,797,3257
3,439,241,136,816,3257
4,427,279,176,882,3257
5,404,307,202,913,3257
6,397,323,235,955,3257
7,398,363,238,999,3257
8,379,379,252,1010,3257
9,381,399,252,1032,3257
10,354,404,289,1047,3257
11,361,406,311,1078,3257
1,500,200,50,750,3258
2,453,234,95,782,3258
3,418,272,148,838,3258
4,414,303,162,879,3258
5,383,329,187,899,3258
6,412,349,219,980,3258
7,376,350,249,975,3258
8,378,377,244,999,3258
9,387,392,257,1036,3258
10,393,403,264,1060,3258
11,386,411,296,1093,3258
1,500,200,50,750,3259
2,443,250,101,794,3259
3,420,266,131,817,3259
4,410,310,155,875,3259
5,384,336,182,902,3259
6,376,358,223,957,3259
7,353,393,224,970,3259
8,349,413,219,981,3259
9,376,402,244,1022,3259
10,401,401,261,1063,3259
11,407,410,274,1091,3259
1,500,200,50,750,3260
2,451,221,92,764,3260
3,450,239,124,813,3260
4,426,261,168,855,3260
5,445,296,189,930,3260
6,413,331,204,948,3260
7,422,350,202,974,3260
8,415,368,221,1004,3260
9,414,371,236,1021,3260
10,410,396,252,1058,3260
11,416,410,277,1103,3260
1,500,200,50,750,3261
2,443,232,105,780,3261
3,451,264,135,850,3261
4,417,290,161,868,3261
5,412,318,186,916,3261
6,422,358,190,970,3261
7,408,374,207,989,3261
8,398,385,237,1020,3261
9,379,408,244,1031,3261
10,379,402,270,1051,3261
11,388,455,245,1088,3261
1,500,200,50,750,3262
2,445,241,96,782,3262
3,435,261,139,835,3262
4,422,290,159,871,3262
5,406,322,178,906,3262
6,407,358,190,955,3262
7,391,357,230,978,3262
8,387,379,249,1015,3262
9,379,400,243,1022,3262
10,400,402,254,1056,3262
11,410,391,286,1087,3262
1,500,200,50,750,3263
2,466,204,109,779,3263
3,432,243,146,821,3263
4,416,286,158,860,3263
5,431,298,193,922,3263
6,418,306,221,945,3263
7,425,332,232,989,3263
8,414,359,240,1013,3263
9,401,383,249,1033,3263
10,397,385,261,1043,3263
11,422,392,267,1081,3263
1,500,200,50,750,3264
2,451,234,93,778,3264
3,416,261,136,813,3264
4,424,272,182,878,3264
5,405,322,179,906,3264
6,419,328,209,956,3264
7,423,347,224,994,3264
8,397,369,226,992,3264
9,386,390,238,1014,3264
10,401,389,263,1053,3264
11,395,421,280,1096,3264
1,500,200,50,750,3265
2,453,232,105,790,3265
3,428,260,129,817,3265
4,415,271,179,865,3265
5,408,325,196,929,3265
6,431,328,208,967,3265
7,411,336,234,981,3265
8,418,341,245,1004,3265
9,392,375,245,1012,3265
10,405,389,269,1063,3265
11,436,393,275,1104,3265
1,500,200,50,750,3266
2,444,236,104,784,3266
3,409,272,144,825,3266
4,400,307,169,876,3266
5,378,341,186,905,3266
6,380,363,220,963,3266
7,379,386,224,989,3266
8,391,390,231,1012,3266
9,386,397,258,1041,3266
10,375,396,280,1051,3266
11,382,432,258,1072,3266
1,500,200,50,750,3267
2,467,224,89,780,3267
3,444,234,135,813,3267
4,417,271,163,851,3267
5,406,300,199,905,3267
6,381,347,223,951,3267
7,384,359,237,980,3267
8,382,360,258,1000,3267
9,379,384,268,1031,3267
10,367,407,280,1054,3267
11,395,406,290,1091,3267
1,500,200,50,750,3268
2,454,232,94,780,3268
3,421,263,136,820,3268
4,435,268,156,859,3268
5,428,311,168,907,3268
6,424,335,207,966,3268
7,388,369,237,994,3268
8,377,393,232,1002,3268
9,384,383,262,1029,3268
10,408,388,263,1059,3268
11,401,409,287,1097,3268
1,500,200,50,750,3269
2,461,240,89,790,3269
3,416,274,124,814,3269
4,385,324,158,867,3269
5,407,339,172,918,3269
6,403,369,189,961,3269
7,430,382,192,1004,3269
8,387,374,235,996,3269
9,392,387,256,1035,3269
10,404,401,266,1071,3269
11,384,413,293,1090,3269
1,500,200,50,750,3270
2,460,227,96,783,3270
3,434,233,141,808,3270
4,433,293,156,882,3270
5,408,323,179,910,3270
6,416,337,208,961,3270
7,392,350,240,982,3270
8,384,367,249,1000,3270
9,388,381,279,1048,3270
10,387,398,276,1061,3270
11,389,439,263,1091,3270
1,500,200,50,750,3271
2,445,238,96,779,3271
3,428,267,132,827,3271
4,421,282,160,863,3271
5,423,299,186,908,3271
6,400,323,216,939,3271
7,399,369,234,1002,3271
8,385,372,244,1001,3271
9,377,397,258,1032,3271
10,364,406,285,1055,3271
11,372,434,277,1083,3271
1,500,200,50,750,3272
2,462,231,96,789,3272
3,435,262,134,831,3272
4,402,290,168,860,3272
5,406,310,192,908,3272
6,423,328,208,959,3272
7,414,352,217,983,3272
8,413,368,227,1008,3272
9,377,391,247,1015,3272
10,391,397,266,1054,3272
11,370,407,279,1056,3272
1,500,200,50,750,3273
2,451,228,100,779,3273
3,438,249,138,825,3273
4,415,282,171,868,3273
5,409,296,195,900,3273
6,434,323,214,971,3273
7,397,367,231,995,3273
8,392,368,240,1000,3273
9,402,373,261,1036,3273
10,394,386,274,1054,3273
11,385,425,278,1088,3273
1,500,200,50,750,3274
2,453,228,102,783,3274
3,441,241,146,828,3274
4,399,283,172,854,3274
5,384,309,205,898,3274
6,419,337,223,979,3274
7,390,356,246,992,3274
8,362,371,265,998,3274
9,365,396,270,1031,3274
10,372,419,275,1066,3274
11,388,441,259,1088,3274
1,500,200,50,750,3275
2,452,234,99,785,3275
3,430,256,126,812,3275
4,424,270,169,863,3275
5,405,289,197,891,3275
6,397,331,225,953,3275
7,423,341,221,985,3275
8,393,346,260,999,3275
9,402,372,254,1028,3275
10,418,382,250,1050,3275
11,418,395,272,1085,3275
1,500,200,50,750,3276
2,443,224,114,781,3276
3,410,262,150,822,3276
4,415,280,185,880,3276
5,387,295,219,901,3276
6,366,359,246,971,3276
7,364,344,265,973,3276
8,411,362,255,1028,3276
9,398,380,251,1029,3276
10,379,402,277,1058,3276
11,382,418,286,1086,3276
1,500,200,50,750,3277
2,467,224,87,778,3277
3,456,243,129,828,3277
4,426,274,148,848,3277
5,452,282,186,920,3277
6,447,333,188,968,3277
7,405,354,216,975,3277
8,404,370,223,997,3277
9,404,389,239,1032,3277
10,434,395,250,1079,3277
11,408,412,269,1089,3277
1,500,200,50,750,3278
2,467,231,95,793,3278
3,428,261,133,822,3278
4,419,279,159,857,3278
5,432,308,185,925,3278
6,420,330,206,956,3278
7,406,333,238,977,3278
8,378,379,256,1013,3278
9,392,386,245,1023,3278
10,406,409,266,1081,3278
11,399,432,253,1084,3278
1,500,200,50,750,3279
2,453,216,105,774,3279
3,432,253,138,823,3279
4,407,285,164,856,3279
5,410,316,198,924,3279
6,417,325,209,951,3279
7,427,336,221,984,3279
8,412,354,240,1006,3279
9,411,379,248,1038,3279
10,412,407,248,1067,3279
11,409,418,270,1097,3279
1,500,200,50,750,3280
2,442,231,104,777,3280
3,426,253,147,826,3280
4,395,279,173,847,3280
5,425,303,194,922,3280
6,410,325,236,971,3280
7,399,337,246,982,3280
8,400,363,240,1003,3280
9,388,386,247,1021,3280
10,391,403,256,1050,3280
11,398,408,282,1088,3280
1,500,200,50,750,3281
2,459,221,93,773,3281
3,460,242,108,810,3281
4,453,270,137,860,3281
5,428,306,159,893,3281
6,425,329,194,948,3281
7,428,337,215,980,3281
8,414,347,238,999,3281
9,393,372,254,1019,3281
10,392,386,279,1057,3281
11,415,413,267,1095,3281
1,500,200,50,750,3282
2,447,235,112,794,3282
3,413,268,153,834,3282
4,421,291,175,887,3282
5,399,313,197,909,3282
6,397,345,210,952,3282
7,396,354,237,987,3282
8,389,361,246,996,3282
9,417,380,253,1050,3282
10,384,380,273,1037,3282
11,406,422,267,1095,3282
1,500,200,50,750,3283
2,473,212,102,787,3283
3,440,244,140,824,3283
4,434,254,179,867,3283
5,428,300,189,917,3283
6,406,341,208,955,3283
7,398,341,238,977,3283
8,402,395,214,1011,3283
9,385,383,246,1014,3283
10,384,384,271,1039,3283
11,402,407,285,1094,3283
1,500,200,50,750,3284
2,465,224,106,795,3284
3,429,252,147,828,3284
4,422,287,166,875,3284
5,431,302,201,934,3284
6,396,327,218,941,3284
7,402,355,230,987,3284
8,386,345,259,990,3284
9,406,360,266,1032,3284
10,373,381,291,1045,3284
11,375,400,296,1071,3284
1,500,200,50,750,3285
2,451,243,101,795,3285
3,422,283,130,835,3285
4,403,284,172,859,3285
5,396,333,187,916,3285
6,414,365,191,970,3285
7,389,363,232,984,3285
8,395,386,234,1015,3285
9,382,382,260,1024,3285
10,411,370,271,1052,3285
11,403,397,274,1074,3285
1,500,200,50,750,3286
2,450,241,96,787,3286
3,419,278,132,829,3286
4,413,305,150,868,3286
5,415,317,181,913,3286
6,418,338,198,954,3286
7,393,364,218,975,3286
8,404,357,248,1009,3286
9,400,367,250,1017,3286
10,429,393,250,1072,3286
11,431,408,251,1090,3286
1,500,200,50,750,3287
2,447,229,109,785,3287
3,417,261,138,816,3287
4,394,293,174,861,3287
5,401,313,208,922,3287
6,404,352,204,960,3287
7,399,361,225,985,3287
8,393,358,242,993,3287
9,391,385,267,1043,3287
10,388,375,293,1056,3287
11,384,389,312,1085,3287
1,500,200,50,750,3288
2,461,221,104,786,3288
3,443,266,132,841,3288
4,413,281,186,880,3288
5,386,310,210,906,3288
6,417,329,221,967,3288
7,396,362,215,973,3288
8,376,401,229,1006,3288
9,360,408,264,1032,3288
10,353,433,272,1058,3288
11,350,428,285,1063,3288
1,500,200,50,750,3289
2,468,225,96,789,3289
3,425,272,127,824,3289
4,408,293,162,863,3289
5,399,303,187,889,3289
6,407,343,224,974,3289
7,397,352,225,974,3289
8,402,385,236,1023,3289
9,394,391,249,1034,3289
10,389,390,276,1055,3289
11,387,415,300,1102,3289
1,500,200,50,750,3290
2,464,231,99,794,3290
3,429,250,145,824,3290
4,421,253,177,851,3290
5,401,271,226,898,3290
6,420,303,231,954,3290
7,408,332,237,977,3290
8,409,346,246,1001,3290
9,419,374,249,1042,3290
10,403,396,268,1067,3290
11,408,396,275,1079,3290
1,500,200,50,750,3291
2,452,249,87,788,3291
3,438,263,128,829,3291
4,418,298,158,874,3291
5,422,316,172,910,3291
6,428,331,205,964,3291
7,393,357,231,981,3291
8,373,364,262,999,3291
9,383,385,262,1030,3291
10,387,384,281,1052,3291
11,373,404,299,1076,3291
1,500,200,50,750,3292
2,437,260,101,798,3292
3,415,276,148,839,3292
4,414,294,174,882,3292
5,410,316,196,922,3292
6,396,344,217,957,3292
7,420,341,236,997,3292
8,412,365,223,1000,3292
9,408,378,227,1013,3292
10,419,406,237,1062,3292
11,389,410,268,1067,3292
1,500,200,50,750,3293
2,452,243,93,788,3293
3,416,282,138,836,3293
4,408,290,167,865,3293
5,441,303,174,918,3293
6,414,313,221,948,3293
7,402,319,257,978,3293
8,398,350,245,993,3293
9,413,397,240,1050,3293
10,403,390,262,1055,3293
11,388,424,274,1086,3293
1,500,200,50,750,3294
2,452,236,105,793,3294
3,403,271,150,824,3294
4,414,291,165,870,3294
5,416,327,172,915,3294
6,420,332,206,958,3294
7,411,325,249,985,3294
8,395,346,258,999,3294
9,399,371,258,1028,3294
10,393,392,267,1052,3294
11,401,385,280,1066,3294
1,500,200,50,750,3295
2,449,262,82,793,3295
3,416,286,131,833,3295
4,382,308,162,852,3295
5,401,322,181,904,3295
6,390,358,189,937,3295
7,393,361,204,958,3295
8,424,346,251,1021,3295
9,404,370,242,1016,3295
10,413,392,261,1066,3295
11,398,420,253,1071,3295
1,500,200,50,750,3296
2,460,220,105,785,3296
3,436,252,141,829,3296
4,422,268,162,852,3296
5,421,314,178,913,3296
6,408,347,203,958,3296
7,397,358,216,971,3296
8,390,378,234,1002,3296
9,382,399,247,1028,3296
10,377,401,282,1060,3296
11,387,432,269,1088,3296
1,500,200,50,750,3297
2,447,247,85,779,3297
3,415,279,140,834,3297
4,409,288,158,855,3297
5,383,347,186,916,3297
6,385,359,224,968,3297
7,362,357,255,974,3297
8,397,357,271,1025,3297
9,384,361,279,1024,3297
10,376,385,269,1030,3297
11,413,395,267,1075,3297
1,500,200,50,750,3298
2,477,223,103,803,3298
3,438,262,124,824,3298
4,419,297,146,862,3298
5,408,325,180,913,3298
6,425,340,194,959,3298
7,424,343,220,987,3298
8,414,345,246,1005,3298
9,417,349,263,1029,3298
10,420,379,265,1064,3298
11,418,386,281,1085,3298
1,500,200,50,750,3299
2,456,227,100,783,3299
3,438,253,139,830,3299
4,425,295,163,883,3299
5,384,301,210,895,3299
6,412,324,225,961,3299
7,395,361,230,986,3299
8,389,383,235,1007,3299
9,390,382,248,1020,3299
10,396,393,271,1060,3299
11,403,395,282,1080,3299
1,500,200,50,750,3300
2,451,229,106,786,3300
3,422,261,136,819,3300
4,424,301,153,878,3300
5,396,312,193,901,3300
6,379,343,215,937,3300
7,374,364,236,974,3300
8,411,370,228,1009,3300
9,403,385,242,1030,3300
10,412,392,249,1053,3300
11,403,406,267,1076,3300
1,500,200,50,750,3301
2,469,233,106,808,3301
3,451,249,139,839,3301
4,427,289,156,872,3301
5,420,324,164,908,3301
6,424,361,182,967,3301
7,380,377,216,973,3301
8,384,372,243,999,3301
9,377,399,258,1034,3301
10,372,417,274,1063,3301
11,369,416,282,1067,3301
1,500,200,50,750,3302
2,463,235,91,789,3302
3,415,283,132,830,3302
4,418,298,157,873,3302
5,411,300,190,901,3302
6,391,320,234,945,3302
7,408,331,236,975,3302
8,409,347,252,1008,3302
9,404,380,237,1021,3302
10,408,409,219,1036,3302
11,427,419,241,1087,3302
1,500,200,50,750,3303
2,467,216,106,789,3303
3,432,258,141,831,3303
4,415,286,169,870,3303
5,439,308,189,936,3303
6,416,311,224,951,3303
7,432,330,240,1002,3303
8,401,356,237,994,3303
9,406,359,253,1018,3303
10,426,374,265,1065,3303
11,431,373,288,1092,3303
1,500,200,50,750,3304
2,459,228,95,782,3304
3,437,244,131,812,3304
4,417,284,157,858,3304
5,432,290,193,915,3304
6,409,322,214,945,3304
7,425,338,234,997,3304
8,393,366,239,998,3304
9,381,402,231,1014,3304
10,407,393,247,1047,3304
11,431,410,249,1090,3304
1,500,200,50,750,3305
2,470,216,108,794,3305
3,437,256,141,834,3305
4,417,298,160,875,3305
5,404,315,198,917,3305
6,411,354,205,970,3305
7,395,368,224,987,3305
8,389,371,244,1004,3305
9,381,398,252,1031,3305
10,391,416,250,1057,3305
11,404,408,278,1090,3305
1,500,200,50,750,3306
2,463,229,105,797,3306
3,434,252,150,836,3306
4,417,273,181,871,3306
5,421,302,178,901,3306
6,410,326,218,954,3306
7,428,343,213,984,3306
8,407,362,233,1002,3306
9,398,385,234,1017,3306
10,402,402,263,1067,3306
11,387,417,280,1084,3306
1,500,200,50,750,3307
2,459,222,112,793,3307
3,431,247,150,828,3307
4,410,278,166,854,3307
5,412,304,184,900,3307
6,411,329,212,952,3307
7,365,373,224,962,3307
8,374,374,252,1000,3307
9,394,383,261,1038,3307
10,400,375,277,1052,3307
11,398,411,276,1085,3307
1,500,200,50,750,3308
2,449,222,105,776,3308
3,402,285,142,829,3308
4,377,298,190,865,3308
5,375,328,202,905,3308
6,400,350,212,962,3308
7,387,378,211,976,3308
8,397,387,219,1003,3308
9,377,391,261,1029,3308
10,398,384,271,1053,3308
11,379,409,270,1058,3308
1,500,200,50,750,3309
2,470,216,90,776,3309
3,431,269,123,823,3309
4,409,288,171,868,3309
5,403,327,187,917,3309
6,414,339,213,966,3309
7,393,370,222,985,3309
8,373,392,236,1001,3309
9,393,376,269,1038,3309
10,391,415,260,1066,3309
11,388,398,295,1081,3309
1,500,200,50,750,3310
2,448,229,106,783,3310
3,438,261,146,845,3310
4,408,288,157,853,3310
5,414,345,168,927,3310
6,412,356,192,960,3310
7,407,355,219,981,3310
8,395,358,252,1005,3310
9,393,382,264,1039,3310
10,369,417,276,1062,3310
11,382,427,280,1089,3310
1,500,200,50,750,3311
2,462,230,101,793,3311
3,435,261,135,831,3311
4,424,269,167,860,3311
5,406,304,199,909,3311
6,414,314,217,945,3311
7,427,325,227,979,3311
8,428,341,227,996,3311
9,384,372,251,1007,3311
10,411,383,270,1064,3311
11,404,384,279,1067,3311
1,500,200,50,750,3312
2,468,234,90,792,3312
3,432,256,139,827,3312
4,411,279,176,866,3312
5,408,305,202,915,3312
6,405,352,206,963,3312
7,390,360,241,991,3312
8,363,396,235,994,3312
9,400,386,253,1039,3312
10,399,392,275,1066,3312
11,395,408,278,1081,3312
1,500,200,50,750,3313
2,438,235,98,771,3313
3,437,285,138,860,3313
4,398,306,165,869,3313
5,385,324,200,909,3313
6,404,348,222,974,3313
7,380,369,234,983,3313
8,400,353,255,1008,3313
9,417,363,252,1032,3313
10,430,375,254,1059,3313
11,422,410,254,1086,3313
1,500,200,50,750,3314
2,447,233,99,779,3314
3,428,262,120,810,3314
4,442,294,144,880,3314
5,404,302,181,887,3314
6,406,328,214,948,3314
7,400,355,232,987,3314
8,386,385,253,1024,3314
9,383,389,262,1034,3314
10,407,403,252,1062,3314
11,420,382,279,1081,3314
1,500,200,50,750,3315
2,444,249,101,794,3315
3,420,288,116,824,3315
4,411,295,159,865,3315
5,408,315,192,915,3315
6,402,341,213,956,3315
7,405,355,221,981,3315
8,416,361,243,1020,3315
9,396,380,243,1019,3315
10,407,414,245,1066,3315
11,399,414,268,1081,3315
1,500,200,50,750,3316
2,472,223,106,801,3316
3,432,262,141,835,3316
4,414,265,179,858,3316
5,424,299,183,906,3316
6,398,331,224,953,3316
7,376,376,227,979,3316
8,381,365,269,1015,3316
9,382,365,279,1026,3316
10,382,379,286,1047,3316
11,416,362,320,1098,3316
1,500,200,50,750,3317
2,467,235,86,788,3317
3,435,244,139,818,3317
4,416,256,172,844,3317
5,418,287,186,891,3317
6,432,302,219,953,3317
7,428,339,225,992,3317
8,400,372,246,1018,3317
9,402,389,246,1037,3317
10,388,397,265,1050,3317
11,392,411,281,1084,3317
1,500,200,50,750,3318
2,474,225,106,805,3318
3,451,249,132,832,3318
4,419,293,154,866,3318
5,386,350,187,923,3318
6,397,366,203,966,3318
7,389,376,220,985,3318
8,384,373,242,999,3318
9,405,399,242,1046,3318
10,407,413,248,1068,3318
11,406,405,262,1073,3318
1,500,200,50,750,3319
2,431,257,93,781,3319
3,422,274,140,836,3319
4,397,293,174,864,3319
5,391,343,182,916,3319
6,410,350,205,965,3319
7,397,355,226,978,3319
8,400,369,228,997,3319
9,417,372,249,1038,3319
10,396,374,275,1045,3319
11,432,417,277,1126,3319
1,500,200,50,750,3320
2,472,216,115,803,3320
3,418,241,170,829,3320
4,399,291,197,887,3320
5,385,313,207,905,3320
6,392,346,227,965,3320
7,381,365,240,986,3320
8,387,348,266,1001,3320
9,362,391,264,1017,3320
10,381,406,257,1044,3320
11,392,406,285,1083,3320
1,500,200,50,750,3321
2,467,231,91,789,3321
3,435,277,116,828,3321
4,418,278,170,866,3321
5,413,309,188,910,3321
6,421,334,215,970,3321
7,395,344,244,983,3321
8,384,368,256,1008,3321
9,364,387,280,1031,3321
10,386,395,285,1066,3321
11,389,429,273,1091,3321
1,500,200,50,750,3322
2,436,220,124,780,3322
3,428,254,146,828,3322
4,397,297,159,853,3322
5,384,329,174,887,3322
6,403,358,200,961,3322
7,375,369,235,979,3322
8,365,393,253,1011,3322
9,356,406,260,1022,3322
10,375,410,259,1044,3322
11,392,424,255,1071,3322
1,500,200,50,750,3323
2,466,231,94,791,3323
3,434,267,135,836,3323
4,400,284,177,861,3323
5,415,277,209,901,3323
6,404,318,226,948,3323
7,376,339,239,954,3323
8,399,367,250,1016,3323
9,391,374,252,1017,3323
10,401,403,263,1067,3323
11,398,410,280,1088,3323
1,500,200,50,750,3324
2,438,248,94,780,3324
3,404,269,140,813,3324
4,393,301,174,868,3324
5,386,328,192,906,3324
6,388,363,214,965,3324
7,393,364,226,983,3324
8,386,402,229,1017,3324
9,377,425,240,1042,3324
10,376,411,269,1056,3324
11,384,414,285,1083,3324
1,500,200,50,750,3325
2,454,251,93,798,3325
3,398,293,133,824,3325
4,398,318,157,873,3325
5,394,333,191,918,3325
6,402,322,207,931,3325
7,415,336,226,977,3325
8,411,328,239,978,3325
9,419,350,255,1024,3325
10,423,353,273,1049,3325
11,456,363,274,1093,3325
1,500,200,50,750,3326
2,464,227,96,787,3326
3,439,245,140,824,3326
4,435,255,169,859,3326
5,423,284,192,899,3326
6,403,322,204,929,3326
7,425,349,225,999,3326
8,404,365,235,1004,3326
9,388,374,265,1027,3326
10,386,392,273,1051,3326
11,416,393,277,1086,3326
1,500,200,50,750,3327
2,463,220,97,780,3327
3,441,266,118,825,3327
4,391,304,174,869,3327
5,396,326,187,909,3327
6,409,345,202,956,3327
7,408,350,224,982,3327
8,399,371,241,1011,3327
9,386,395,256,1037,3327
10,406,381,275,1062,3327
11,401,387,267,1055,3327
1,500,200,50,750,3328
2,445,243,105,793,3328
3,427,267,139,833,3328
4,399,276,177,852,3328
5,402,329,188,919,3328
6,394,338,213,945,3328
7,412,361,222,995,3328
8,408,364,238,1010,3328
9,405,374,250,1029,3328
10,417,383,262,1062,3328
11,413,399,259,1071,3328
1,500,200,50,750,3329
2,460,222,102,784,3329
3,436,264,133,833,3329
4,438,267,165,870,3329
5,432,289,181,902,3329
6,431,323,196,950,3329
7,412,348,214,974,3329
8,429,353,218,1000,3329
9,404,389,229,1022,3329
10,427,400,253,1080,3329
11,395,430,252,1077,3329
1,500,200,50,750,3330
2,458,243,88,789,3330
3,417,279,132,828,3330
4,417,298,153,868,3330
5,395,323,181,899,3330
6,413,347,201,961,3330
7,418,331,239,988,3330
8,388,356,254,998,3330
9,396,398,254,1048,3330
10,389,420,258,1067,3330
11,368,427,281,1076,3330
1,500,200,50,750,3331
2,461,222,101,784,3331
3,441,263,134,838,3331
4,420,277,178,875,3331
5,414,303,194,911,3331
6,397,316,229,942,3331
7,406,343,237,986,3331
8,406,367,229,1002,3331
9,391,374,249,1014,3331
10,403,386,266,1055,3331
11,417,382,278,1077,3331
1,500,200,50,750,3332
2,463,218,105,786,3332
3,421,278,139,838,3332
4,396,273,181,850,3332
5,396,335,190,921,3332
6,388,355,204,947,3332
7,413,355,207,975,3332
8,412,370,219,1001,3332
9,435,374,230,1039,3332
10,427,391,239,1057,3332
11,409,416,264,1089,3332
1,500,200,50,750,3333
2,468,218,105,791,3333
3,423,270,139,832,3333
4,411,290,160,861,3333
5,402,324,191,917,3333
6,389,332,218,939,3333
7,381,361,232,974,3333
8,389,382,238,1009,3333
9,393,389,237,1019,3333
10,375,414,256,1045,3333
11,409,404,269,1082,3333
1,500,200,50,750,3334
2,470,215,106,791,3334
3,445,227,157,829,3334
4,447,262,171,880,3334
5,438,304,184,926,3334
6,434,313,188,935,3334
7,421,339,210,970,3334
8,425,360,226,1011,3334
9,429,362,238,1029,3334
10,421,376,250,1047,3334
11,407,402,267,1076,3334
1,500,200,50,750,3335
2,445,238,99,782,3335
3,437,260,137,834,3335
4,410,296,157,863,3335
5,422,307,182,911,3335
6,413,332,200,945,3335
7,392,356,229,977,3335
8,386,387,247,1020,3335
9,377,401,244,1022,3335
10,414,397,262,1073,3335
11,407,411,263,1081,3335
1,500,200,50,750,3336
2,465,225,95,785,3336
3,439,274,123,836,3336
4,427,311,142,880,3336
5,392,342,175,909,3336
6,424,349,205,978,3336
7,423,331,221,975,3336
8,427,342,234,1003,3336
9,437,354,240,1031,3336
10,426,383,251,1060,3336
11,405,393,268,1066,3336
1,500,200,50,750,3337
2,454,224,103,781,3337
3,430,272,133,835,3337
4,425,282,168,875,3337
5,416,297,197,910,3337
6,435,321,221,977,3337
7,404,352,227,983,3337
8,397,369,234,1000,3337
9,375,394,257,1026,3337
10,388,402,269,1059,3337
11,389,415,277,1081,3337
1,500,200,50,750,3338
2,463,235,96,794,3338
3,438,276,128,842,3338
4,421,294,156,871,3338
5,422,333,174,929,3338
6,416,343,204,963,3338
7,412,353,223,988,3338
8,398,372,230,1000,3338
9,382,394,252,1028,3338
10,379,417,254,1050,3338
11,408,422,271,1101,3338
1,500,200,50,750,3339
2,449,243,94,786,3339
3,411,267,136,814,3339
4,413,305,156,874,3339
5,410,302,193,905,3339
6,427,326,207,960,3339
7,413,340,214,967,3339
8,422,357,236,1015,3339
9,415,388,230,1033,3339
10,405,397,260,1062,3339
11,410,400,284,1094,3339
1,500,200,50,750,3340
2,470,223,94,787,3340
3,459,253,128,840,3340
4,431,256,176,863,3340
5,420,295,188,903,3340
6,424,324,213,961,3340
7,388,355,246,989,3340
8,373,369,254,996,3340
9,383,382,278,1043,3340
10,357,390,302,1049,3340
11,373,410,316,1099,3340
1,500,200,50,750,3341
2,459,234,94,787,3341
3,445,248,135,828,3341
4,413,273,169,855,3341
5,404,312,186,902,3341
6,390,364,219,973,3341
7,372,380,234,986,3341
8,382,390,243,1015,3341
9,361,397,249,1007,3341
10,376,422,259,1057,3341
11,374,420,274,1068,3341
1,500,200,50,750,3342
2,478,226,105,809,3342
3,431,243,141,815,3342
4,406,277,175,858,3342
5,395,311,206,912,3342
6,398,339,219,956,3342
7,404,344,222,970,3342
8,406,369,231,1006,3342
9,401,367,257,1025,3342
10,410,376,271,1057,3342
11,414,396,280,1090,3342
1,500,200,50,750,3343
2,466,220,101,787,3343
3,440,241,148,829,3343
4,442,270,173,885,3343
5,428,274,209,911,3343
6,430,291,235,956,3343
7,427,313,233,973,3343
8,417,336,233,986,3343
9,420,354,260,1034,3343
10,433,383,264,1080,3343
11,409,406,279,1094,3343
1,500,200,50,750,3344
2,446,250,90,786,3344
3,420,275,138,833,3344
4,418,300,161,879,3344
5,404,339,178,921,3344
6,391,357,207,955,3344
7,385,372,209,966,3344
8,377,371,238,986,3344
9,399,398,235,1032,3344
10,396,399,265,1060,3344
11,390,409,282,1081,3344
1,500,200,50,750,3345
2,471,232,86,789,3345
3,439,275,124,838,3345
4,423,302,151,876,3345
5,404,356,158,918,3345
6,406,337,201,944,3345
7,370,387,216,973,3345
8,362,394,221,977,3345
9,375,383,264,1022,3345
10,399,402,258,1059,3345
11,406,411,265,1082,3345
1,500,200,50,750,3346
2,455,250,97,802,3346
3,408,257,158,823,3346
4,387,308,175,870,3346
5,412,325,183,920,3346
6,410,326,202,938,3346
7,409,351,218,978,3346
8,398,370,227,995,3346
9,401,366,253,1020,3346
10,401,369,278,1048,3346
11,383,399,299,1081,3346
1,500,200,50,750,3347
2,453,234,101,788,3347
3,435,265,127,827,3347
4,424,282,168,874,3347
5,428,313,177,918,3347
6,431,347,196,974,3347
7,403,354,223,980,3347
8,398,344,246,988,3347
9,424,358,258,1040,3347
10,417,384,258,1059,3347
11,420,382,279,1081,3347
1,500,200,50,750,3348
2,445,250,83,778,3348
3,420,287,122,829,3348
4,415,310,149,874,3348
5,419,345,155,919,3348
6,401,365,173,939,3348
7,383,381,201,965,3348
8,389,398,219,1006,3348
9,378,408,239,1025,3348
10,394,411,254,1059,3348
11,397,409,283,1089,3348
1,500,200,50,750,3349
2,464,230,89,783,3349
3,436,281,118,835,3349
4,422,287,165,874,3349
5,429,306,186,921,3349
6,434,328,194,956,3349
7,407,366,201,974,3349
8,400,384,223,1007,3349
9,394,392,246,1032,3349
10,409,409,254,1072,3349
11,409,421,250,1080,3349
1,500,200,50,750,3350
2,452,237,102,791,3350
3,405,255,150,810,3350
4,417,306,168,891,3350
5,381,312,215,908,3350
6,361,338,230,929,3350
7,379,366,234,979,3350
8,382,399,237,1018,3350
9,382,407,243,1032,3350
10,375,424,259,1058,3350
11,379,405,295,1079,3350
1,500,200,50,750,3351
2,448,236,88,772,3351
3,417,264,133,814,3351
4,417,316,150,883,3351
5,383,344,191,918,3351
6,389,356,201,946,3351
7,385,357,250,992,3351
8,364,369,269,1002,3351
9,360,389,279,1028,3351
10,366,406,289,1061,3351
11,362,413,303,1078,3351
1,500,200,50,750,3352
2,453,235,101,789,3352
3,440,239,144,823,3352
4,431,265,168,864,3352
5,437,297,189,923,3352
6,437,314,200,951,3352
7,422,337,208,967,3352
8,434,352,231,1017,3352
9,424,375,237,1036,3352
10,389,404,258,1051,3352
11,416,386,286,1088,3352
1,500,200,50,750,3353
2,461,226,100,787,3353
3,437,247,141,825,3353
4,402,279,176,857,3353
5,386,332,186,904,3353
6,387,351,203,941,3353
7,393,365,234,992,3353
8,382,362,255,999,3353
9,391,381,253,1025,3353
10,416,365,267,1048,3353
11,435,395,267,1097,3353
1,500,200,50,750,3354
2,461,221,104,786,3354
3,444,245,123,812,3354
4,433,270,159,862,3354
5,401,290,191,882,3354
6,406,358,192,956,3354
7,400,371,207,978,3354
8,382,392,233,1007,3354
9,407,398,229,1034,3354
10,403,411,247,1061,3354
11,378,426,268,1072,3354
1,500,200,50,750,3355
2,481,216,101,798,3355
3,432,239,147,818,3355
4,400,283,180,863,3355
5,396,318,204,918,3355
6,388,351,219,958,3355
7,403,361,228,992,3355
8,379,362,237,978,3355
9,399,387,238,1024,3355
10,409,414,243,1066,3355
11,392,431,249,1072,3355
1,500,200,50,750,3356
2,467,236,95,798,3356
3,432,254,141,827,3356
4,403,294,177,874,3356
5,401,314,201,916,3356
6,387,339,222,948,3356
7,395,362,238,995,3356
8,371,366,256,993,3356
9,380,386,272,1038,3356
10,383,390,281,1054,3356
11,398,400,292,1090,3356
1,500,200,50,750,3357
2,439,242,98,779,3357
3,438,265,132,835,3357
4,419,290,156,865,3357
5,403,314,181,898,3357
6,408,330,208,946,3357
7,418,325,222,965,3357
8,405,371,241,1017,3357
9,383,394,247,1024,3357
10,365,409,263,1037,3357
11,393,417,290,1100,3357
1,500,200,50,750,3358
2,469,229,88,786,3358
3,436,272,119,827,3358
4,437,296,153,886,3358
5,390,326,180,896,3358
6,409,314,234,957,3358
7,412,347,220,979,3358
8,431,346,241,1018,3358
9,415,363,256,1034,3358
10,408,370,272,1050,3358
11,424,390,270,1084,3358
1,500,200,50,750,3359
2,449,261,89,799,3359
3,408,275,143,826,3359
4,389,303,156,848,3359
5,388,325,196,909,3359
6,405,355,214,974,3359
7,380,369,225,974,3359
8,395,394,237,1026,3359
9,386,380,256,1022,3359
10,391,422,241,1054,3359
11,404,413,269,1086,3359
1,500,200,50,750,3360
2,437,244,112,793,3360
3,412,284,133,829,3360
4,399,297,164,860,3360
5,387,337,179,903,3360
6,389,362,204,955,3360
7,392,362,227,981,3360
8,394,382,231,1007,3360
9,391,388,241,1020,3360
10,389,411,251,1051,3360
11,392,438,252,1082,3360
1,500,200,50,750,3361
2,453,238,89,780,3361
3,474,238,139,851,3361
4,456,271,154,881,3361
5,436,301,179,916,3361
6,419,332,194,945,3361
7,412,342,224,978,3361
8,391,361,241,993,3361
9,396,383,263,1042,3361
10,385,407,273,1065,3361
11,395,411,283,1089,3361
1,500,200,50,750,3362
2,468,235,92,795,3362
3,448,256,126,830,3362
4,413,288,157,858,3362
5,409,307,178,894,3362
6,401,340,209,950,3362
7,403,360,225,988,3362
8,386,368,250,1004,3362
9,369,390,267,1026,3362
10,386,403,267,1056,3362
11,404,408,279,1091,3362
1,500,200,50,750,3363
2,454,244,94,792,3363
3,440,263,133,836,3363
4,435,271,161,867,3363
5,413,280,199,892,3363
6,419,320,209,948,3363
7,414,352,218,984,3363
8,410,393,218,1021,3363
9,410,389,231,1030,3363
10,411,380,279,1070,3363
11,413,404,275,1092,3363
1,500,200,50,750,3364
2,441,237,99,777,3364
3,405,288,142,835,3364
4,386,288,183,857,3364
5,394,317,194,905,3364
6,400,346,210,956,3364
7,390,357,231,978,3364
8,378,391,239,1008,3364
9,384,369,271,1024,3364
10,399,411,253,1063,3364
11,388,420,273,1081,3364
1,500,200,50,750,3365
2,454,243,95,792,3365
3,410,293,131,834,3365
4,409,302,150,861,3365
5,439,325,163,927,3365
6,443,350,184,977,3365
7,419,344,198,961,3365
8,422,355,219,996,3365
9,432,388,228,1048,3365
10,406,401,255,1062,3365
11,416,409,259,1084,3365
1,500,200,50,750,3366
2,450,230,101,781,3366
3,454,252,125,831,3366
4,420,288,162,870,3366
5,418,302,184,904,3366
6,391,361,196,948,3366
7,391,347,240,978,3366
8,398,364,249,1011,3366
9,431,358,250,1039,3366
10,413,390,265,1068,3366
11,389,410,265,1064,3366
1,500,200,50,750,3367
2,460,260,86,806,3367
3,429,261,127,817,3367
4,411,287,160,858,3367
5,400,317,201,918,3367
6,390,346,218,954,3367
7,404,361,227,992,3367
8,383,375,251,1009,3367
9,396,372,270,1038,3367
10,384,387,290,1061,3367
11,399,418,264,1081,3367
1,500,200,50,750,3368
2,454,237,89,780,3368
3,422,269,132,823,3368
4,414,308,156,878,3368
5,398,335,191,924,3368
6,395,334,236,965,3368
7,359,369,250,978,3368
8,364,376,262,1002,3368
9,381,370,272,1023,3368
10,397,407,259,1063,3368
11,378,427,269,1074,3368
1,500,200,50,750,3369
2,475,225,91,791,3369
3,433,268,129,830,3369
4,419,288,172,879,3369
5,403,304,202,909,3369
6,398,348,208,954,3369
7,393,357,227,977,3369
8,380,393,210,983,3369
9,407,420,218,1045,3369
10,400,405,254,1059,3369
11,410,407,272,1089,3369
1,500,200,50,750,3370
2,442,248,107,797,3370
3,401,255,167,823,3370
4,409,306,153,868,3370
5,409,345,176,930,3370
6,401,366,197,964,3370
7,390,378,214,982,3370
8,401,378,226,1005,3370
9,392,349,261,1002,3370
10,404,371,275,1050,3370
11,402,368,275,1045,3370
1,500,200,50,750,3371
2,475,231,88,794,3371
3,440,254,124,818,3371
4,420,298,157,875,3371
5,410,333,173,916,3371
6,428,344,206,978,3371
7,380,359,225,964,3371
8,393,363,261,1017,3371
9,385,367,285,1037,3371
10,373,389,285,1047,3371
11,406,415,268,1089,3371
1,500,200,50,750,3372
2,467,226,92,785,3372
3,421,264,129,814,3372
4,413,317,135,865,3372
5,428,335,172,935,3372
6,406,353,201,960,3372
7,379,375,230,984,3372
8,384,379,249,1012,3372
9,372,409,236,1017,3372
10,386,417,254,1057,3372
11,390,403,284,1077,3372
1,500,200,50,750,3373
2,454,235,95,784,3373
3,412,287,131,830,3373
4,424,286,160,870,3373
5,410,307,183,900,3373
6,405,332,198,935,3373
7,412,359,223,994,3373
8,406,377,231,1014,3373
9,401,385,255,1041,3373
10,415,397,260,1072,3373
11,412,392,288,1092,3373
1,500,200,50,750,3374
2,468,243,85,796,3374
3,421,275,124,820,3374
4,400,313,151,864,3374
5,394,326,187,907,3374
6,415,345,206,966,3374
7,396,379,219,994,3374
8,399,382,227,1008,3374
9,385,390,260,1035,3374
10,369,380,288,1037,3374
11,391,401,291,1083,3374
1,500,200,50,750,3375
2,465,240,87,792,3375
3,427,273,125,825,3375
4,408,305,155,868,3375
5,410,329,176,915,3375
6,413,364,195,972,3375
7,391,370,233,994,3375
8,390,378,252,1020,3375
9,372,376,255,1003,3375
10,391,427,260,1078,3375
11,386,419,275,1080,3375
1,500,200,50,750,3376
2,471,225,97,793,3376
3,450,243,134,827,3376
4,434,278,156,868,3376
5,428,304,186,918,3376
6,414,342,207,963,3376
7,395,346,230,971,3376
8,395,355,251,1001,3376
9,411,362,259,1032,3376
10,395,376,278,1049,3376
11,418,417,263,1098,3376
1,500,200,50,750,3377
2,454,242,93,789,3377
3,424,280,120,824,3377
4,392,308,147,847,3377
5,393,335,168,896,3377
6,417,352,191,960,3377
7,394,371,221,986,3377
8,382,393,234,1009,3377
9,391,388,257,1036,3377
10,373,417,275,1065,3377
11,374,423,287,1084,3377
1,500,200,50,750,3378
2,452,238,92,782,3378
3,443,259,129,831,3378
4,423,295,143,861,3378
5,428,300,170,898,3378
6,423,332,199,954,3378
7,405,347,237,989,3378
8,422,364,245,1031,3378
9,392,367,270,1029,3378
10,397,389,266,1052,3378
11,413,415,258,1086,3378
1,500,200,50,750,3379
2,460,229,103,792,3379
3,425,257,144,826,3379
4,408,296,164,868,3379
5,408,338,183,929,3379
6,395,354,204,953,3379
7,388,378,204,970,3379
8,384,393,229,1006,3379
9,373,386,253,1012,3379
10,385,398,257,1040,3379
11,408,398,285,1091,3379
1,500,200,50,750,3380
2,443,254,100,797,3380
3,409,265,143,817,3380
4,416,280,169,865,3380
5,423,315,187,925,3380
6,419,347,199,965,3380
7,387,354,229,970,3380
8,386,355,255,996,3380
9,409,356,255,1020,3380
10,414,376,251,1041,3380
11,433,384,265,1082,3380
1,500,200,50,750,3381
2,448,240,98,786,3381
3,422,274,139,835,3381
4,403,293,177,873,3381
5,386,319,215,920,3381
6,389,357,217,963,3381
7,381,375,227,983,3381
8,381,372,249,1002,3381
9,368,405,246,1019,3381
10,389,388,293,1070,3381
11,391,386,296,1073,3381
1,500,200,50,750,3382
2,467,233,88,788,3382
3,429,260,146,835,3382
4,420,287,162,869,3382
5,413,302,190,905,3382
6,404,343,208,955,3382
7,392,393,220,1005,3382
8,402,358,240,1000,3382
9,400,386,246,1032,3382
10,402,425,241,1068,3382
11,391,433,261,1085,3382
1,500,200,50,750,3383
2,458,241,93,792,3383
3,430,253,135,818,3383
4,411,303,150,864,3383
5,404,330,190,924,3383
6,388,357,215,960,3383
7,376,371,237,984,3383
8,386,360,258,1004,3383
9,383,364,279,1026,3383
10,398,385,272,1055,3383
11,397,413,277,1087,3383
1,500,200,50,750,3384
2,439,227,102,768,3384
3,424,242,159,825,3384
4,426,270,174,870,3384
5,423,281,195,899,3384
6,426,312,198,936,3384
7,425,350,215,990,3384
8,406,361,242,1009,3384
9,394,353,287,1034,3384
10,388,383,265,1036,3384
11,382,388,297,1067,3384
1,500,200,50,750,3385
2,454,233,110,797,3385
3,416,264,142,822,3385
4,427,290,168,885,3385
5,401,317,189,907,3385
6,394,342,219,955,3385
7,391,348,238,977,3385
8,398,339,263,1000,3385
9,413,360,262,1035,3385
10,403,369,277,1049,3385
11,414,377,286,1077,3385
1,500,200,50,750,3386
2,477,226,88,791,3386
3,448,252,128,828,3386
4,442,288,162,892,3386
5,427,303,189,919,3386
6,413,314,216,943,3386
7,392,355,226,973,3386
8,411,366,228,1005,3386
9,406,383,243,1032,3386
10,395,404,262,1061,3386
11,382,415,283,1080,3386
1,500,200,50,750,3387
2,450,241,92,783,3387
3,423,264,127,814,3387
4,404,285,159,848,3387
5,426,325,170,921,3387
6,418,344,183,945,3387
7,413,358,210,981,3387
8,392,376,258,1026,3387
9,375,432,233,1040,3387
10,376,412,268,1056,3387
11,388,417,276,1081,3387
1,500,200,50,750,3388
2,463,225,93,781,3388
3,445,258,123,826,3388
4,432,281,157,870,3388
5,412,288,195,895,3388
6,399,330,204,933,3388
7,400,370,221,991,3388
8,395,379,255,1029,3388
9,369,407,257,1033,3388
10,369,424,261,1054,3388
11,387,408,271,1066,3388
1,500,200,50,750,3389
2,466,229,93,788,3389
3,429,243,160,832,3389
4,416,274,176,866,3389
5,406,311,192,909,3389
6,406,345,209,960,3389
7,399,370,215,984,3389
8,380,379,237,996,3389
9,380,400,248,1028,3389
10,374,412,268,1054,3389
11,390,406,280,1076,3389
1,500,200,50,750,3390
2,461,228,96,785,3390
3,436,229,146,811,3390
4,392,290,171,853,3390
5,412,307,187,906,3390
6,403,326,217,946,3390
7,405,336,235,976,3390
8,419,359,232,1010,3390
9,421,356,261,1038,3390
10,424,382,254,1060,3390
11,414,408,269,1091,3390
1,500,200,50,750,3391
2,441,211,119,771,3391
3,419,243,164,826,3391
4,403,281,175,859,3391
5,409,307,202,918,3391
6,417,317,216,950,3391
7,420,331,225,976,3391
8,425,361,221,1007,3391
9,414,375,244,1033,3391
10,410,386,265,1061,3391
11,408,394,276,1078,3391
1,500,200,50,750,3392
2,440,246,110,796,3392
3,398,285,143,826,3392
4,388,295,185,868,3392
5,401,323,190,914,3392
6,412,359,197,968,3392
7,389,353,242,984,3392
8,376,374,260,1010,3392
9,370,381,281,1032,3392
10,381,411,270,1062,3392
11,386,414,289,1089,3392
1,500,200,50,750,3393
2,456,236,90,782,3393
3,442,264,125,831,3393
4,430,295,144,869,3393
5,415,300,199,914,3393
6,417,331,209,957,3393
7,406,335,235,976,3393
8,404,354,246,1004,3393
9,413,385,249,1047,3393
10,407,376,261,1044,3393
11,409,400,273,1082,3393
1,500,200,50,750,3394
2,433,254,103,790,3394
3,418,282,131,831,3394
4,387,303,175,865,3394
5,396,314,205,915,3394
6,384,347,226,957,3394
7,382,385,212,979,3394
8,388,388,234,1010,3394
9,406,395,236,1037,3394
10,423,388,247,1058,3394
11,405,424,253,1082,3394
1,500,200,50,750,3395
2,461,226,97,784,3395
3,434,253,142,829,3395
4,439,274,158,871,3395
5,418,304,186,908,3395
6,428,336,193,957,3395
7,394,358,214,966,3395
8,394,384,232,1010,3395
9,394,396,245,1035,3395
10,395,389,263,1047,3395
11,416,401,284,1101,3395
1,500,200,50,750,3396
2,450,248,93,791,3396
3,446,250,130,826,3396
4,430,278,158,866,3396
5,420,313,173,906,3396
6,404,346,212,962,3396
7,390,345,234,969,3396
8,417,350,249,1016,3396
9,401,380,247,1028,3396
10,404,377,280,1061,3396
11,411,407,267,1085,3396
1,500,200,50,750,3397
2,465,222,90,777,3397
3,436,262,132,830,3397
4,419,285,168,872,3397
5,405,303,198,906,3397
6,395,356,198,949,3397
7,385,360,230,975,3397
8,382,355,259,996,3397
9,385,362,270,1017,3397
10,376,396,276,1048,3397
11,394,404,282,1080,3397
1,500,200,50,750,3398
2,452,239,98,789,3398
3,419,275,127,821,3398
4,430,290,162,882,3398
5,420,292,190,902,3398
6,400,345,203,948,3398
7,399,369,225,993,3398
8,384,368,260,1012,3398
9,383,380,262,1025,3398
10,376,416,262,1054,3398
11,372,434,277,1083,3398
1,500,200,50,750,3399
2,473,238,94,805,3399
3,428,258,138,824,3399
4,417,278,166,861,3399
5,416,306,196,918,3399
6,402,316,242,960,3399
7,394,318,260,972,3399
8,395,350,267,1012,3399
9,383,374,276,1033,3399
10,388,387,290,1065,3399
11,379,411,293,1083,3399
1,500,200,50,750,3400
2,465,220,100,785,3400
3,447,255,125,827,3400
4,424,296,159,879,3400
5,406,321,186,913,3400
6,384,338,227,949,3400
7,383,361,246,990,3400
8,404,340,270,1014,3400
9,403,357,269,1029,3400
10,389,382,287,1058,3400
11,400,402,268,1070,3400
1,500,200,50,750,3401
2,457,227,97,781,3401
3,434,284,119,837,3401
4,395,318,150,863,3401
5,390,334,185,909,3401
6,401,357,211,969,3401
7,398,358,231,987,3401
8,390,363,244,997,3401
9,381,378,258,1017,3401
10,392,420,255,1067,3401
11,391,411,262,1064,3401
1,500,200,50,750,3402
2,444,242,100,786,3402
3,426,275,138,839,3402
4,391,298,171,860,3402
5,391,318,198,907,3402
6,386,347,231,964,3402
7,369,354,246,969,3402
8,376,360,263,999,3402
9,366,408,249,1023,3402
10,364,436,251,1051,3402
11,388,418,285,1091,3402
1,500,200,50,750,3403
2,452,220,117,789,3403
3,431,236,147,814,3403
4,431,277,173,881,3403
5,436,308,168,912,3403
6,440,326,201,967,3403
7,428,351,207,986,3403
8,409,387,208,1004,3403
9,385,401,237,1023,3403
10,373,408,258,1039,3403
11,398,433,274,1105,3403
1,500,200,50,750,3404
2,455,244,95,794,3404
3,423,255,149,827,3404
4,401,288,175,864,3404
5,394,324,196,914,3404
6,389,349,216,954,3404
7,385,370,226,981,3404
8,374,377,251,1002,3404
9,377,400,257,1034,3404
10,361,409,261,1031,3404
11,363,432,281,1076,3404
1,500,200,50,750,3405
2,460,223,111,794,3405
3,444,241,136,821,3405
4,417,275,158,850,3405
5,427,311,179,917,3405
6,422,351,200,973,3405
7,399,369,222,990,3405
8,379,374,255,1008,3405
9,395,391,250,1036,3405
10,411,368,281,1060,3405
11,417,395,277,1089,3405
1,500,200,50,750,3406
2,446,241,102,789,3406
3,422,252,141,815,3406
4,414,303,148,865,3406
5,397,339,181,917,3406
6,388,356,215,959,3406
7,400,372,229,1001,3406
8,385,391,240,1016,3406
9,370,394,265,1029,3406
10,378,420,261,1059,3406
11,378,429,263,1070,3406
1,500,200,50,750,3407
2,453,249,100,802,3407
3,419,281,130,830,3407
4,387,298,174,859,3407
5,417,329,179,925,3407
6,424,325,210,959,3407
7,430,317,230,977,3407
8,413,347,246,1006,3407
9,405,373,259,1037,3407
10,397,371,274,1042,3407
11,430,388,285,1103,3407
1,500,200,50,750,3408
2,464,233,94,791,3408
3,426,264,145,835,3408
4,383,279,186,848,3408
5,393,319,215,927,3408
6,404,344,205,953,3408
7,396,377,209,982,3408
8,389,386,213,988,3408
9,383,397,238,1018,3408
10,410,393,246,1049,3408
11,397,406,265,1068,3408
1,500,200,50,750,3409
2,452,240,92,784,3409
3,410,289,124,823,3409
4,381,322,162,865,3409
5,368,341,181,890,3409
6,399,377,191,967,3409
7,403,360,210,973,3409
8,385,382,231,998,3409
9,392,380,259,1031,3409
10,403,402,257,1062,3409
11,426,410,245,1081,3409
1,500,200,50,750,3410
2,461,230,88,779,3410
3,455,234,143,832,3410
4,415,287,166,868,3410
5,417,296,207,920,3410
6,413,339,218,970,3410
7,394,343,238,975,3410
8,406,370,234,1010,3410
9,394,390,249,1033,3410
10,411,383,267,1061,3410
11,390,402,282,1074,3410
1,500,200,50,750,3411
2,463,222,103,788,3411
3,433,262,147,842,3411
4,407,279,177,863,3411
5,431,295,194,920,3411
6,440,348,199,987,3411
7,399,364,217,980,3411
8,390,383,231,1004,3411
9,371,399,248,1018,3411
10,393,413,244,1050,3411
11,406,414,277,1097,3411
1,500,200,50,750,3412
2,450,229,92,771,3412
3,426,268,129,823,3412
4,440,303,142,885,3412
5,419,309,184,912,3412
6,411,325,215,951,3412
7,409,348,220,977,3412
8,411,393,232,1036,3412
9,412,373,245,1030,3412
10,416,382,265,1063,3412
11,401,408,270,1079,3412
1,500,200,50,750,3413
2,457,247,93,797,3413
3,408,282,137,827,3413
4,383,306,159,848,3413
5,404,328,187,919,3413
6,405,350,217,972,3413
7,403,342,244,989,3413
8,384,381,237,1002,3413
9,384,406,246,1036,3413
10,388,410,261,1059,3413
11,383,394,283,1060,3413
1,500,200,50,750,3414
2,451,229,117,797,3414
3,408,252,155,815,3414
4,403,277,186,866,3414
5,394,328,193,915,3414
6,393,372,201,966,3414
7,391,361,233,985,3414
8,387,375,245,1007,3414
9,404,386,239,1029,3414
10,406,406,246,1058,3414
11,420,414,254,1088,3414
1,500,200,50,750,3415
2,460,239,96,795,3415
3,404,285,129,818,3415
4,392,310,160,862,3415
5,389,352,191,932,3415
6,376,364,214,954,3415
7,370,362,240,972,3415
8,370,388,241,999,3415
9,374,384,264,1022,3415
10,367,413,271,1051,3415
11,378,435,277,1090,3415
1,500,200,50,750,3416
2,473,225,99,797,3416
3,436,260,128,824,3416
4,413,285,161,859,3416
5,424,331,179,934,3416
6,415,359,196,970,3416
7,409,378,210,997,3416
8,392,371,239,1002,3416
9,397,393,238,1028,3416
10,395,410,250,1055,3416
11,393,416,279,1088,3416
1,500,200,50,750,3417
2,457,242,93,792,3417
3,426,245,144,815,3417
4,405,269,184,858,3417
5,389,293,203,885,3417
6,418,339,211,968,3417
7,385,364,226,975,3417
8,378,379,234,991,3417
9,381,391,254,1026,3417
10,383,390,279,1052,3417
11,392,419,293,1104,3417
1,500,200,50,750,3418
2,457,243,91,791,3418
3,427,282,119,828,3418
4,385,315,167,867,3418
5,407,343,184,934,3418
6,397,369,191,957,3418
7,396,377,217,990,3418
8,403,381,233,1017,3418
9,383,402,246,1031,3418
10,376,407,266,1049,3418
11,397,415,284,1096,3418
1,500,200,50,750,3419
2,468,247,90,805,3419
3,443,261,127,831,3419
4,420,292,162,874,3419
5,411,337,174,922,3419
6,412,353,200,965,3419
7,405,350,237,992,3419
8,392,379,245,1016,3419
9,384,396,250,1030,3419
10,387,408,267,1062,3419
11,401,420,261,1082,3419
1,500,200,50,750,3420
2,463,223,105,791,3420
3,446,245,137,828,3420
4,436,275,154,865,3420
5,413,304,184,901,3420
6,394,332,224,950,3420
7,389,334,248,971,3420
8,403,370,236,1009,3420
9,394,368,263,1025,3420
10,401,394,270,1065,3420
11,369,421,288,1078,3420
1,500,200,50,750,3421
2,476,224,87,787,3421
3,444,245,139,828,3421
4,400,274,188,862,3421
5,406,307,188,901,3421
6,416,333,209,958,3421
7,402,372,211,985,3421
8,410,376,222,1008,3421
9,428,376,238,1042,3421
10,431,379,253,1063,3421
11,414,409,260,1083,3421
1,500,200,50,750,3422
2,451,246,93,790,3422
3,439,264,122,825,3422
4,432,306,139,877,3422
5,419,324,164,907,3422
6,410,356,190,956,3422
7,415,371,198,984,3422
8,393,385,221,999,3422
9,405,391,233,1029,3422
10,407,401,250,1058,3422
11,423,402,251,1076,3422
1,500,200,50,750,3423
2,452,245,95,792,3423
3,426,268,135,829,3423
4,410,294,165,869,3423
5,403,309,201,913,3423
6,419,327,207,953,3423
7,414,326,230,970,3423
8,420,344,231,995,3423
9,426,373,252,1051,3423
10,400,389,267,1056,3423
11,410,418,269,1097,3423
1,500,200,50,750,3424
2,444,242,89,775,3424
3,419,268,140,827,3424
4,398,278,186,862,3424
5,395,317,195,907,3424
6,401,335,219,955,3424
7,398,341,243,982,3424
8,408,335,269,1012,3424
9,414,363,258,1035,3424
10,416,369,274,1059,3424
11,424,384,290,1098,3424
1,500,200,50,750,3425
2,467,237,91,795,3425
3,427,263,142,832,3425
4,412,291,173,876,3425
5,413,316,186,915,3425
6,415,335,199,949,3425
7,415,351,228,994,3425
8,401,357,252,1010,3425
9,396,375,240,1011,3425
10,409,401,238,1048,3425
11,427,413,247,1087,3425
1,500,200,50,750,3426
2,465,223,105,793,3426
3,430,257,150,837,3426
4,410,286,172,868,3426
5,398,308,192,898,3426
6,423,332,197,952,3426
7,397,371,222,990,3426
8,405,375,230,1010,3426
9,396,398,235,1029,3426
10,395,409,256,1060,3426
11,411,408,266,1085,3426
1,500,200,50,750,3427
2,460,233,84,777,3427
3,443,250,133,826,3427
4,429,290,142,861,3427
5,440,305,166,911,3427
6,433,300,207,940,3427
7,414,342,220,976,3427
8,426,365,219,1010,3427
9,396,385,250,1031,3427
10,399,401,257,1057,3427
11,392,398,273,1063,3427
1,500,200,50,750,3428
2,455,235,104,794,3428
3,430,249,150,829,3428
4,427,270,176,873,3428
5,417,298,202,917,3428
6,412,331,199,942,3428
7,416,359,212,987,3428
8,400,358,239,997,3428
9,425,378,256,1059,3428
10,391,388,284,1063,3428
11,397,401,296,1094,3428
1,500,200,50,750,3429
2,464,216,116,796,3429
3,439,261,128,828,3429
4,430,295,151,876,3429
5,428,314,174,916,3429
6,422,321,212,955,3429
7,432,339,227,998,3429
8,400,357,228,985,3429
9,401,388,234,1023,3429
10,414,415,242,1071,3429
11,429,398,258,1085,3429
1,500,200,50,750,3430
2,452,245,96,793,3430
3,418,246,145,809,3430
4,407,286,168,861,3430
5,412,326,181,919,3430
6,408,349,194,951,3430
7,414,326,248,988,3430
8,411,341,259,1011,3430
9,422,369,230,1021,3430
10,422,392,251,1065,3430
11,412,412,273,1097,3430
1,500,200,50,750,3431
2,472,220,93,785,3431
3,436,246,135,817,3431
4,411,289,175,875,3431
5,406,334,187,927,3431
6,375,354,221,950,3431
7,387,352,240,979,3431
8,378,376,242,996,3431
9,393,400,252,1045,3431
10,397,394,279,1070,3431
11,388,412,276,1076,3431
1,500,200,50,750,3432
2,479,247,86,812,3432
3,419,279,126,824,3432
4,407,319,148,874,3432
5,403,318,198,919,3432
6,414,329,217,960,3432
7,417,327,242,986,3432
8,412,339,249,1000,3432
9,407,347,270,1024,3432
10,392,396,274,1062,3432
11,398,425,263,1086,3432
1,500,200,50,750,3433
2,470,224,91,785,3433
3,439,276,123,838,3433
4,396,319,161,876,3433
5,379,338,192,909,3433
6,368,328,232,928,3433
7,382,348,257,987,3433
8,373,356,271,1000,3433
9,385,370,277,1032,3433
10,386,402,277,1065,3433
11,416,399,274,1089,3433
1,500,200,50,750,3434
2,454,236,106,796,3434
3,429,275,146,850,3434
4,397,302,166,865,3434
5,376,344,182,902,3434
6,402,345,199,946,3434
7,386,369,234,989,3434
8,408,363,252,1023,3434
9,398,383,265,1046,3434
10,381,390,287,1058,3434
11,397,414,273,1084,3434
1,500,200,50,750,3435
2,452,222,100,774,3435
3,457,242,133,832,3435
4,441,266,163,870,3435
5,434,292,187,913,3435
6,422,325,221,968,3435
7,396,352,235,983,3435
8,395,368,243,1006,3435
9,396,387,243,1026,3435
10,400,395,263,1058,3435
11,378,419,270,1067,3435
1,500,200,50,750,3436
2,457,235,91,783,3436
3,446,258,138,842,3436
4,424,276,167,867,3436
5,409,323,180,912,3436
6,415,352,201,968,3436
7,403,357,226,986,3436
8,401,348,240,989,3436
9,402,389,251,1042,3436
10,389,367,285,1041,3436
11,424,386,275,1085,3436
1,500,200,50,750,3437
2,454,243,94,791,3437
3,430,262,148,840,3437
4,412,270,185,867,3437
5,409,296,202,907,3437
6,420,328,212,960,3437
7,414,355,208,977,3437
8,415,356,228,999,3437
9,422,380,238,1040,3437
10,396,397,260,1053,3437
11,374,436,271,1081,3437
1,500,200,50,750,3438
2,459,227,102,788,3438
3,444,242,146,832,3438
4,409,282,163,854,3438
5,426,316,186,928,3438
6,401,350,198,949,3438
7,380,361,223,964,3438
8,391,354,257,1002,3438
9,372,371,282,1025,3438
10,351,397,292,1040,3438
11,387,401,302,1090,3438
1,500,200,50,750,3439
2,465,227,90,782,3439
3,418,266,145,829,3439
4,416,276,181,873,3439
5,420,297,194,911,3439
6,409,357,205,971,3439
7,399,372,223,994,3439
8,392,373,236,1001,3439
9,420,396,234,1050,3439
10,397,389,266,1052,3439
11,400,397,280,1077,3439
1,500,200,50,750,3440
2,451,234,103,788,3440
3,420,248,161,829,3440
4,409,258,205,872,3440
5,395,296,225,916,3440
6,409,317,237,963,3440
7,389,349,255,993,3440
8,404,353,258,1015,3440
9,411,359,254,1024,3440
10,401,410,244,1055,3440
11,422,403,263,1088,3440
1,500,200,50,750,3441
2,467,227,87,781,3441
3,457,261,116,834,3441
4,411,291,157,859,3441
5,381,305,203,889,3441
6,403,337,212,952,3441
7,400,350,228,978,3441
8,392,368,242,1002,3441
9,402,388,233,1023,3441
10,382,414,257,1053,3441
11,408,400,285,1093,3441
1,500,200,50,750,3442
2,440,243,95,778,3442
3,405,266,143,814,3442
4,408,282,179,869,3442
5,401,302,216,919,3442
6,399,328,228,955,3442
7,392,357,224,973,3442
8,382,370,230,982,3442
9,397,396,241,1034,3442
10,407,387,262,1056,3442
11,394,410,284,1088,3442
1,500,200,50,750,3443
2,449,220,105,774,3443
3,440,240,147,827,3443
4,422,285,171,878,3443
5,422,300,176,898,3443
6,439,319,206,964,3443
7,414,335,231,980,3443
8,419,350,234,1003,3443
9,404,383,240,1027,3443
10,402,390,263,1055,3443
11,406,414,275,1095,3443
1,500,200,50,750,3444
2,456,250,90,796,3444
3,427,259,133,819,3444
4,432,281,172,885,3444
5,392,316,186,894,3444
6,405,347,200,952,3444
7,400,369,220,989,3444
8,376,372,253,1001,3444
9,375,370,267,1012,3444
10,391,407,266,1064,3444
11,370,412,294,1076,3444
1,500,200,50,750,3445
2,462,229,98,789,3445
3,405,272,146,823,3445
4,374,305,184,863,3445
5,350,336,210,896,3445
6,357,362,229,948,3445
7,396,345,244,985,3445
8,394,366,256,1016,3445
9,395,378,273,1046,3445
10,400,388,270,1058,3445
11,407,388,284,1079,3445
1,500,200,50,750,3446
2,477,214,103,794,3446
3,449,251,124,824,3446
4,421,304,149,874,3446
5,422,298,195,915,3446
6,427,315,218,960,3446
7,416,314,243,973,3446
8,420,348,232,1000,3446
9,427,364,240,1031,3446
10,440,354,268,1062,3446
11,421,380,275,1076,3446
1,500,200,50,750,3447
2,476,213,98,787,3447
3,447,257,124,828,3447
4,395,281,171,847,3447
5,404,325,198,927,3447
6,395,330,224,949,3447
7,392,344,245,981,3447
8,399,380,238,1017,3447
9,378,406,240,1024,3447
10,371,432,274,1077,3447
11,349,434,293,1076,3447
1,500,200,50,750,3448
2,446,251,94,791,3448
3,435,275,132,842,3448
4,395,301,172,868,3448
5,375,334,181,890,3448
6,396,365,200,961,3448
7,400,380,222,1002,3448
8,373,387,234,994,3448
9,384,385,260,1029,3448
10,354,404,280,1038,3448
11,371,428,264,1063,3448
1,500,200,50,750,3449
2,450,221,116,787,3449
3,460,257,135,852,3449
4,417,296,154,867,3449
5,416,303,199,918,3449
6,418,334,222,974,3449
7,397,330,250,977,3449
8,395,358,239,992,3449
9,411,373,251,1035,3449
10,403,393,242,1038,3449
11,425,405,262,1092,3449
1,500,200,50,750,3450
2,426,249,108,783,3450
3,437,285,128,850,3450
4,396,311,164,871,3450
5,399,337,182,918,3450
6,398,357,225,980,3450
7,363,377,239,979,3450
8,348,380,277,1005,3450
9,361,392,284,1037,3450
10,351,415,278,1044,3450
11,370,418,293,1081,3450
1,500,200,50,750,3451
2,457,226,100,783,3451
3,418,273,134,825,3451
4,415,281,176,872,3451
5,405,295,195,895,3451
6,394,341,213,948,3451
7,393,363,223,979,3451
8,375,388,242,1005,3451
9,373,383,249,1005,3451
10,383,384,276,1043,3451
11,410,401,292,1103,3451
1,500,200,50,750,3452
2,465,237,90,792,3452
3,433,264,128,825,3452
4,413,296,153,862,3452
5,409,300,200,909,3452
6,437,344,186,967,3452
7,394,357,227,978,3452
8,393,380,230,1003,3452
9,392,373,253,1018,3452
10,401,358,285,1044,3452
11,424,383,294,1101,3452
1,500,200,50,750,3453
2,455,221,108,784,3453
3,437,243,145,825,3453
4,427,272,171,870,3453
5,421,288,192,901,3453
6,431,307,215,953,3453
7,417,341,226,984,3453
8,397,381,242,1020,3453
9,393,381,252,1026,3453
10,402,395,260,1057,3453
11,395,429,265,1089,3453
1,500,200,50,750,3454
2,445,247,102,794,3454
3,416,276,135,827,3454
4,392,292,166,850,3454
5,386,318,190,894,3454
6,404,339,228,971,3454
7,388,359,236,983,3454
8,401,361,255,1017,3454
9,397,392,247,1036,3454
10,404,394,260,1058,3454
11,416,409,266,1091,3454
1,500,200,50,750,3455
2,445,233,108,786,3455
3,428,252,150,830,3455
4,425,263,178,866,3455
5,422,324,162,908,3455
6,404,351,183,938,3455
7,395,380,198,973,3455
8,381,400,218,999,3455
9,372,418,231,1021,3455
10,404,418,243,1065,3455
11,406,425,257,1088,3455
1,500,200,50,750,3456
2,455,232,108,795,3456
3,403,258,149,810,3456
4,406,281,180,867,3456
5,414,301,187,902,3456
6,442,319,212,973,3456
7,404,343,233,980,3456
8,407,360,240,1007,3456
9,393,387,250,1030,3456
10,383,404,263,1050,3456
11,396,425,265,1086,3456
1,500,200,50,750,3457
2,458,241,93,792,3457
3,433,262,132,827,3457
4,412,281,170,863,3457
5,424,324,169,917,3457
6,402,352,194,948,3457
7,391,369,211,971,3457
8,407,387,217,1011,3457
9,394,407,232,1033,3457
10,396,407,250,1053,3457
11,381,442,266,1089,3457
1,500,200,50,750,3458
2,454,235,93,782,3458
3,426,272,135,833,3458
4,418,273,177,868,3458
5,403,305,202,910,3458
6,386,333,201,920,3458
7,416,350,207,973,3458
8,411,382,218,1011,3458
9,409,377,252,1038,3458
10,412,377,255,1044,3458
11,389,402,283,1074,3458
1,500,200,50,750,3459
2,441,240,101,782,3459
3,418,264,132,814,3459
4,401,289,168,858,3459
5,391,317,187,895,3459
6,405,327,218,950,3459
7,390,356,231,977,3459
8,387,343,262,992,3459
9,403,362,271,1036,3459
10,375,387,278,1040,3459
11,406,409,274,1089,3459
1,500,200,50,750,3460
2,447,239,105,791,3460
3,417,287,128,832,3460
4,392,309,166,867,3460
5,364,331,201,896,3460
6,378,359,223,960,3460
7,367,356,237,960,3460
8,367,388,260,1015,3460
9,367,409,257,1033,3460
10,391,410,251,1052,3460
11,394,417,256,1067,3460
1,500,200,50,750,3461
2,453,227,94,774,3461
3,452,254,134,840,3461
4,408,297,163,868,3461
5,383,350,187,920,3461
6,398,346,216,960,3461
7,397,357,235,989,3461
8,397,375,243,1015,3461
9,377,385,258,1020,3461
10,394,422,250,1066,3461
11,391,444,264,1099,3461
1,500,200,50,750,3462
2,451,236,98,785,3462
3,438,273,124,835,3462
4,401,302,158,861,3462
5,397,343,171,911,3462
6,397,354,195,946,3462
7,390,382,216,988,3462
8,395,384,234,1013,3462
9,381,422,230,1033,3462
10,378,403,269,1050,3462
11,392,426,264,1082,3462
1,500,200,50,750,3463
2,461,246,89,796,3463
3,423,268,142,833,3463
4,391,313,161,865,3463
5,393,327,194,914,3463
6,412,320,213,945,3463
7,425,338,225,988,3463
8,410,348,250,1008,3463
9,402,357,264,1023,3463
10,439,364,247,1050,3463
11,455,384,256,1095,3463
1,500,200,50,750,3464
2,460,224,94,778,3464
3,438,268,132,838,3464
4,428,297,153,878,3464
5,421,310,178,909,3464
6,433,329,207,969,3464
7,411,353,214,978,3464
8,419,365,225,1009,3464
9,411,373,244,1028,3464
10,404,381,268,1053,3464
11,423,390,276,1089,3464
1,500,200,50,750,3465
2,465,226,103,794,3465
3,429,273,122,824,3465
4,425,290,154,869,3465
5,402,324,182,908,3465
6,407,361,191,959,3465
7,418,352,222,992,3465
8,407,357,247,1011,3465
9,383,399,254,1036,3465
10,381,394,273,1048,3465
11,382,381,290,1053,3465
1,500,200,50,750,3466
2,464,243,100,807,3466
3,420,273,132,825,3466
4,409,305,153,867,3466
5,393,330,193,916,3466
6,391,344,220,955,3466
7,372,357,247,976,3466
8,389,372,249,1010,3466
9,371,389,269,1029,3466
10,342,394,312,1048,3466
11,357,395,305,1057,3466
1,500,200,50,750,3467
2,458,219,108,785,3467
3,450,238,152,840,3467
4,429,271,170,870,3467
5,418,302,197,917,3467
6,412,323,218,953,3467
7,399,353,225,977,3467
8,377,386,240,1003,3467
9,374,389,252,1015,3467
10,401,398,263,1062,3467
11,375,400,278,1053,3467
1,500,200,50,750,3468
2,451,223,101,775,3468
3,432,252,129,813,3468
4,418,295,150,863,3468
5,399,326,181,906,3468
6,423,349,210,982,3468
7,416,330,235,981,3468
8,390,358,233,981,3468
9,402,373,250,1025,3468
10,386,381,283,1050,3468
11,402,407,282,1091,3468
1,500,200,50,750,3469
2,473,214,101,788,3469
3,453,250,132,835,3469
4,437,272,160,869,3469
5,412,306,191,909,3469
6,412,320,222,954,3469
7,412,321,241,974,3469
8,432,332,256,1020,3469
9,412,365,263,1040,3469
10,417,377,268,1062,3469
11,407,403,272,1082,3469
1,500,200,50,750,3470
2,450,247,103,800,3470
3,423,271,149,843,3470
4,384,293,180,857,3470
5,392,303,206,901,3470
6,397,340,212,949,3470
7,385,353,238,976,3470
8,387,383,248,1018,3470
9,410,384,244,1038,3470
10,413,396,260,1069,3470
11,425,391,269,1085,3470
1,500,200,50,750,3471
2,445,256,94,795,3471
3,405,270,141,816,3471
4,415,290,175,880,3471
5,413,296,202,911,3471
6,423,326,219,968,3471
7,412,338,238,988,3471
8,400,345,239,984,3471
9,425,345,248,1018,3471
10,422,368,271,1061,3471
11,416,406,273,1095,3471
1,500,200,50,750,3472
2,474,229,94,797,3472
3,463,250,128,841,3472
4,437,274,156,867,3472
5,438,293,171,902,3472
6,439,303,193,935,3472
7,434,322,218,974,3472
8,420,349,241,1010,3472
9,433,368,246,1047,3472
10,418,389,252,1059,3472
11,387,401,270,1058,3472
1,500,200,50,750,3473
2,458,228,113,799,3473
3,407,254,158,819,3473
4,389,283,187,859,3473
5,379,318,199,896,3473
6,388,344,222,954,3473
7,381,352,246,979,3473
8,386,354,257,997,3473
9,383,386,252,1021,3473
10,383,385,256,1024,3473
11,404,400,270,1074,3473
1,500,200,50,750,3474
2,471,214,98,783,3474
3,438,253,134,825,3474
4,421,271,177,869,3474
5,402,310,196,908,3474
6,393,363,196,952,3474
7,398,386,202,986,3474
8,402,382,218,1002,3474
9,406,373,252,1031,3474
10,400,399,256,1055,3474
11,393,408,269,1070,3474
1,500,200,50,750,3475
2,442,234,104,780,3475
3,411,259,146,816,3475
4,409,278,176,863,3475
5,422,301,208,931,3475
6,420,323,221,964,3475
7,390,348,248,986,3475
8,388,358,254,1000,3475
9,378,362,274,1014,3475
10,402,381,271,1054,3475
11,398,411,293,1102,3475
1,500,200,50,750,3476
2,471,225,94,790,3476
3,455,241,143,839,3476
4,414,273,169,856,3476
5,401,292,200,893,3476
6,387,335,226,948,3476
7,390,375,232,997,3476
8,398,380,236,1014,3476
9,401,378,240,1019,3476
10,392,401,267,1060,3476
11,390,405,275,1070,3476
1,500,200,50,750,3477
2,465,232,100,797,3477
3,423,261,156,840,3477
4,405,294,166,865,3477
5,395,333,189,917,3477
6,394,352,212,958,3477
7,393,366,226,985,3477
8,380,363,244,987,3477
9,398,395,249,1042,3477
10,397,382,263,1042,3477
11,392,381,297,1070,3477
1,500,200,50,750,3478
2,454,246,94,794,3478
3,414,262,139,815,3478
4,410,289,173,872,3478
5,397,315,202,914,3478
6,392,313,240,945,3478
7,391,342,240,973,3478
8,368,372,255,995,3478
9,403,374,269,1046,3478
10,408,378,278,1064,3478
11,379,409,287,1075,3478
1,500,200,50,750,3479
2,438,233,105,776,3479
3,430,251,137,818,3479
4,416,285,144,845,3479
5,406,333,167,906,3479
6,411,328,210,949,3479
7,411,349,224,984,3479
8,399,369,238,1006,3479
9,412,371,266,1049,3479
10,414,370,266,1050,3479
11,432,373,282,1087,3479
1,500,200,50,750,3480
2,477,220,100,797,3480
3,439,244,136,819,3480
4,434,280,168,882,3480
5,406,313,202,921,3480
6,383,337,209,929,3480
7,392,355,241,988,3480
8,396,363,252,1011,3480
9,386,385,262,1033,3480
10,375,397,281,1053,3480
11,403,421,266,1090,3480
1,500,200,50,750,3481
2,456,214,102,772,3481
3,444,237,136,817,3481
4,416,277,167,860,3481
5,391,304,215,910,3481
6,400,323,225,948,3481
7,409,325,249,983,3481
8,391,364,258,1013,3481
9,383,346,271,1000,3481
10,390,380,298,1068,3481
11,411,379,285,1075,3481
1,500,200,50,750,3482
2,460,221,107,788,3482
3,425,274,133,832,3482
4,421,280,178,879,3482
5,413,309,190,912,3482
6,416,316,222,954,3482
7,386,343,243,972,3482
8,390,368,243,1001,3482
9,401,371,251,1023,3482
10,410,383,272,1065,3482
11,404,378,280,1062,3482
1,500,200,50,750,3483
2,443,223,114,780,3483
3,432,262,150,844,3483
4,428,280,156,864,3483
5,424,302,186,912,3483
6,416,357,182,955,3483
7,429,339,218,986,3483
8,412,375,226,1013,3483
9,408,375,248,1031,3483
10,383,404,269,1056,3483
11,386,416,276,1078,3483
1,500,200,50,750,3484
2,462,232,98,792,3484
3,444,256,137,837,3484
4,428,295,137,860,3484
5,424,316,171,911,3484
6,400,344,205,949,3484
7,408,350,231,989,3484
8,387,387,226,1000,3484
9,380,394,256,1030,3484
10,390,402,263,1055,3484
11,390,418,273,1081,3484
1,500,200,50,750,3485
2,458,240,81,779,3485
3,428,279,108,815,3485
4,406,313,143,862,3485
5,408,334,175,917,3485
6,424,348,179,951,3485
7,401,349,221,971,3485
8,409,370,242,1021,3485
9,380,397,247,1024,3485
10,385,396,265,1046,3485
11,424,441,261,1126,3485
1,500,200,50,750,3486
2,467,233,96,796,3486
3,426,278,122,826,3486
4,434,276,165,875,3486
5,432,326,179,937,3486
6,413,339,196,948,3486
7,402,364,209,975,3486
8,402,371,220,993,3486
9,415,375,250,1040,3486
10,405,381,268,1054,3486
11,413,409,265,1087,3486
1,500,200,50,750,3487
2,464,225,103,792,3487
3,423,269,142,834,3487
4,397,284,179,860,3487
5,401,309,198,908,3487
6,393,346,214,953,3487
7,400,355,234,989,3487
8,376,373,246,995,3487
9,383,391,265,1039,3487
10,405,379,280,1064,3487
11,385,415,288,1088,3487
1,500,200,50,750,3488
2,451,228,93,772,3488
3,417,273,132,822,3488
4,399,282,170,851,3488
5,411,321,187,919,3488
6,404,345,211,960,3488
7,401,368,210,979,3488
8,402,371,237,1010,3488
9,404,392,245,1041,3488
10,409,410,244,1063,3488
11,419,399,260,1078,3488
1,500,200,50,750,3489
2,455,226,110,791,3489
3,420,266,140,826,3489
4,413,297,167,877,3489
5,404,311,190,905,3489
6,423,321,224,968,3489
7,403,343,235,981,3489
8,405,376,235,1016,3489
9,416,386,245,1047,3489
10,397,384,274,1055,3489
11,393,384,293,1070,3489
1,500,200,50,750,3490
2,445,237,99,781,3490
3,419,279,122,820,3490
4,420,315,158,893,3490
5,398,326,193,917,3490
6,404,345,210,959,3490
7,392,355,228,975,3490
8,401,398,218,1017,3490
9,383,398,228,1009,3490
10,433,423,235,1091,3490
11,420,421,249,1090,3490
1,500,200,50,750,3491
2,452,234,103,789,3491
3,445,265,144,854,3491
4,406,291,165,862,3491
5,393,316,190,899,3491
6,415,349,205,969,3491
7,398,365,224,987,3491
8,394,382,229,1005,3491
9,394,383,245,1022,3491
10,396,413,241,1050,3491
11,411,419,260,1090,3491
1,500,200,50,750,3492
2,450,240,107,797,3492
3,432,248,144,824,3492
4,404,282,163,849,3492
5,418,305,199,922,3492
6,402,346,222,970,3492
7,386,345,250,981,3492
8,391,350,252,993,3492
9,426,351,256,1033,3492
10,420,364,265,1049,3492
11,410,387,279,1076,3492
1,500,200,50,750,3493
2,468,218,101,787,3493
3,442,250,134,826,3493
4,434,294,152,880,3493
5,432,314,160,906,3493
6,445,322,187,954,3493
7,421,360,202,983,3493
8,390,379,238,1007,3493
9,386,376,267,1029,3493
10,404,408,254,1066,3493
11,413,429,262,1104,3493
1,500,200,50,750,3494
2,465,243,87,795,3494
3,414,269,129,812,3494
4,406,308,156,870,3494
5,394,331,178,903,3494
6,390,375,206,971,3494
7,387,367,236,990,3494
8,380,392,247,1019,3494
9,382,398,252,1032,3494
10,380,377,288,1045,3494
11,390,410,288,1088,3494
1,500,200,50,750,3495
2,432,239,122,793,3495
3,411,270,138,819,3495
4,411,282,169,862,3495
5,411,296,197,904,3495
6,410,319,225,954,3495
7,427,347,221,995,3495
8,396,356,238,990,3495
9,390,375,254,1019,3495
10,391,390,260,1041,3495
11,415,405,277,1097,3495
1,500,200,50,750,3496
2,454,227,110,791,3496
3,429,251,136,816,3496
4,407,289,164,860,3496
5,402,324,196,922,3496
6,400,344,220,964,3496
7,389,343,233,965,3496
8,379,359,259,997,3496
9,400,363,261,1024,3496
10,379,375,274,1028,3496
11,409,394,268,1071,3496
1,500,200,50,750,3497
2,453,246,96,795,3497
3,411,271,132,814,3497
4,406,290,163,859,3497
5,406,291,213,910,3497
6,418,313,229,960,3497
7,415,355,228,998,3497
8,404,371,247,1022,3497
9,390,397,245,1032,3497
10,378,414,256,1048,3497
11,378,406,303,1087,3497
1,500,200,50,750,3498
2,453,241,99,793,3498
3,418,269,144,831,3498
4,397,279,186,862,3498
5,410,304,207,921,3498
6,398,337,231,966,3498
7,393,343,256,992,3498
8,362,368,264,994,3498
9,378,390,266,1034,3498
10,403,391,279,1073,3498
11,408,400,286,1094,3498
1,500,200,50,750,3499
2,461,224,100,785,3499
3,433,258,123,814,3499
4,421,284,164,869,3499
5,437,302,180,919,3499
6,427,319,201,947,3499
7,419,323,231,973,3499
8,412,377,226,1015,3499
9,408,385,238,1031,3499
10,383,407,257,1047,3499
11,370,431,278,1079,3499
1,500,200,50,750,3500
2,445,248,98,791,3500
3,404,273,146,823,3500
4,404,309,167,880,3500
5,400,333,184,917,3500
6,394,359,195,948,3500
7,401,353,221,975,3500
8,382,366,242,990,3500
9,394,411,241,1046,3500
10,381,412,262,1055,3500
11,390,420,259,1069,3500
1,500,200,50,750,3501
2,460,225,97,782,3501
3,436,245,134,815,3501
4,420,303,161,884,3501
5,408,313,190,911,3501
6,405,333,224,962,3501
7,395,349,245,989,3501
8,381,371,257,1009,3501
9,380,385,275,1040,3501
10,387,396,252,1035,3501
11,391,413,275,1079,3501
1,500,200,50,750,3502
2,468,240,87,795,3502
3,453,256,124,833,3502
4,422,291,153,866,3502
5,433,313,183,929,3502
6,400,354,204,958,3502
7,408,358,231,997,3502
8,400,381,233,1014,3502
9,398,412,233,1043,3502
10,400,404,266,1070,3502
11,395,399,265,1059,3502
1,500,200,50,750,3503
2,457,215,99,771,3503
3,426,246,150,822,3503
4,409,289,165,863,3503
5,416,317,184,917,3503
6,407,356,201,964,3503
7,397,379,202,978,3503
8,415,358,242,1015,3503
9,423,366,251,1040,3503
10,413,391,275,1079,3503
11,392,416,277,1085,3503
1,500,200,50,750,3504
2,468,228,84,780,3504
3,445,242,132,819,3504
4,435,275,159,869,3504
5,423,312,181,916,3504
6,410,335,207,952,3504
7,399,360,231,990,3504
8,396,366,262,1024,3504
9,365,383,286,1034,3504
10,371,412,274,1057,3504
11,361,416,290,1067,3504
1,500,200,50,750,3505
2,446,233,111,790,3505
3,412,270,150,832,3505
4,401,298,176,875,3505
5,403,311,194,908,3505
6,401,330,233,964,3505
7,400,333,249,982,3505
8,398,355,259,1012,3505
9,387,388,253,1028,3505
10,367,422,271,1060,3505
11,375,433,288,1096,3505
1,500,200,50,750,3506
2,455,238,98,791,3506
3,431,261,129,821,3506
4,409,288,166,863,3506
5,407,324,184,915,3506
6,413,330,229,972,3506
7,399,330,241,970,3506
8,401,365,249,1015,3506
9,399,368,264,1031,3506
10,396,368,271,1035,3506
11,405,399,266,1070,3506
1,500,200,50,750,3507
2,457,232,93,782,3507
3,436,261,124,821,3507
4,433,282,155,870,3507
5,438,296,184,918,3507
6,429,320,213,962,3507
7,409,351,225,985,3507
8,404,369,233,1006,3507
9,402,382,255,1039,3507
10,411,382,260,1053,3507
11,411,428,260,1099,3507
1,500,200,50,750,3508
2,443,236,104,783,3508
3,434,273,124,831,3508
4,423,297,167,887,3508
5,410,307,196,913,3508
6,412,319,216,947,3508
7,409,326,237,972,3508
8,410,351,258,1019,3508
9,396,356,276,1028,3508
10,400,377,270,1047,3508
11,421,403,286,1110,3508
1,500,200,50,750,3509
2,468,222,108,798,3509
3,432,249,148,829,3509
4,419,292,166,877,3509
5,415,318,188,921,3509
6,392,344,216,952,3509
7,363,400,214,977,3509
8,369,414,226,1009,3509
9,359,414,249,1022,3509
10,370,427,260,1057,3509
11,402,429,255,1086,3509
1,500,200,50,750,3510
2,467,228,98,793,3510
3,445,246,134,825,3510
4,427,281,167,875,3510
5,415,296,200,911,3510
6,430,312,228,970,3510
7,413,324,244,981,3510
8,388,364,257,1009,3510
9,391,380,257,1028,3510
10,385,400,259,1044,3510
11,414,413,258,1085,3510
1,500,200,50,750,3511
2,464,224,101,789,3511
3,433,249,144,826,3511
4,414,303,146,863,3511
5,413,308,192,913,3511
6,427,332,212,971,3511
7,417,353,229,999,3511
8,390,367,241,998,3511
9,392,376,269,1037,3511
10,405,392,277,1074,3511
11,387,412,276,1075,3511
1,500,200,50,750,3512
2,464,234,93,791,3512
3,422,265,132,819,3512
4,428,265,176,869,3512
5,406,289,204,899,3512
6,416,334,225,975,3512
7,384,347,237,968,3512
8,419,368,224,1011,3512
9,408,378,246,1032,3512
10,386,396,261,1043,3512
11,405,405,266,1076,3512
1,500,200,50,750,3513
2,439,245,100,784,3513
3,429,257,143,829,3513
4,418,306,158,882,3513
5,402,328,180,910,3513
6,411,338,203,952,3513
7,404,333,238,975,3513
8,411,358,255,1024,3513
9,380,385,255,1020,3513
10,377,412,256,1045,3513
11,384,435,269,1088,3513
1,500,200,50,750,3514
2,461,229,91,781,3514
3,450,251,133,834,3514
4,421,281,154,856,3514
5,428,306,188,922,3514
6,433,313,210,956,3514
7,420,340,220,980,3514
8,404,362,255,1021,3514
9,377,369,264,1010,3514
10,378,361,290,1029,3514
11,400,409,281,1090,3514
1,500,200,50,750,3515
2,463,229,99,791,3515
3,432,255,134,821,3515
4,427,277,156,860,3515
5,422,316,176,914,3515
6,450,305,222,977,3515
7,434,327,241,1002,3515
8,410,343,258,1011,3515
9,406,375,256,1037,3515
10,406,385,274,1065,3515
11,403,413,266,1082,3515
1,500,200,50,750,3516
2,449,225,97,771,3516
3,444,236,128,808,3516
4,431,281,151,863,3516
5,432,322,177,931,3516
6,413,338,205,956,3516
7,412,356,221,989,3516
8,402,382,218,1002,3516
9,408,386,238,1032,3516
10,393,413,245,1051,3516
11,402,417,268,1087,3516
1,500,200,50,750,3517
2,457,235,99,791,3517
3,446,257,120,823,3517
4,442,273,159,874,3517
5,411,321,191,923,3517
6,397,354,203,954,3517
7,389,355,224,968,3517
8,405,378,242,1025,3517
9,394,390,243,1027,3517
10,388,399,249,1036,3517
11,401,423,245,1069,3517
1,500,200,50,750,3518
2,462,211,113,786,3518
3,433,249,141,823,3518
4,410,279,173,862,3518
5,428,287,202,917,3518
6,397,322,217,936,3518
7,395,346,245,986,3518
8,378,370,246,994,3518
9,370,390,267,1027,3518
10,383,402,265,1050,3518
11,386,422,279,1087,3518
1,500,200,50,750,3519
2,467,205,111,783,3519
3,427,241,156,824,3519
4,414,287,176,877,3519
5,399,320,193,912,3519
6,393,341,224,958,3519
7,390,343,255,988,3519
8,370,373,257,1000,3519
9,375,392,258,1025,3519
10,380,425,248,1053,3519
11,372,430,272,1074,3519
1,500,200,50,750,3520
2,445,232,108,785,3520
3,430,263,141,834,3520
4,412,275,167,854,3520
5,417,334,170,921,3520
6,398,348,196,942,3520
7,407,360,220,987,3520
8,393,363,249,1005,3520
9,397,379,254,1030,3520
10,389,392,272,1053,3520
11,396,422,262,1080,3520
1,500,200,50,750,3521
2,467,229,97,793,3521
3,423,262,130,815,3521
4,426,291,149,866,3521
5,418,317,166,901,3521
6,423,344,198,965,3521
7,411,354,215,980,3521
8,389,373,235,997,3521
9,398,381,251,1030,3521
10,401,362,275,1038,3521
11,420,384,273,1077,3521
1,500,200,50,750,3522
2,459,232,102,793,3522
3,423,258,136,817,3522
4,385,297,177,859,3522
5,401,309,196,906,3522
6,410,326,221,957,3522
7,379,370,233,982,3522
8,380,381,234,995,3522
9,381,416,244,1041,3522
10,386,416,250,1052,3522
11,393,415,279,1087,3522
1,500,200,50,750,3523
2,475,236,90,801,3523
3,436,270,111,817,3523
4,422,305,145,872,3523
5,411,321,166,898,3523
6,392,339,225,956,3523
7,402,347,222,971,3523
8,433,350,222,1005,3523
9,416,367,246,1029,3523
10,421,388,250,1059,3523
11,427,403,260,1090,3523
1,500,200,50,750,3524
2,458,221,107,786,3524
3,429,268,137,834,3524
4,396,322,135,853,3524
5,412,338,170,920,3524
6,410,371,186,967,3524
7,394,381,216,991,3524
8,389,389,239,1017,3524
9,386,395,251,1032,3524
10,394,402,266,1062,3524
11,423,416,267,1106,3524
1,500,200,50,750,3525
2,479,209,108,796,3525
3,430,270,125,825,3525
4,423,294,163,880,3525
5,401,314,197,912,3525
6,406,332,217,955,3525
7,383,355,248,986,3525
8,375,389,255,1019,3525
9,369,394,261,1024,3525
10,359,416,280,1055,3525
11,379,420,273,1072,3525
1,500,200,50,750,3526
2,468,209,114,791,3526
3,444,215,151,810,3526
4,430,257,173,860,3526
5,395,294,210,899,3526
6,390,316,231,937,3526
7,384,373,229,986,3526
8,383,383,229,995,3526
9,389,394,240,1023,3526
10,406,409,247,1062,3526
11,423,392,270,1085,3526
1,500,200,50,750,3527
2,492,216,81,789,3527
3,468,247,117,832,3527
4,441,255,165,861,3527
5,430,286,199,915,3527
6,439,314,203,956,3527
7,425,329,213,967,3527
8,420,360,224,1004,3527
9,406,392,234,1032,3527
10,405,403,240,1048,3527
11,436,405,254,1095,3527
1,500,200,50,750,3528
2,468,228,97,793,3528
3,439,253,139,831,3528
4,428,273,178,879,3528
5,420,302,190,912,3528
6,386,345,220,951,3528
7,379,389,223,991,3528
8,384,396,240,1020,3528
9,369,380,258,1007,3528
10,408,389,282,1079,3528
11,390,410,275,1075,3528
1,500,200,50,750,3529
2,454,239,97,790,3529
3,425,256,127,808,3529
4,415,270,174,859,3529
5,403,313,193,909,3529
6,394,324,230,948,3529
7,392,350,236,978,3529
8,390,342,264,996,3529
9,403,362,269,1034,3529
10,399,400,272,1071,3529
11,392,407,291,1090,3529
1,500,200,50,750,3530
2,471,228,87,786,3530
3,443,247,135,825,3530
4,406,284,161,851,3530
5,407,317,183,907,3530
6,402,351,197,950,3530
7,382,357,237,976,3530
8,379,374,241,994,3530
9,383,390,244,1017,3530
10,393,413,250,1056,3530
11,408,433,241,1082,3530
1,500,200,50,750,3531
2,461,226,95,782,3531
3,441,273,124,838,3531
4,418,284,150,852,3531
5,428,317,172,917,3531
6,425,336,191,952,3531
7,407,365,208,980,3531
8,390,378,227,995,3531
9,390,377,257,1024,3531
10,407,371,280,1058,3531
11,412,384,297,1093,3531
1,500,200,50,750,3532
2,459,222,108,789,3532
3,421,284,141,846,3532
4,400,317,166,883,3532
5,395,333,182,910,3532
6,385,366,210,961,3532
7,390,379,215,984,3532
8,387,371,261,1019,3532
9,373,380,270,1023,3532
10,412,405,255,1072,3532
11,403,402,276,1081,3532
1,500,200,50,750,3533
2,453,236,97,786,3533
3,418,264,140,822,3533
4,409,289,172,870,3533
5,413,307,182,902,3533
6,412,330,222,964,3533
7,385,366,236,987,3533
8,396,381,231,1008,3533
9,400,385,259,1044,3533
10,391,398,266,1055,3533
11,398,403,272,1073,3533
1,500,200,50,750,3534
2,460,248,80,788,3534
3,446,267,122,835,3534
4,409,304,155,868,3534
5,403,315,200,918,3534
6,412,346,206,964,3534
7,394,366,217,977,3534
8,380,408,219,1007,3534
9,378,414,238,1030,3534
10,395,401,249,1045,3534
11,418,398,275,1091,3534
1,500,200,50,750,3535
2,452,235,99,786,3535
3,431,278,129,838,3535
4,423,302,164,889,3535
5,414,313,178,905,3535
6,416,339,197,952,3535
7,425,344,221,990,3535
8,419,349,247,1015,3535
9,429,368,250,1047,3535
10,405,392,248,1045,3535
11,420,412,247,1079,3535
1,500,200,50,750,3536
2,435,231,111,777,3536
3,410,262,144,816,3536
4,395,301,173,869,3536
5,389,323,198,910,3536
6,409,350,217,976,3536
7,396,343,234,973,3536
8,405,370,248,1023,3536
9,389,390,259,1038,3536
10,389,402,257,1048,3536
11,429,405,264,1098,3536
1,500,200,50,750,3537
2,455,235,97,787,3537
3,432,267,136,835,3537
4,392,298,176,866,3537
5,410,305,199,914,3537
6,408,344,200,952,3537
7,383,360,224,967,3537
8,378,394,237,1009,3537
9,378,393,249,1020,3537
10,379,381,268,1028,3537
11,396,399,279,1074,3537
1,500,200,50,750,3538
2,449,238,102,789,3538
3,441,252,141,834,3538
4,423,282,149,854,3538
5,422,330,180,932,3538
6,415,355,198,968,3538
7,398,358,213,969,3538
8,400,355,238,993,3538
9,421,374,259,1054,3538
10,403,380,274,1057,3538
11,404,407,269,1080,3538
1,500,200,50,750,3539
2,455,238,99,792,3539
3,443,248,131,822,3539
4,429,264,161,854,3539
5,434,297,190,921,3539
6,426,325,202,953,3539
7,416,344,223,983,3539
8,394,368,238,1000,3539
9,400,379,251,1030,3539
10,410,373,265,1048,3539
11,420,381,281,1082,3539
1,500,200,50,750,3540
2,467,228,88,783,3540
3,445,273,119,837,3540
4,417,305,171,893,3540
5,400,318,193,911,3540
6,411,359,199,969,3540
7,392,360,233,985,3540
8,389,388,229,1006,3540
9,397,380,253,1030,3540
10,417,404,248,1069,3540
11,418,400,260,1078,3540
1,500,200,50,750,3541
2,458,235,90,783,3541
3,422,271,137,830,3541
4,390,323,170,883,3541
5,402,317,193,912,3541
6,421,326,211,958,3541
7,413,360,213,986,3541
8,401,378,231,1010,3541
9,400,396,258,1054,3541
10,380,419,268,1067,3541
11,382,426,273,1081,3541
1,500,200,50,750,3542
2,457,234,94,785,3542
3,435,252,143,830,3542
4,443,270,167,880,3542
5,420,319,181,920,3542
6,424,334,193,951,3542
7,420,364,214,998,3542
8,412,358,231,1001,3542
9,411,386,251,1048,3542
10,405,392,264,1061,3542
11,404,417,274,1095,3542
1,500,200,50,750,3543
2,463,236,91,790,3543
3,442,273,117,832,3543
4,418,296,155,869,3543
5,417,289,206,912,3543
6,421,342,206,969,3543
7,407,351,221,979,3543
8,388,375,229,992,3543
9,404,396,229,1029,3543
10,407,402,243,1052,3543
11,416,408,269,1093,3543
1,500,200,50,750,3544
2,467,231,85,783,3544
3,443,252,126,821,3544
4,410,277,183,870,3544
5,404,305,204,913,3544
6,422,327,210,959,3544
7,417,322,235,974,3544
8,416,353,233,1002,3544
9,409,377,245,1031,3544
10,436,374,266,1076,3544
11,463,377,270,1110,3544
1,500,200,50,750,3545
2,448,254,92,794,3545
3,410,274,137,821,3545
4,402,322,153,877,3545
5,403,339,170,912,3545
6,406,356,176,938,3545
7,415,364,195,974,3545
8,398,370,229,997,3545
9,400,396,247,1043,3545
10,402,388,270,1060,3545
11,387,394,285,1066,3545
1,500,200,50,750,3546
2,454,247,91,792,3546
3,432,274,120,826,3546
4,428,264,178,870,3546
5,408,305,200,913,3546
6,415,345,228,988,3546
7,406,338,248,992,3546
8,398,386,234,1018,3546
9,378,374,259,1011,3546
10,394,392,260,1046,3546
11,407,404,274,1085,3546
1,500,200,50,750,3547
2,443,229,96,768,3547
3,423,275,130,828,3547
4,419,312,138,869,3547
5,380,347,185,912,3547
6,388,349,206,943,3547
7,412,346,225,983,3547
8,398,360,240,998,3547
9,401,380,247,1028,3547
10,387,410,266,1063,3547
11,385,408,286,1079,3547
1,500,200,50,750,3548
2,452,237,94,783,3548
3,444,252,137,833,3548
4,422,277,171,870,3548
5,414,309,189,912,3548
6,422,342,186,950,3548
7,416,354,213,983,3548
8,405,378,241,1024,3548
9,382,403,242,1027,3548
10,385,404,261,1050,3548
11,391,431,258,1080,3548
1,500,200,50,750,3549
2,455,221,109,785,3549
3,428,262,152,842,3549
4,402,276,185,863,3549
5,421,304,187,912,3549
6,429,323,201,953,3549
7,417,347,213,977,3549
8,407,378,223,1008,3549
9,411,372,248,1031,3549
10,386,405,260,1051,3549
11,398,404,277,1079,3549
1,500,200,50,750,3550
2,457,235,91,783,3550
3,430,266,122,818,3550
4,411,305,158,874,3550
5,417,343,164,924,3550
6,418,359,201,978,3550
7,390,380,214,984,3550
8,386,385,236,1007,3550
9,385,396,259,1040,3550
10,391,402,268,1061,3550
11,386,405,289,1080,3550
1,500,200,50,750,3551
2,450,239,93,782,3551
3,430,259,135,824,3551
4,414,284,172,870,3551
5,404,315,190,909,3551
6,414,355,198,967,3551
7,407,348,221,976,3551
8,408,351,250,1009,3551
9,394,368,247,1009,3551
10,397,405,256,1058,3551
11,404,403,282,1089,3551
1,500,200,50,750,3552
2,460,240,102,802,3552
3,434,270,145,849,3552
4,401,280,186,867,3552
5,408,318,207,933,3552
6,394,327,224,945,3552
7,383,354,244,981,3552
8,378,385,237,1000,3552
9,382,393,256,1031,3552
10,406,396,278,1080,3552
11,362,417,292,1071,3552
1,500,200,50,750,3553
2,480,218,102,800,3553
3,432,258,131,821,3553
4,418,277,173,868,3553
5,404,313,184,901,3553
6,433,353,198,984,3553
7,395,363,215,973,3553
8,384,408,220,1012,3553
9,407,408,229,1044,3553
10,391,431,238,1060,3553
11,400,421,250,1071,3553
1,500,200,50,750,3554
2,444,246,99,789,3554
3,426,263,135,824,3554
4,385,292,173,850,3554
5,387,337,179,903,3554
6,392,362,202,956,3554
7,378,350,239,967,3554
8,389,384,227,1000,3554
9,403,378,265,1046,3554
10,407,404,268,1079,3554
11,403,430,260,1093,3554
1,500,200,50,750,3555
2,477,238,90,805,3555
3,442,261,135,838,3555
4,423,288,156,867,3555
5,437,322,170,929,3555
6,419,345,193,957,3555
7,416,349,216,981,3555
8,402,370,234,1006,3555
9,406,386,247,1039,3555
10,414,421,234,1069,3555
11,397,427,261,1085,3555
1,500,200,50,750,3556
2,482,225,87,794,3556
3,449,245,124,818,3556
4,438,284,152,874,3556
5,440,288,200,928,3556
6,424,318,216,958,3556
7,422,335,226,983,3556
8,414,347,243,1004,3556
9,386,371,252,1009,3556
10,406,397,258,1061,3556
11,415,402,267,1084,3556
1,500,200,50,750,3557
2,452,247,92,791,3557
3,449,252,136,837,3557
4,423,287,167,877,3557
5,402,322,199,923,3557
6,397,336,228,961,3557
7,397,346,242,985,3557
8,395,359,267,1021,3557
9,373,391,266,1030,3557
10,377,389,282,1048,3557
11,393,404,308,1105,3557
1,500,200,50,750,3558
2,456,238,92,786,3558
3,413,264,140,817,3558
4,390,301,163,854,3558
5,418,336,182,936,3558
6,412,346,198,956,3558
7,395,366,216,977,3558
8,387,374,252,1013,3558
9,383,400,250,1033,3558
10,386,395,268,1049,3558
11,408,404,278,1090,3558
1,500,200,50,750,3559
2,446,213,115,774,3559
3,433,261,139,833,3559
4,432,273,160,865,3559
5,417,317,181,915,3559
6,430,325,210,965,3559
7,419,325,233,977,3559
8,417,342,245,1004,3559
9,409,355,262,1026,3559
10,428,373,270,1071,3559
11,432,386,277,1095,3559
1,500,200,50,750,3560
2,460,231,87,778,3560
3,437,275,116,828,3560
4,410,306,152,868,3560
5,408,325,180,913,3560
6,386,355,205,946,3560
7,391,367,213,971,3560
8,390,407,215,1012,3560
9,397,379,250,1026,3560
10,417,380,265,1062,3560
11,419,383,278,1080,3560
1,500,200,50,750,3561
2,461,223,98,782,3561
3,439,245,147,831,3561
4,423,277,174,874,3561
5,417,304,188,909,3561
6,430,324,208,962,3561
7,422,351,223,996,3561
8,406,353,232,991,3561
9,413,382,243,1038,3561
10,409,379,275,1063,3561
11,426,392,272,1090,3561
1,500,200,50,750,3562
2,457,229,111,797,3562
3,419,280,130,829,3562
4,421,290,166,877,3562
5,417,313,190,920,3562
6,388,342,213,943,3562
7,396,369,226,991,3562
8,389,373,249,1011,3562
9,370,388,266,1024,3562
10,389,384,278,1051,3562
11,402,381,295,1078,3562
1,500,200,50,750,3563
2,480,241,84,805,3563
3,433,267,127,827,3563
4,409,271,187,867,3563
5,386,311,209,906,3563
6,372,327,230,929,3563
7,393,361,241,995,3563
8,374,353,276,1003,3563
9,375,360,280,1015,3563
10,409,373,284,1066,3563
11,392,401,282,1075,3563
1,500,200,50,750,3564
2,469,226,97,792,3564
3,419,264,148,831,3564
4,388,296,176,860,3564
5,382,337,193,912,3564
6,384,367,211,962,3564
7,368,386,224,978,3564
8,393,363,263,1019,3564
9,373,382,262,1017,3564
10,410,390,266,1066,3564
11,396,402,285,1083,3564
1,500,200,50,750,3565
2,453,235,93,781,3565
3,436,251,133,820,3565
4,432,288,158,878,3565
5,430,309,172,911,3565
6,462,332,196,990,3565
7,422,332,227,981,3565
8,411,340,260,1011,3565
9,399,368,267,1034,3565
10,385,407,270,1062,3565
11,385,421,277,1083,3565
1,500,200,50,750,3566
2,462,230,103,795,3566
3,430,261,125,816,3566
4,417,278,152,847,3566
5,426,306,187,919,3566
6,421,317,212,950,3566
7,418,327,230,975,3566
8,418,350,254,1022,3566
9,402,353,277,1032,3566
10,415,371,273,1059,3566
11,415,381,281,1077,3566
1,500,200,50,750,3567
2,467,241,92,800,3567
3,411,285,127,823,3567
4,410,298,163,871,3567
5,391,330,186,907,3567
6,407,351,197,955,3567
7,399,380,205,984,3567
8,398,372,241,1011,3567
9,415,380,238,1033,3567
10,412,408,238,1058,3567
11,419,409,269,1097,3567
1,500,200,50,750,3568
2,467,217,97,781,3568
3,452,246,142,840,3568
4,427,275,168,870,3568
5,426,283,200,909,3568
6,401,314,220,935,3568
7,411,339,227,977,3568
8,393,358,260,1011,3568
9,395,371,277,1043,3568
10,402,387,267,1056,3568
11,421,399,272,1092,3568
1,500,200,50,750,3569
2,473,238,90,801,3569
3,437,253,130,820,3569
4,431,289,158,878,3569
5,433,314,170,917,3569
6,436,344,180,960,3569
7,413,342,222,977,3569
8,404,385,214,1003,3569
9,412,371,257,1040,3569
10,399,367,280,1046,3569
11,415,389,295,1099,3569
1,500,200,50,750,3570
2,484,229,86,799,3570
3,424,277,126,827,3570
4,415,294,163,872,3570
5,410,316,183,909,3570
6,395,339,200,934,3570
7,404,361,212,977,3570
8,403,387,214,1004,3570
9,381,416,218,1015,3570
10,400,429,244,1073,3570
11,402,412,264,1078,3570
1,500,200,50,750,3571
2,464,227,101,792,3571
3,427,243,143,813,3571
4,394,287,182,863,3571
5,388,299,218,905,3571
6,405,340,218,963,3571
7,380,365,240,985,3571
8,362,396,244,1002,3571
9,381,387,264,1032,3571
10,402,392,260,1054,3571
11,405,419,265,1089,3571
1,500,200,50,750,3572
2,448,230,110,788,3572
3,445,242,141,828,3572
4,437,269,166,872,3572
5,425,297,190,912,3572
6,431,303,208,942,3572
7,445,327,220,992,3572
8,425,336,246,1007,3572
9,428,380,253,1061,3572
10,414,381,261,1056,3572
11,417,427,255,1099,3572
1,500,200,50,750,3573
2,443,252,100,795,3573
3,414,268,151,833,3573
4,392,287,173,852,3573
5,410,295,208,913,3573
6,403,335,216,954,3573
7,387,374,221,982,3573
8,394,382,236,1012,3573
9,371,388,256,1015,3573
10,385,402,281,1068,3573
11,399,399,290,1088,3573
1,500,200,50,750,3574
2,444,228,108,780,3574
3,412,261,146,819,3574
4,405,295,178,878,3574
5,377,335,202,914,3574
6,380,361,212,953,3574
7,366,371,258,995,3574
8,361,367,270,998,3574
9,366,377,274,1017,3574
10,386,384,256,1026,3574
11,400,440,261,1101,3574
1,500,200,50,750,3575
2,461,235,82,778,3575
3,448,273,118,839,3575
4,417,293,161,871,3575
5,397,338,180,915,3575
6,405,339,211,955,3575
7,405,346,238,989,3575
8,377,378,244,999,3575
9,401,377,249,1027,3575
10,388,399,270,1057,3575
11,401,413,266,1080,3575
1,500,200,50,750,3576
2,432,243,112,787,3576
3,412,270,153,835,3576
4,386,305,170,861,3576
5,400,309,199,908,3576
6,393,333,214,940,3576
7,381,372,234,987,3576
8,365,382,258,1005,3576
9,352,410,273,1035,3576
10,379,420,263,1062,3576
11,381,433,276,1090,3576
1,500,200,50,750,3577
2,470,222,94,786,3577
3,429,260,132,821,3577
4,418,309,142,869,3577
5,413,312,188,913,3577
6,406,321,219,946,3577
7,399,347,231,977,3577
8,396,374,245,1015,3577
9,395,384,273,1052,3577
10,382,403,272,1057,3577
11,402,411,285,1098,3577
1,500,200,50,750,3578
2,448,223,123,794,3578
3,408,262,154,824,3578
4,403,303,163,869,3578
5,391,320,199,910,3578
6,371,385,195,951,3578
7,359,402,218,979,3578
8,362,407,243,1012,3578
9,361,395,263,1019,3578
10,358,426,277,1061,3578
11,345,431,291,1067,3578
1,500,200,50,750,3579
2,444,226,111,781,3579
3,428,261,145,834,3579
4,396,295,185,876,3579
5,376,330,211,917,3579
6,389,356,212,957,3579
7,360,371,241,972,3579
8,381,400,237,1018,3579
9,381,387,254,1022,3579
10,383,405,270,1058,3579
11,378,425,275,1078,3579
1,500,200,50,750,3580
2,463,241,80,784,3580
3,406,279,132,817,3580
4,398,293,180,871,3580
5,403,296,217,916,3580
6,424,304,222,950,3580
7,423,323,250,996,3580
8,420,336,249,1005,3580
9,405,355,277,1037,3580
10,391,363,287,1041,3580
11,385,397,288,1070,3580
1,500,200,50,750,3581
2,467,233,96,796,3581
3,431,262,134,827,3581
4,412,281,168,861,3581
5,408,324,184,916,3581
6,398,354,197,949,3581
7,396,374,219,989,3581
8,407,366,230,1003,3581
9,409,395,234,1038,3581
10,422,389,257,1068,3581
11,384,400,294,1078,3581
1,500,200,50,750,3582
2,451,224,112,787,3582
3,436,258,142,836,3582
4,401,288,176,865,3582
5,383,315,191,889,3582
6,402,355,206,963,3582
7,384,373,217,974,3582
8,371,386,239,996,3582
9,362,401,249,1012,3582
10,396,397,284,1077,3582
11,377,416,274,1067,3582
1,500,200,50,750,3583
2,464,234,100,798,3583
3,429,257,146,832,3583
4,401,285,178,864,3583
5,401,324,194,919,3583
6,408,332,228,968,3583
7,391,345,243,979,3583
8,390,371,244,1005,3583
9,389,398,240,1027,3583
10,403,392,267,1062,3583
11,394,415,276,1085,3583
1,500,200,50,750,3584
2,484,229,87,800,3584
3,448,243,135,826,3584
4,431,263,173,867,3584
5,418,274,212,904,3584
6,427,311,220,958,3584
7,430,344,219,993,3584
8,415,384,208,1007,3584
9,417,383,230,1030,3584
10,420,388,254,1062,3584
11,426,401,276,1103,3584
1,500,200,50,750,3585
2,454,219,111,784,3585
3,440,242,144,826,3585
4,418,264,178,860,3585
5,412,282,220,914,3585
6,414,333,226,973,3585
7,394,343,236,973,3585
8,409,349,243,1001,3585
9,407,388,236,1031,3585
10,417,392,255,1064,3585
11,418,416,265,1099,3585
1,500,200,50,750,3586
2,468,228,95,791,3586
3,421,259,134,814,3586
4,405,276,172,853,3586
5,401,305,189,895,3586
6,403,356,212,971,3586
7,398,353,246,997,3586
8,371,382,242,995,3586
9,385,379,255,1019,3586
10,395,420,245,1060,3586
11,406,409,268,1083,3586
1,500,200,50,750,3587
2,457,235,91,783,3587
3,432,256,128,816,3587
4,411,293,164,868,3587
5,404,313,183,900,3587
6,394,352,204,950,3587
7,387,352,236,975,3587
8,369,383,252,1004,3587
9,372,409,252,1033,3587
10,390,388,286,1064,3587
11,389,401,293,1083,3587
1,500,200,50,750,3588
2,441,235,110,786,3588
3,414,263,141,818,3588
4,412,297,146,855,3588
5,418,320,187,925,3588
6,423,318,214,955,3588
7,427,327,221,975,3588
8,434,351,255,1040,3588
9,402,354,260,1016,3588
10,396,374,280,1050,3588
11,442,398,253,1093,3588
1,500,200,50,750,3589
2,440,230,118,788,3589
3,427,272,144,843,3589
4,401,302,157,860,3589
5,400,327,181,908,3589
6,404,341,215,960,3589
7,409,364,217,990,3589
8,418,369,231,1018,3589
9,405,386,239,1030,3589
10,411,386,264,1061,3589
11,421,391,269,1081,3589
1,500,200,50,750,3590
2,464,215,112,791,3590
3,438,249,132,819,3590
4,437,273,159,869,3590
5,424,281,198,903,3590
6,426,307,218,951,3590
7,404,336,233,973,3590
8,405,371,238,1014,3590
9,388,394,233,1015,3590
10,404,403,238,1045,3590
11,394,422,266,1082,3590
1,500,200,50,750,3591
2,453,233,88,774,3591
3,445,257,129,831,3591
4,414,273,165,852,3591
5,403,294,209,906,3591
6,416,317,226,959,3591
7,403,324,245,972,3591
8,400,343,249,992,3591
9,419,353,260,1032,3591
10,404,378,275,1057,3591
11,408,393,265,1066,3591
1,500,200,50,750,3592
2,452,231,98,781,3592
3,430,265,135,830,3592
4,420,284,158,862,3592
5,440,313,174,927,3592
6,406,351,194,951,3592
7,403,368,213,984,3592
8,409,354,245,1008,3592
9,402,360,270,1032,3592
10,416,386,256,1058,3592
11,422,386,279,1087,3592
1,500,200,50,750,3593
2,464,235,94,793,3593
3,429,262,136,827,3593
4,425,284,153,862,3593
5,407,328,177,912,3593
6,424,345,190,959,3593
7,422,366,206,994,3593
8,403,391,206,1000,3593
9,399,387,233,1019,3593
10,400,397,252,1049,3593
11,395,400,274,1069,3593
1,500,200,50,750,3594
2,465,211,112,788,3594
3,432,251,137,820,3594
4,408,301,165,874,3594
5,370,349,194,913,3594
6,358,377,217,952,3594
7,377,358,235,970,3594
8,402,367,244,1013,3594
9,390,374,257,1021,3594
10,404,390,248,1042,3594
11,400,387,286,1073,3594
1,500,200,50,750,3595
2,467,230,97,794,3595
3,431,272,129,832,3595
4,427,300,148,875,3595
5,405,321,183,909,3595
6,389,355,212,956,3595
7,381,354,242,977,3595
8,367,385,250,1002,3595
9,380,399,261,1040,3595
10,381,392,287,1060,3595
11,408,415,281,1104,3595
1,500,200,50,750,3596
2,458,237,101,796,3596
3,428,274,129,831,3596
4,424,301,152,877,3596
5,405,301,202,908,3596
6,419,347,194,960,3596
7,413,352,227,992,3596
8,366,372,258,996,3596
9,384,378,271,1033,3596
10,411,396,259,1066,3596
11,408,393,287,1088,3596
1,500,200,50,750,3597
2,447,228,107,782,3597
3,415,266,141,822,3597
4,405,294,173,872,3597
5,403,306,213,922,3597
6,382,343,225,950,3597
7,376,347,245,968,3597
8,391,352,271,1014,3597
9,388,367,271,1026,3597
10,408,387,261,1056,3597
11,402,407,278,1087,3597
1,500,200,50,750,3598
2,463,216,98,777,3598
3,438,264,125,827,3598
4,420,299,153,872,3598
5,403,310,195,908,3598
6,413,306,234,953,3598
7,408,344,223,975,3598
8,419,356,223,998,3598
9,403,387,237,1027,3598
10,417,357,271,1045,3598
11,439,384,268,1091,3598
1,500,200,50,750,3599
2,450,241,109,800,3599
3,420,254,145,819,3599
4,438,286,160,884,3599
5,409,313,181,903,3599
6,423,348,198,969,3599
7,422,350,212,984,3599
8,408,386,215,1009,3599
9,415,398,224,1037,3599
10,399,401,242,1042,3599
11,394,429,256,1079,3599
1,500,200,50,750,3600
2,462,223,101,786,3600
3,431,262,137,830,3600
4,413,290,165,868,3600
5,391,328,187,906,3600
6,407,355,191,953,3600
7,415,356,215,986,3600
8,412,368,237,1017,3600
9,405,390,240,1035,3600
10,412,391,239,1042,3600
11,421,396,274,1091,3600
1,500,200,50,750,3601
2,475,223,95,793,3601
3,450,252,136,838,3601
4,423,275,169,867,3601
5,405,316,189,910,3601
6,405,326,224,955,3601
7,391,371,215,977,3601
8,399,384,216,999,3601
9,411,399,226,1036,3601
10,402,409,248,1059,3601
11,422,447,245,1114,3601
1,500,200,50,750,3602
2,452,249,88,789,3602
3,430,265,132,827,3602
4,421,279,159,859,3602
5,416,300,189,905,3602
6,411,335,211,957,3602
7,411,351,220,982,3602
8,420,352,241,1013,3602
9,411,359,265,1035,3602
10,414,387,256,1057,3602
11,432,373,274,1079,3602
1,500,200,50,750,3603
2,450,222,112,784,3603
3,437,254,139,830,3603
4,433,256,175,864,3603
5,427,287,188,902,3603
6,427,300,224,951,3603
7,392,334,231,957,3603
8,404,329,258,991,3603
9,411,370,249,1030,3603
10,385,383,272,1040,3603
11,402,416,276,1094,3603
1,500,200,50,750,3604
2,459,245,88,792,3604
3,436,275,114,825,3604
4,424,298,142,864,3604
5,425,311,189,925,3604
6,397,336,206,939,3604
7,407,352,227,986,3604
8,416,363,234,1013,3604
9,401,383,242,1026,3604
10,404,387,267,1058,3604
11,432,396,253,1081,3604
1,500,200,50,750,3605
2,459,243,88,790,3605
3,449,267,118,834,3605
4,433,294,140,867,3605
5,425,316,174,915,3605
6,434,332,197,963,3605
7,420,346,223,989,3605
8,403,360,249,1012,3605
9,395,396,249,1040,3605
10,384,387,283,1054,3605
11,395,399,297,1091,3605
1,500,200,50,750,3606
2,461,225,102,788,3606
3,437,270,125,832,3606
4,419,316,134,869,3606
5,426,318,167,911,3606
6,406,333,208,947,3606
7,395,364,226,985,3606
8,380,378,237,995,3606
9,376,392,259,1027,3606
10,380,417,271,1068,3606
11,383,438,267,1088,3606
1,500,200,50,750,3607
2,454,239,102,795,3607
3,445,243,142,830,3607
4,416,293,162,871,3607
5,408,322,175,905,3607
6,422,321,216,959,3607
7,418,357,220,995,3607
8,390,373,231,994,3607
9,401,371,257,1029,3607
10,383,396,273,1052,3607
11,372,406,296,1074,3607
1,500,200,50,750,3608
2,434,228,110,772,3608
3,426,277,157,860,3608
4,416,273,177,866,3608
5,410,289,206,905,3608
6,405,334,211,950,3608
7,420,328,214,962,3608
8,419,365,218,1002,3608
9,416,370,240,1026,3608
10,415,403,238,1056,3608
11,405,431,254,1090,3608
1,500,200,50,750,3609
2,461,232,96,789,3609
3,435,253,140,828,3609
4,413,296,163,872,3609
5,386,329,192,907,3609
6,388,356,223,967,3609
7,372,356,255,983,3609
8,381,368,269,1018,3609
9,401,373,259,1033,3609
10,406,389,261,1056,3609
11,395,398,270,1063,3609
1,500,200,50,750,3610
2,440,240,100,780,3610
3,412,263,148,823,3610
4,398,298,168,864,3610
5,387,312,201,900,3610
6,387,348,219,954,3610
7,383,360,239,982,3610
8,380,385,238,1003,3610
9,388,382,256,1026,3610
10,384,388,268,1040,3610
11,422,424,253,1099,3610
1,500,200,50,750,3611
2,478,223,102,803,3611
3,464,232,137,833,3611
4,425,287,161,873,3611
5,434,303,186,923,3611
6,426,325,203,954,3611
7,416,318,236,970,3611
8,382,360,255,997,3611
9,390,362,259,1011,3611
10,397,385,268,1050,3611
11,407,409,278,1094,3611
1,500,200,50,750,3612
2,471,224,93,788,3612
3,446,245,130,821,3612
4,449,288,156,893,3612
5,427,300,183,910,3612
6,408,333,205,946,3612
7,390,365,228,983,3612
8,399,363,240,1002,3612
9,405,380,236,1021,3612
10,427,384,250,1061,3612
11,434,388,268,1090,3612
1,500,200,50,750,3613
2,469,224,96,789,3613
3,434,242,137,813,3613
4,406,306,168,880,3613
5,377,331,203,911,3613
6,382,369,209,960,3613
7,368,375,235,978,3613
8,357,399,239,995,3613
9,360,404,244,1008,3613
10,376,408,282,1066,3613
11,372,435,280,1087,3613
1,500,200,50,750,3614
2,444,259,89,792,3614
3,422,273,132,827,3614
4,410,287,183,880,3614
5,397,323,193,913,3614
6,413,332,223,968,3614
7,398,354,233,985,3614
8,389,353,252,994,3614
9,386,376,268,1030,3614
10,387,416,274,1077,3614
11,388,410,282,1080,3614
1,500,200,50,750,3615
2,459,231,98,788,3615
3,434,269,124,827,3615
4,425,283,145,853,3615
5,421,295,196,912,3615
6,406,335,217,958,3615
7,395,349,227,971,3615
8,398,359,254,1011,3615
9,406,376,254,1036,3615
10,411,390,277,1078,3615
11,404,397,285,1086,3615
1,500,200,50,750,3616
2,425,271,92,788,3616
3,423,272,128,823,3616
4,423,284,169,876,3616
5,404,321,199,924,3616
6,401,320,215,936,3616
7,419,340,226,985,3616
8,414,366,236,1016,3616
9,407,387,242,1036,3616
10,401,420,252,1073,3616
11,399,434,269,1102,3616
1,500,200,50,750,3617
2,471,212,111,794,3617
3,436,254,137,827,3617
4,409,271,168,848,3617
5,415,304,193,912,3617
6,412,325,208,945,3617
7,399,363,231,993,3617
8,396,374,243,1013,3617
9,378,402,262,1042,3617
10,375,417,260,1052,3617
11,388,413,273,1074,3617
1,500,200,50,750,3618
2,461,216,111,788,3618
3,424,263,134,821,3618
4,411,277,170,858,3618
5,405,320,187,912,3618
6,390,359,202,951,3618
7,380,362,210,952,3618
8,386,387,239,1012,3618
9,378,407,235,1020,3618
10,384,419,255,1058,3618
11,398,413,278,1089,3618
1,500,200,50,750,3619
2,455,231,105,791,3619
3,427,263,128,818,3619
4,446,280,145,871,3619
5,435,306,168,909,3619
6,427,355,187,969,3619
7,408,365,209,982,3619
8,406,366,232,1004,3619
9,414,386,239,1039,3619
10,422,398,243,1063,3619
11,412,403,274,1089,3619
1,500,200,50,750,3620
2,446,237,96,779,3620
3,435,275,114,824,3620
4,429,293,166,888,3620
5,399,321,187,907,3620
6,412,351,195,958,3620
7,418,328,216,962,3620
8,434,332,253,1019,3620
9,406,384,237,1027,3620
10,402,405,251,1058,3620
11,394,412,269,1075,3620
1,500,200,50,750,3621
2,459,225,100,784,3621
3,421,248,144,813,3621
4,425,272,184,881,3621
5,402,314,207,923,3621
6,394,338,219,951,3621
7,390,348,229,967,3621
8,400,353,254,1007,3621
9,366,378,272,1016,3621
10,387,400,284,1071,3621
11,377,422,275,1074,3621
1,500,200,50,750,3622
2,466,235,90,791,3622
3,441,260,129,830,3622
4,417,273,179,869,3622
5,386,300,203,889,3622
6,399,332,220,951,3622
7,391,348,240,979,3622
8,385,366,263,1014,3622
9,396,376,268,1040,3622
10,392,399,270,1061,3622
11,358,434,289,1081,3622
1,500,200,50,750,3623
2,443,235,118,796,3623
3,411,284,142,837,3623
4,402,303,171,876,3623
5,409,308,206,923,3623
6,401,331,229,961,3623
7,414,334,232,980,3623
8,408,354,232,994,3623
9,418,371,248,1037,3623
10,420,374,256,1050,3623
11,417,418,251,1086,3623
1,500,200,50,750,3624
2,474,206,105,785,3624
3,431,270,136,837,3624
4,414,298,171,883,3624
5,375,338,188,901,3624
6,379,346,216,941,3624
7,391,363,234,988,3624
8,382,375,246,1003,3624
9,393,374,272,1039,3624
10,393,368,285,1046,3624
11,399,388,273,1060,3624
1,500,200,50,750,3625
2,453,218,102,773,3625
3,427,249,125,801,3625
4,443,258,172,873,3625
5,422,297,192,911,3625
6,449,329,203,981,3625
7,432,338,203,973,3625
8,439,348,220,1007,3625
9,424,370,229,1023,3625
10,414,390,251,1055,3625
11,423,402,264,1089,3625
1,500,200,50,750,3626
2,466,225,104,795,3626
3,446,245,133,824,3626
4,422,260,168,850,3626
5,424,316,173,913,3626
6,446,322,198,966,3626
7,439,339,213,991,3626
8,404,373,221,998,3626
9,399,359,253,1011,3626
10,421,394,257,1072,3626
11,412,405,277,1094,3626
1,500,200,50,750,3627
2,449,235,101,785,3627
3,437,258,128,823,3627
4,418,277,168,863,3627
5,421,295,198,914,3627
6,416,328,203,947,3627
7,406,330,232,968,3627
8,412,372,242,1026,3627
9,385,377,263,1025,3627
10,381,388,281,1050,3627
11,362,409,299,1070,3627
1,500,200,50,750,3628
2,470,212,103,785,3628
3,457,237,150,844,3628
4,423,261,186,870,3628
5,431,274,211,916,3628
6,421,294,227,942,3628
7,420,347,218,985,3628
8,399,359,237,995,3628
9,411,380,248,1039,3628
10,387,389,270,1046,3628
11,396,399,283,1078,3628
1,500,200,50,750,3629
2,455,225,109,789,3629
3,415,262,150,827,3629
4,424,282,164,870,3629
5,408,306,195,909,3629
6,402,309,228,939,3629
7,393,359,248,1000,3629
8,380,368,257,1005,3629
9,383,402,258,1043,3629
10,382,407,280,1069,3629
11,364,423,286,1073,3629
1,500,200,50,750,3630
2,444,234,106,784,3630
3,423,246,146,815,3630
4,418,309,164,891,3630
5,397,328,188,913,3630
6,403,354,207,964,3630
7,412,352,230,994,3630
8,388,350,267,1005,3630
9,396,368,272,1036,3630
10,407,382,283,1072,3630
11,389,397,309,1095,3630
1,500,200,50,750,3631
2,450,245,90,785,3631
3,433,262,134,829,3631
4,405,285,178,868,3631
5,405,324,203,932,3631
6,388,343,223,954,3631
7,380,357,234,971,3631
8,365,372,257,994,3631
9,353,413,260,1026,3631
10,361,435,269,1065,3631
11,364,419,304,1087,3631
1,500,200,50,750,3632
2,444,245,93,782,3632
3,411,258,138,807,3632
4,404,298,177,879,3632
5,432,313,187,932,3632
6,443,311,222,976,3632
7,412,336,227,975,3632
8,399,362,241,1002,3632
9,409,389,237,1035,3632
10,385,398,269,1052,3632
11,379,417,282,1078,3632
1,500,200,50,750,3633
2,452,247,90,789,3633
3,418,281,124,823,3633
4,431,299,150,880,3633
5,409,323,170,902,3633
6,430,369,170,969,3633
7,420,369,185,974,3633
8,417,362,209,988,3633
9,413,380,231,1024,3633
10,408,390,251,1049,3633
11,402,398,266,1066,3633
1,500,200,50,750,3634
2,463,217,112,792,3634
3,454,245,141,840,3634
4,434,259,172,865,3634
5,428,317,178,923,3634
6,428,345,194,967,3634
7,389,351,218,958,3634
8,393,349,259,1001,3634
9,386,378,267,1031,3634
10,397,387,284,1068,3634
11,381,416,279,1076,3634
1,500,200,50,750,3635
2,459,237,99,795,3635
3,441,275,125,841,3635
4,437,287,145,869,3635
5,416,330,179,925,3635
6,392,341,206,939,3635
7,406,374,217,997,3635
8,395,374,252,1021,3635
9,381,397,256,1034,3635
10,403,398,265,1066,3635
11,379,399,300,1078,3635
1,500,200,50,750,3636
2,450,233,98,781,3636
3,419,263,145,827,3636
4,431,277,162,870,3636
5,416,315,186,917,3636
6,401,323,216,940,3636
7,394,350,230,974,3636
8,396,373,243,1012,3636
9,390,387,255,1032,3636
10,401,393,257,1051,3636
11,424,408,254,1086,3636
1,500,200,50,750,3637
2,460,238,92,790,3637
3,439,260,123,822,3637
4,437,271,158,866,3637
5,423,302,178,903,3637
6,391,349,205,945,3637
7,424,352,243,1019,3637
8,399,355,247,1001,3637
9,384,379,259,1022,3637
10,386,417,247,1050,3637
11,388,411,274,1073,3637
1,500,200,50,750,3638
2,470,221,99,790,3638
3,431,256,135,822,3638
4,434,278,148,860,3638
5,417,333,169,919,3638
6,415,355,192,962,3638
7,417,340,226,983,3638
8,429,344,243,1016,3638
9,399,375,253,1027,3638
10,415,370,261,1046,3638
11,419,397,258,1074,3638
1,500,200,50,750,3639
2,469,233,83,785,3639
3,449,240,134,823,3639
4,430,286,158,874,3639
5,426,293,192,911,3639
6,437,304,234,975,3639
7,402,347,236,985,3639
8,399,364,239,1002,3639
9,406,371,269,1046,3639
10,387,394,275,1056,3639
11,380,421,276,1077,3639
1,500,200,50,750,3640
2,467,233,89,789,3640
3,428,282,120,830,3640
4,406,294,170,870,3640
5,401,297,209,907,3640
6,408,321,210,939,3640
7,404,343,238,985,3640
8,394,369,243,1006,3640
9,411,377,241,1029,3640
10,404,383,263,1050,3640
11,400,407,265,1072,3640
1,500,200,50,750,3641
2,470,229,95,794,3641
3,429,243,141,813,3641
4,402,281,161,844,3641
5,411,322,188,921,3641
6,430,346,192,968,3641
7,408,368,213,989,3641
8,414,355,245,1014,3641
9,413,360,249,1022,3641
10,406,385,256,1047,3641
11,412,391,267,1070,3641
1,500,200,50,750,3642
2,455,225,91,771,3642
3,415,266,130,811,3642
4,406,279,181,866,3642
5,406,312,195,913,3642
6,404,325,221,950,3642
7,416,346,224,986,3642
8,413,374,228,1015,3642
9,416,353,266,1035,3642
10,410,352,287,1049,3642
11,399,364,289,1052,3642
1,500,200,50,750,3643
2,447,245,96,788,3643
3,433,251,150,834,3643
4,415,279,179,873,3643
5,403,303,195,901,3643
6,443,330,210,983,3643
7,400,348,228,976,3643
8,411,364,232,1007,3643
9,408,393,248,1049,3643
10,393,401,249,1043,3643
11,407,402,276,1085,3643
1,500,200,50,750,3644
2,453,254,94,801,3644
3,407,274,146,827,3644
4,404,294,162,860,3644
5,422,311,183,916,3644
6,411,336,208,955,3644
7,408,348,217,973,3644
8,412,351,228,991,3644
9,410,377,247,1034,3644
10,414,389,259,1062,3644
11,416,382,283,1081,3644
1,500,200,50,750,3645
2,446,241,91,778,3645
3,431,275,131,837,3645
4,418,284,168,870,3645
5,419,308,183,910,3645
6,404,349,196,949,3645
7,408,368,201,977,3645
8,418,372,225,1015,3645
9,406,379,249,1034,3645
10,393,397,262,1052,3645
11,394,407,277,1078,3645
1,500,200,50,750,3646
2,467,210,99,776,3646
3,446,238,144,828,3646
4,429,264,170,863,3646
5,421,294,192,907,3646
6,421,331,213,965,3646
7,392,368,220,980,3646
8,384,387,228,999,3646
9,391,390,240,1021,3646
10,415,400,256,1071,3646
11,388,415,280,1083,3646
1,500,200,50,750,3647
2,462,248,69,779,3647
3,457,267,104,828,3647
4,418,304,133,855,3647
5,426,309,183,918,3647
6,421,326,202,949,3647
7,404,348,229,981,3647
8,413,360,235,1008,3647
9,395,393,246,1034,3647
10,401,375,280,1056,3647
11,416,377,286,1079,3647
1,500,200,50,750,3648
2,454,250,88,792,3648
3,422,254,149,825,3648
4,420,294,157,871,3648
5,413,310,189,912,3648
6,440,324,192,956,3648
7,422,351,211,984,3648
8,392,355,250,997,3648
9,412,393,246,1051,3648
10,408,396,278,1082,3648
11,412,383,306,1101,3648
1,500,200,50,750,3649
2,444,249,94,787,3649
3,407,273,143,823,3649
4,383,298,169,850,3649
5,397,326,187,910,3649
6,409,366,205,980,3649
7,368,379,221,968,3649
8,388,363,260,1011,3649
9,404,391,253,1048,3649
10,399,392,266,1057,3649
11,392,422,271,1085,3649
1,500,200,50,750,3650
2,443,247,94,784,3650
3,418,269,138,825,3650
4,407,297,161,865,3650
5,408,315,184,907,3650
6,420,334,196,950,3650
7,428,333,225,986,3650
8,414,362,238,1014,3650
9,389,382,255,1026,3650
10,390,417,249,1056,3650
11,405,428,266,1099,3650
1,500,200,50,750,3651
2,467,224,100,791,3651
3,450,249,144,843,3651
4,436,276,162,874,3651
5,411,307,197,915,3651
6,404,322,214,940,3651
7,407,344,220,971,3651
8,410,350,231,991,3651
9,415,359,253,1027,3651
10,391,387,274,1052,3651
11,388,424,271,1083,3651
1,500,200,50,750,3652
2,455,235,102,792,3652
3,421,265,132,818,3652
4,407,291,159,857,3652
5,438,311,179,928,3652
6,423,341,198,962,3652
7,407,338,235,980,3652
8,392,363,230,985,3652
9,403,378,232,1013,3652
10,426,391,260,1077,3652
11,395,399,290,1084,3652
1,500,200,50,750,3653
2,467,239,85,791,3653
3,423,258,130,811,3653
4,417,273,169,859,3653
5,422,307,184,913,3653
6,401,341,200,942,3653
7,396,343,225,964,3653
8,410,357,248,1015,3653
9,389,374,260,1023,3653
10,387,396,262,1045,3653
11,399,403,285,1087,3653
1,500,200,50,750,3654
2,441,240,109,790,3654
3,428,260,150,838,3654
4,413,302,164,879,3654
5,406,340,180,926,3654
6,396,326,219,941,3654
7,397,351,234,982,3654
8,393,363,246,1002,3654
9,403,371,240,1014,3654
10,423,382,253,1058,3654
11,414,380,283,1077,3654
1,500,200,50,750,3655
2,461,219,103,783,3655
3,451,235,142,828,3655
4,435,275,163,873,3655
5,429,314,176,919,3655
6,399,326,228,953,3655
7,389,350,244,983,3655
8,391,369,250,1010,3655
9,399,376,251,1026,3655
10,420,376,267,1063,3655
11,421,393,280,1094,3655
1,500,200,50,750,3656
2,460,221,100,781,3656
3,445,251,141,837,3656
4,420,287,164,871,3656
5,399,307,195,901,3656
6,417,326,215,958,3656
7,398,354,242,994,3656
8,377,359,270,1006,3656
9,378,390,269,1037,3656
10,372,396,296,1064,3656
11,373,406,307,1086,3656
1,500,200,50,750,3657
2,454,226,109,789,3657
3,427,264,128,819,3657
4,416,274,177,867,3657
5,408,301,199,908,3657
6,396,342,231,969,3657
7,378,374,225,977,3657
8,382,376,242,1000,3657
9,384,392,255,1031,3657
10,392,413,255,1060,3657
11,386,412,282,1080,3657
1,500,200,50,750,3658
2,451,238,106,795,3658
3,408,259,148,815,3658
4,399,280,177,856,3658
5,408,332,187,927,3658
6,396,331,220,947,3658
7,420,369,219,1008,3658
8,385,380,241,1006,3658
9,404,381,251,1036,3658
10,416,396,252,1064,3658
11,386,412,268,1066,3658
1,500,200,50,750,3659
2,463,231,84,778,3659
3,427,262,137,826,3659
4,418,294,163,875,3659
5,409,311,200,920,3659
6,435,321,215,971,3659
7,414,327,250,991,3659
8,414,336,253,1003,3659
9,397,365,266,1028,3659
10,398,379,282,1059,3659
11,404,412,262,1078,3659
1,500,200,50,750,3660
2,466,221,91,778,3660
3,436,262,135,833,3660
4,404,292,168,864,3660
5,409,313,190,912,3660
6,394,333,225,952,3660
7,423,332,241,996,3660
8,406,342,263,1011,3660
9,420,350,271,1041,3660
10,413,373,257,1043,3660
11,403,396,276,1075,3660
1,500,200,50,750,3661
2,448,225,101,774,3661
3,427,256,127,810,3661
4,439,277,154,870,3661
5,411,310,178,899,3661
6,432,331,209,972,3661
7,410,375,205,990,3661
8,399,379,229,1007,3661
9,409,390,239,1038,3661
10,397,402,262,1061,3661
11,386,420,274,1080,3661
1,500,200,50,750,3662
2,463,220,93,776,3662
3,472,251,125,848,3662
4,432,252,178,862,3662
5,428,275,194,897,3662
6,434,319,225,978,3662
7,413,358,218,989,3662
8,396,382,227,1005,3662
9,390,394,244,1028,3662
10,403,423,260,1086,3662
11,389,427,258,1074,3662
1,500,200,50,750,3663
2,476,232,89,797,3663
3,444,262,121,827,3663
4,417,287,160,864,3663
5,424,324,173,921,3663
6,416,327,206,949,3663
7,412,345,232,989,3663
8,405,370,226,1001,3663
9,404,391,237,1032,3663
10,405,400,257,1062,3663
11,428,396,276,1100,3663
1,500,200,50,750,3664
2,448,249,99,796,3664
3,408,267,152,827,3664
4,398,296,168,862,3664
5,402,313,202,917,3664
6,393,360,219,972,3664
7,397,359,228,984,3664
8,384,383,242,1009,3664
9,373,391,273,1037,3664
10,374,413,284,1071,3664
11,374,381,321,1076,3664
1,500,200,50,750,3665
2,469,215,91,775,3665
3,445,244,130,819,3665
4,432,288,151,871,3665
5,427,313,174,914,3665
6,413,332,200,945,3665
7,410,346,228,984,3665
8,406,330,270,1006,3665
9,422,351,263,1036,3665
10,420,382,255,1057,3665
11,406,403,269,1078,3665
1,500,200,50,750,3666
2,460,231,100,791,3666
3,424,254,142,820,3666
4,407,295,157,859,3666
5,388,320,200,908,3666
6,394,346,216,956,3666
7,383,371,232,986,3666
8,390,391,233,1014,3666
9,372,390,254,1016,3666
10,390,394,260,1044,3666
11,399,395,276,1070,3666
1,500,200,50,750,3667
2,450,223,105,778,3667
3,455,261,130,846,3667
4,430,288,161,879,3667
5,421,296,189,906,3667
6,423,329,213,965,3667
7,417,345,227,989,3667
8,412,373,225,1010,3667
9,383,391,246,1020,3667
10,401,389,276,1066,3667
11,407,410,275,1092,3667
1,500,200,50,750,3668
2,462,233,91,786,3668
3,449,257,139,845,3668
4,427,277,156,860,3668
5,389,335,173,897,3668
6,412,355,201,968,3668
7,400,370,211,981,3668
8,378,379,245,1002,3668
9,400,394,248,1042,3668
10,399,408,241,1048,3668
11,413,419,260,1092,3668
1,500,200,50,750,3669
2,437,245,101,783,3669
3,392,270,149,811,3669
4,381,303,176,860,3669
5,394,342,189,925,3669
6,380,379,201,960,3669
7,377,376,225,978,3669
8,374,374,250,998,3669
9,381,388,268,1037,3669
10,377,393,283,1053,3669
11,369,415,280,1064,3669
1,500,200,50,750,3670
2,473,216,97,786,3670
3,441,262,133,836,3670
4,411,275,182,868,3670
5,401,303,201,905,3670
6,416,316,219,951,3670
7,404,340,225,969,3670
8,399,359,253,1011,3670
9,395,374,261,1030,3670
10,393,378,278,1049,3670
11,396,400,281,1077,3670
1,500,200,50,750,3671
2,465,236,88,789,3671
3,441,264,125,830,3671
4,416,270,165,851,3671
5,422,297,188,907,3671
6,425,316,215,956,3671
7,431,334,212,977,3671
8,442,325,240,1007,3671
9,434,373,231,1038,3671
10,409,393,239,1041,3671
11,414,411,258,1083,3671
1,500,200,50,750,3672
2,454,210,124,788,3672
3,441,238,151,830,3672
4,427,276,167,870,3672
5,417,298,198,913,3672
6,414,337,218,969,3672
7,414,346,232,992,3672
8,415,361,232,1008,3672
9,407,383,241,1031,3672
10,393,403,245,1041,3672
11,414,427,261,1102,3672
1,500,200,50,750,3673
2,475,218,99,792,3673
3,441,266,135,842,3673
4,420,253,181,854,3673
5,417,299,192,908,3673
6,439,328,223,990,3673
7,401,350,231,982,3673
8,387,368,255,1010,3673
9,394,362,264,1020,3673
10,413,406,246,1065,3673
11,417,401,276,1094,3673
1,500,200,50,750,3674
2,456,230,108,794,3674
3,445,242,131,818,3674
4,431,269,163,863,3674
5,421,294,182,897,3674
6,419,331,206,956,3674
7,384,356,232,972,3674
8,408,380,234,1022,3674
9,403,360,275,1038,3674
10,408,356,286,1050,3674
11,401,382,286,1069,3674
1,500,200,50,750,3675
2,481,200,99,780,3675
3,446,250,128,824,3675
4,429,276,166,871,3675
5,420,303,189,912,3675
6,426,334,202,962,3675
7,426,348,219,993,3675
8,399,375,232,1006,3675
9,396,386,246,1028,3675
10,419,409,229,1057,3675
11,417,412,266,1095,3675
1,500,200,50,750,3676
2,454,221,113,788,3676
3,427,255,144,826,3676
4,421,291,163,875,3676
5,408,321,187,916,3676
6,406,330,229,965,3676
7,399,350,236,985,3676
8,392,377,237,1006,3676
9,396,414,242,1052,3676
10,389,417,244,1050,3676
11,417,442,240,1099,3676
1,500,200,50,750,3677
2,460,217,109,786,3677
3,452,247,146,845,3677
4,404,288,171,863,3677
5,426,297,201,924,3677
6,420,328,202,950,3677
7,412,333,224,969,3677
8,416,352,237,1005,3677
9,400,368,253,1021,3677
10,384,382,281,1047,3677
11,398,396,282,1076,3677
1,500,200,50,750,3678
2,456,232,105,793,3678
3,416,273,140,829,3678
4,375,314,164,853,3678
5,387,317,208,912,3678
6,396,335,222,953,3678
7,392,337,248,977,3678
8,386,367,248,1001,3678
9,396,377,263,1036,3678
10,398,378,278,1054,3678
11,426,399,265,1090,3678
1,500,200,50,750,3679
2,467,238,88,793,3679
3,428,256,140,824,3679
4,406,286,173,865,3679
5,411,323,179,913,3679
6,417,327,216,960,3679
7,398,348,243,989,3679
8,408,325,263,996,3679
9,421,338,285,1044,3679
10,404,376,293,1073,3679
11,399,385,302,1086,3679
1,500,200,50,750,3680
2,470,229,95,794,3680
3,445,266,127,838,3680
4,411,295,173,879,3680
5,415,299,212,926,3680
6,404,328,220,952,3680
7,412,337,232,981,3680
8,398,359,239,996,3680
9,412,387,246,1045,3680
10,412,402,262,1076,3680
11,388,420,274,1082,3680
1,500,200,50,750,3681
2,459,211,108,778,3681
3,445,245,134,824,3681
4,412,295,170,877,3681
5,411,313,195,919,3681
6,396,348,199,943,3681
7,401,353,227,981,3681
8,377,376,232,985,3681
9,409,383,232,1024,3681
10,428,380,259,1067,3681
11,441,400,261,1102,3681
1,500,200,50,750,3682
2,468,229,93,790,3682
3,440,263,138,841,3682
4,401,293,175,869,3682
5,407,294,211,912,3682
6,406,321,210,937,3682
7,429,336,221,986,3682
8,413,348,230,991,3682
9,431,344,260,1035,3682
10,389,386,270,1045,3682
11,391,385,294,1070,3682
1,500,200,50,750,3683
2,461,222,106,789,3683
3,455,250,131,836,3683
4,438,286,154,878,3683
5,405,311,193,909,3683
6,422,320,216,958,3683
7,419,352,215,986,3683
8,394,360,227,981,3683
9,408,373,258,1039,3683
10,411,390,262,1063,3683
11,410,415,261,1086,3683
1,500,200,50,750,3684
2,449,241,94,784,3684
3,437,252,137,826,3684
4,414,294,166,874,3684
5,406,327,187,920,3684
6,419,345,203,967,3684
7,421,336,234,991,3684
8,397,357,258,1012,3684
9,378,365,272,1015,3684
10,391,395,266,1052,3684
11,402,414,270,1086,3684
1,500,200,50,750,3685
2,464,235,100,799,3685
3,443,259,137,839,3685
4,417,297,155,869,3685
5,391,317,184,892,3685
6,423,334,227,984,3685
7,416,348,232,996,3685
8,403,350,252,1005,3685
9,394,357,263,1014,3685
10,424,365,271,1060,3685
11,400,399,274,1073,3685
1,500,200,50,750,3686
2,463,240,94,797,3686
3,428,251,125,804,3686
4,437,284,166,887,3686
5,408,305,181,894,3686
6,416,322,213,951,3686
7,402,339,236,977,3686
8,398,377,248,1023,3686
9,375,398,249,1022,3686
10,372,407,273,1052,3686
11,370,415,304,1089,3686
1,500,200,50,750,3687
2,470,227,88,785,3687
3,418,258,137,813,3687
4,442,283,158,883,3687
5,444,294,177,915,3687
6,429,330,196,955,3687
7,420,347,210,977,3687
8,405,372,234,1011,3687
9,392,387,243,1022,3687
10,405,391,259,1055,3687
11,405,422,258,1085,3687
1,500,200,50,750,3688
2,440,232,107,779,3688
3,419,265,143,827,3688
4,385,312,172,869,3688
5,373,359,174,906,3688
6,394,365,203,962,3688
7,388,369,229,986,3688
8,410,382,235,1027,3688
9,408,367,264,1039,3688
10,394,376,273,1043,3688
11,384,400,296,1080,3688
1,500,200,50,750,3689
2,459,216,109,784,3689
3,439,250,145,834,3689
4,434,273,165,872,3689
5,434,303,179,916,3689
6,419,330,198,947,3689
7,422,351,212,985,3689
8,408,364,232,1004,3689
9,414,381,257,1052,3689
10,395,395,268,1058,3689
11,400,426,264,1090,3689
1,500,200,50,750,3690
2,447,237,109,793,3690
3,409,271,138,818,3690
4,404,303,171,878,3690
5,413,310,197,920,3690
6,389,340,204,933,3690
7,386,375,219,980,3690
8,397,372,238,1007,3690
9,411,367,258,1036,3690
10,394,399,266,1059,3690
11,394,413,279,1086,3690
1,500,200,50,750,3691
2,464,222,98,784,3691
3,451,251,129,831,3691
4,435,294,154,883,3691
5,416,293,193,902,3691
6,371,327,227,925,3691
7,386,337,243,966,3691
8,385,358,260,1003,3691
9,398,379,275,1052,3691
10,371,421,273,1065,3691
11,361,428,283,1072,3691
1,500,200,50,750,3692
2,475,211,101,787,3692
3,460,242,134,836,3692
4,420,275,172,867,3692
5,431,296,186,913,3692
6,425,311,227,963,3692
7,416,345,223,984,3692
8,401,355,241,997,3692
9,399,376,256,1031,3692
10,371,411,270,1052,3692
11,375,422,288,1085,3692
1,500,200,50,750,3693
2,464,228,100,792,3693
3,439,252,129,820,3693
4,436,289,165,890,3693
5,434,290,204,928,3693
6,425,318,208,951,3693
7,398,353,217,968,3693
8,408,378,230,1016,3693
9,396,376,255,1027,3693
10,366,397,295,1058,3693
11,381,404,288,1073,3693
1,500,200,50,750,3694
2,449,239,90,778,3694
3,409,286,119,814,3694
4,411,293,158,862,3694
5,423,294,196,913,3694
6,406,328,204,938,3694
7,396,341,237,974,3694
8,386,390,249,1025,3694
9,386,406,251,1043,3694
10,380,408,253,1041,3694
11,405,416,256,1077,3694
1,500,200,50,750,3695
2,450,240,100,790,3695
3,426,277,130,833,3695
4,398,304,159,861,3695
5,397,318,188,903,3695
6,402,336,206,944,3695
7,401,357,217,975,3695
8,398,379,229,1006,3695
9,419,377,233,1029,3695
10,394,384,248,1026,3695
11,410,420,260,1090,3695
1,500,200,50,750,3696
2,431,249,107,787,3696
3,438,259,141,838,3696
4,415,292,155,862,3696
5,419,312,181,912,3696
6,406,343,220,969,3696
7,371,373,239,983,3696
8,355,395,259,1009,3696
9,372,413,255,1040,3696
10,373,443,247,1063,3696
11,387,436,257,1080,3696
1,500,200,50,750,3697
2,441,219,107,767,3697
3,429,249,143,821,3697
4,396,292,174,862,3697
5,397,313,187,897,3697
6,397,339,199,935,3697
7,402,371,209,982,3697
8,377,389,234,1000,3697
9,380,417,248,1045,3697
10,374,425,257,1056,3697
11,378,409,289,1076,3697
1,500,200,50,750,3698
2,466,240,89,795,3698
3,439,282,122,843,3698
4,429,284,157,870,3698
5,412,317,171,900,3698
6,410,348,199,957,3698
7,403,386,202,991,3698
8,398,378,232,1008,3698
9,389,375,256,1020,3698
10,408,394,255,1057,3698
11,410,400,272,1082,3698
1,500,200,50,750,3699
2,447,238,95,780,3699
3,422,262,133,817,3699
4,411,276,173,860,3699
5,424,299,210,933,3699
6,395,320,229,944,3699
7,408,335,233,976,3699
8,399,351,247,997,3699
9,411,369,258,1038,3699
10,412,382,263,1057,3699
11,415,425,265,1105,3699
1,500,200,50,750,3700
2,451,233,101,785,3700
3,444,257,127,828,3700
4,442,273,154,869,3700
5,429,316,176,921,3700
6,409,350,195,954,3700
7,401,351,221,973,3700
8,423,341,252,1016,3700
9,438,364,240,1042,3700
10,445,356,267,1068,3700
11,435,380,280,1095,3700
1,500,200,50,750,3701
2,445,236,90,771,3701
3,444,268,130,842,3701
4,418,277,174,869,3701
5,411,297,197,905,3701
6,407,323,240,970,3701
7,400,322,262,984,3701
8,396,365,258,1019,3701
9,393,375,263,1031,3701
10,409,377,277,1063,3701
11,393,383,295,1071,3701
1,500,200,50,750,3702
2,455,237,90,782,3702
3,415,270,136,821,3702
4,412,281,167,860,3702
5,398,309,190,897,3702
6,401,331,226,958,3702
7,396,347,243,986,3702
8,396,363,255,1014,3702
9,384,357,276,1017,3702
10,382,392,285,1059,3702
11,383,427,280,1090,3702
1,500,200,50,750,3703
2,457,230,94,781,3703
3,426,287,117,830,3703
4,407,307,152,866,3703
5,385,331,191,907,3703
6,402,332,226,960,3703
7,403,355,228,986,3703
8,396,380,233,1009,3703
9,398,398,245,1041,3703
10,402,387,252,1041,3703
11,402,427,244,1073,3703
1,500,200,50,750,3704
2,478,214,104,796,3704
3,445,267,127,839,3704
4,436,288,156,880,3704
5,401,316,189,906,3704
6,419,323,209,951,3704
7,428,314,225,967,3704
8,421,348,227,996,3704
9,408,351,252,1011,3704
10,418,386,242,1046,3704
11,398,403,275,1076,3704
1,500,200,50,750,3705
2,457,218,104,779,3705
3,437,247,143,827,3705
4,429,276,162,867,3705
5,426,336,176,938,3705
6,418,353,197,968,3705
7,393,365,217,975,3705
8,394,380,246,1020,3705
9,392,389,249,1030,3705
10,389,392,270,1051,3705
11,403,406,262,1071,3705
1,500,200,50,750,3706
2,452,241,94,787,3706
3,429,264,136,829,3706
4,412,266,179,857,3706
5,412,308,189,909,3706
6,412,340,213,965,3706
7,407,359,219,985,3706
8,352,387,248,987,3706
9,369,391,257,1017,3706
10,366,404,281,1051,3706
11,372,419,280,1071,3706
1,500,200,50,750,3707
2,454,244,98,796,3707
3,420,262,153,835,3707
4,386,313,165,864,3707
5,388,333,187,908,3707
6,401,340,227,968,3707
7,388,345,249,982,3707
8,389,355,257,1001,3707
9,388,377,271,1036,3707
10,400,387,275,1062,3707
11,406,422,251,1079,3707
1,500,200,50,750,3708
2,449,238,90,777,3708
3,428,259,127,814,3708
4,422,295,147,864,3708
5,423,304,168,895,3708
6,448,307,208,963,3708
7,422,336,216,974,3708
8,417,350,231,998,3708
9,421,366,248,1035,3708
10,443,371,256,1070,3708
11,437,399,245,1081,3708
1,500,200,50,750,3709
2,477,208,106,791,3709
3,449,229,151,829,3709
4,429,262,173,864,3709
5,429,297,181,907,3709
6,415,324,216,955,3709
7,389,352,242,983,3709
8,377,358,264,999,3709
9,397,395,238,1030,3709
10,385,404,266,1055,3709
11,397,434,265,1096,3709
1,500,200,50,750,3710
2,453,244,100,797,3710
3,436,268,128,832,3710
4,403,303,140,846,3710
5,405,331,159,895,3710
6,436,345,188,969,3710
7,406,348,220,974,3710
8,408,359,231,998,3710
9,404,392,235,1031,3710
10,404,409,242,1055,3710
11,391,425,265,1081,3710
1,500,200,50,750,3711
2,439,238,101,778,3711
3,406,286,137,829,3711
4,388,302,174,864,3711
5,419,304,194,917,3711
6,431,343,199,973,3711
7,390,366,217,973,3711
8,400,353,247,1000,3711
9,412,360,270,1042,3711
10,381,395,258,1034,3711
11,398,387,284,1069,3711
1,500,200,50,750,3712
2,474,224,104,802,3712
3,450,244,140,834,3712
4,432,261,176,869,3712
5,415,307,192,914,3712
6,424,327,217,968,3712
7,395,353,230,978,3712
8,379,384,238,1001,3712
9,413,405,246,1064,3712
10,389,414,258,1061,3712
11,382,427,281,1090,3712
1,500,200,50,750,3713
2,461,248,90,799,3713
3,420,264,139,823,3713
4,401,300,146,847,3713
5,386,338,191,915,3713
6,392,348,221,961,3713
7,372,367,234,973,3713
8,375,399,228,1002,3713
9,369,410,257,1036,3713
10,369,460,232,1061,3713
11,381,452,264,1097,3713
1,500,200,50,750,3714
2,441,250,93,784,3714
3,432,254,139,825,3714
4,398,281,169,848,3714
5,393,326,205,924,3714
6,387,343,220,950,3714
7,404,358,218,980,3714
8,397,361,237,995,3714
9,426,376,237,1039,3714
10,417,410,227,1054,3714
11,432,411,255,1098,3714
1,500,200,50,750,3715
2,461,222,95,778,3715
3,442,242,136,820,3715
4,431,284,171,886,3715
5,425,295,191,911,3715
6,428,305,228,961,3715
7,412,299,254,965,3715
8,413,341,248,1002,3715
9,403,376,252,1031,3715
10,405,389,262,1056,3715
11,422,413,247,1082,3715
1,500,200,50,750,3716
2,450,237,102,789,3716
3,440,260,132,832,3716
4,418,286,164,868,3716
5,378,335,188,901,3716
6,374,348,213,935,3716
7,370,367,238,975,3716
8,394,367,257,1018,3716
9,384,384,272,1040,3716
10,407,381,281,1069,3716
11,400,384,302,1086,3716
1,500,200,50,750,3717
2,452,232,97,781,3717
3,447,269,119,835,3717
4,421,304,140,865,3717
5,413,319,179,911,3717
6,402,331,212,945,3717
7,396,360,234,990,3717
8,378,390,241,1009,3717
9,391,404,248,1043,3717
10,394,381,279,1054,3717
11,396,403,275,1074,3717
1,500,200,50,750,3718
2,449,248,90,787,3718
3,417,263,139,819,3718
4,419,277,173,869,3718
5,430,300,193,923,3718
6,418,309,219,946,3718
7,406,346,229,981,3718
8,412,357,235,1004,3718
9,396,375,252,1023,3718
10,399,398,266,1063,3718
11,406,416,259,1081,3718
1,500,200,50,750,3719
2,464,257,93,814,3719
3,408,266,153,827,3719
4,401,283,189,873,3719
5,412,307,199,918,3719
6,406,339,218,963,3719
7,373,355,245,973,3719
8,372,375,255,1002,3719
9,365,397,277,1039,3719
10,401,393,287,1081,3719
11,390,404,291,1085,3719
1,500,200,50,750,3720
2,452,228,108,788,3720
3,398,267,145,810,3720
4,403,286,174,863,3720
5,399,327,190,916,3720
6,390,353,207,950,3720
7,371,362,247,980,3720
8,375,369,260,1004,3720
9,369,400,252,1021,3720
10,372,396,273,1041,3720
11,373,433,281,1087,3720
1,500,200,50,750,3721
2,467,219,99,785,3721
3,431,268,131,830,3721
4,407,287,173,867,3721
5,428,309,181,918,3721
6,432,327,202,961,3721
7,419,349,209,977,3721
8,412,378,215,1005,3721
9,410,385,227,1022,3721
10,427,394,252,1073,3721
11,418,373,280,1071,3721
1,500,200,50,750,3722
2,466,210,122,798,3722
3,420,267,148,835,3722
4,389,288,187,864,3722
5,404,299,206,909,3722
6,393,355,226,974,3722
7,377,356,250,983,3722
8,386,383,231,1000,3722
9,409,372,256,1037,3722
10,382,389,274,1045,3722
11,396,397,285,1078,3722
1,500,200,50,750,3723
2,449,222,117,788,3723
3,421,243,152,816,3723
4,407,266,167,840,3723
5,430,286,186,902,3723
6,438,336,208,982,3723
7,397,338,235,970,3723
8,398,347,261,1006,3723
9,375,379,265,1019,3723
10,400,409,286,1095,3723
11,392,397,296,1085,3723
1,500,200,50,750,3724
2,436,250,96,782,3724
3,425,279,121,825,3724
4,410,320,133,863,3724
5,406,332,170,908,3724
6,401,350,189,940,3724
7,409,365,212,986,3724
8,404,377,228,1009,3724
9,398,371,256,1025,3724
10,405,376,273,1054,3724
11,419,389,272,1080,3724
1,500,200,50,750,3725
2,438,233,100,771,3725
3,418,278,129,825,3725
4,416,290,159,865,3725
5,419,290,195,904,3725
6,395,322,220,937,3725
7,396,354,235,985,3725
8,401,336,266,1003,3725
9,396,361,269,1026,3725
10,405,378,271,1054,3725
11,393,409,295,1097,3725
1,500,200,50,750,3726
2,469,228,92,789,3726
3,447,238,137,822,3726
4,424,280,157,861,3726
5,418,305,191,914,3726
6,415,323,213,951,3726
7,398,371,228,997,3726
8,394,371,254,1019,3726
9,417,363,261,1041,3726
10,417,378,268,1063,3726
11,410,405,262,1077,3726
1,500,200,50,750,3727
2,452,237,91,780,3727
3,436,242,137,815,3727
4,432,280,159,871,3727
5,406,338,163,907,3727
6,400,355,200,955,3727
7,394,374,211,979,3727
8,391,375,229,995,3727
9,414,369,248,1031,3727
10,395,378,285,1058,3727
11,416,399,277,1092,3727
1,500,200,50,750,3728
2,471,215,92,778,3728
3,445,250,122,817,3728
4,429,258,170,857,3728
5,411,305,174,890,3728
6,426,323,204,953,3728
7,426,342,221,989,3728
8,411,354,237,1002,3728
9,427,380,223,1030,3728
10,429,378,245,1052,3728
11,423,410,249,1082,3728
1,500,200,50,750,3729
2,432,247,97,776,3729
3,429,259,133,821,3729
4,409,285,156,850,3729
5,412,318,176,906,3729
6,409,340,193,942,3729
7,416,367,212,995,3729
8,401,372,242,1015,3729
9,391,368,269,1028,3729
10,403,389,279,1071,3729
11,400,412,272,1084,3729
1,500,200,50,750,3730
2,460,228,91,779,3730
3,440,262,130,832,3730
4,414,287,169,870,3730
5,405,303,205,913,3730
6,391,339,215,945,3730
7,405,339,232,976,3730
8,415,346,252,1013,3730
9,415,358,252,1025,3730
10,388,419,267,1074,3730
11,375,435,274,1084,3730
1,500,200,50,750,3731
2,462,223,95,780,3731
3,413,255,154,822,3731
4,409,287,167,863,3731
5,408,321,191,920,3731
6,412,345,198,955,3731
7,409,357,218,984,3731
8,379,377,241,997,3731
9,381,388,263,1032,3731
10,390,370,290,1050,3731
11,410,382,294,1086,3731
1,500,200,50,750,3732
2,453,237,96,786,3732
3,451,278,108,837,3732
4,424,275,159,858,3732
5,403,291,187,881,3732
6,421,326,191,938,3732
7,404,331,225,960,3732
8,396,367,235,998,3732
9,404,391,243,1038,3732
10,394,385,265,1044,3732
11,382,421,274,1077,3732
1,500,200,50,750,3733
2,444,237,111,792,3733
3,419,265,140,824,3733
4,395,295,171,861,3733
5,413,322,185,920,3733
6,400,348,192,940,3733
7,404,363,219,986,3733
8,382,365,251,998,3733
9,409,355,262,1026,3733
10,396,373,272,1041,3733
11,400,403,280,1083,3733
1,500,200,50,750,3734
2,444,242,101,787,3734
3,432,252,138,822,3734
4,417,277,170,864,3734
5,426,298,175,899,3734
6,450,323,195,968,3734
7,450,333,210,993,3734
8,431,346,225,1002,3734
9,432,368,238,1038,3734
10,429,377,265,1071,3734
11,424,401,265,1090,3734
1,500,200,50,750,3735
2,451,226,105,782,3735
3,423,251,153,827,3735
4,406,286,170,862,3735
5,437,279,195,911,3735
6,406,300,229,935,3735
7,402,338,262,1002,3735
8,389,357,250,996,3735
9,387,389,256,1032,3735
10,389,406,264,1059,3735
11,405,407,271,1083,3735
1,500,200,50,750,3736
2,463,223,113,799,3736
3,442,251,141,834,3736
4,408,301,155,864,3736
5,392,322,187,901,3736
6,403,337,228,968,3736
7,365,368,233,966,3736
8,377,381,250,1008,3736
9,389,375,271,1035,3736
10,422,381,269,1072,3736
11,409,416,259,1084,3736
1,500,200,50,750,3737
2,459,235,89,783,3737
3,433,248,144,825,3737
4,424,284,155,863,3737
5,417,287,205,909,3737
6,413,327,213,953,3737
7,397,339,236,972,3737
8,402,337,264,1003,3737
9,419,344,272,1035,3737
10,416,379,280,1075,3737
11,400,398,280,1078,3737
1,500,200,50,750,3738
2,457,244,97,798,3738
3,442,256,133,831,3738
4,422,262,179,863,3738
5,412,266,208,886,3738
6,420,320,227,967,3738
7,399,328,238,965,3738
8,416,366,230,1012,3738
9,410,381,232,1023,3738
10,430,370,262,1062,3738
11,407,414,263,1084,3738
1,500,200,50,750,3739
2,449,239,100,788,3739
3,415,271,137,823,3739
4,407,304,171,882,3739
5,396,318,205,919,3739
6,392,326,231,949,3739
7,395,332,249,976,3739
8,410,345,258,1013,3739
9,386,366,266,1018,3739
10,385,370,282,1037,3739
11,401,414,285,1100,3739
1,500,200,50,750,3740
2,475,222,94,791,3740
3,437,252,134,823,3740
4,417,279,165,861,3740
5,401,336,175,912,3740
6,396,356,205,957,3740
7,420,337,222,979,3740
8,422,334,222,978,3740
9,432,375,230,1037,3740
10,429,390,221,1040,3740
11,411,406,247,1064,3740
1,500,200,50,750,3741
2,465,236,99,800,3741
3,416,272,132,820,3741
4,387,322,165,874,3741
5,378,330,196,904,3741
6,388,343,226,957,3741
7,381,349,243,973,3741
8,372,365,257,994,3741
9,379,365,274,1018,3741
10,375,394,283,1052,3741
11,381,405,286,1072,3741
1,500,200,50,750,3742
2,460,226,95,781,3742
3,428,259,133,820,3742
4,410,282,178,870,3742
5,441,296,184,921,3742
6,435,322,202,959,3742
7,412,370,205,987,3742
8,407,360,242,1009,3742
9,393,370,253,1016,3742
10,415,408,249,1072,3742
11,388,399,283,1070,3742
1,500,200,50,750,3743
2,454,249,90,793,3743
3,424,276,133,833,3743
4,393,295,169,857,3743
5,384,331,198,913,3743
6,380,352,236,968,3743
7,363,364,250,977,3743
8,385,376,250,1011,3743
9,390,377,259,1026,3743
10,389,390,276,1055,3743
11,407,393,268,1068,3743
1,500,200,50,750,3744
2,459,234,98,791,3744
3,439,236,152,827,3744
4,420,271,182,873,3744
5,411,296,207,914,3744
6,421,328,209,958,3744
7,409,345,220,974,3744
8,442,344,227,1013,3744
9,421,378,224,1023,3744
10,420,373,248,1041,3744
11,444,392,251,1087,3744
1,500,200,50,750,3745
2,454,212,116,782,3745
3,432,261,135,828,3745
4,409,301,162,872,3745
5,388,318,195,901,3745
6,399,329,221,949,3745
7,381,345,245,971,3745
8,391,358,258,1007,3745
9,396,369,259,1024,3745
10,392,397,267,1056,3745
11,396,402,277,1075,3745
1,500,200,50,750,3746
2,448,242,100,790,3746
3,426,273,141,840,3746
4,413,284,175,872,3746
5,400,332,186,918,3746
6,397,337,213,947,3746
7,396,368,213,977,3746
8,399,362,253,1014,3746
9,388,395,249,1032,3746
10,380,390,286,1056,3746
11,368,417,301,1086,3746
1,500,200,50,750,3747
2,474,229,85,788,3747
3,454,240,128,822,3747
4,437,274,172,883,3747
5,431,320,178,929,3747
6,433,332,207,972,3747
7,394,344,235,973,3747
8,412,367,227,1006,3747
9,409,376,248,1033,3747
10,431,356,271,1058,3747
11,429,386,269,1084,3747
1,500,200,50,750,3748
2,445,240,94,779,3748
3,435,275,127,837,3748
4,424,251,185,860,3748
5,417,281,208,906,3748
6,423,319,211,953,3748
7,392,330,243,965,3748
8,398,352,249,999,3748
9,403,364,266,1033,3748
10,401,397,264,1062,3748
11,406,430,270,1106,3748
1,500,200,50,750,3749
2,469,230,96,795,3749
3,454,254,112,820,3749
4,429,303,138,870,3749
5,421,323,169,913,3749
6,435,332,199,966,3749
7,425,334,210,969,3749
8,410,347,241,998,3749
9,406,368,258,1032,3749
10,416,381,263,1060,3749
11,402,398,291,1091,3749
1,500,200,50,750,3750
2,467,232,91,790,3750
3,429,244,151,824,3750
4,412,270,177,859,3750
5,411,293,203,907,3750
6,415,333,207,955,3750
7,405,358,213,976,3750
8,395,397,223,1015,3750
9,389,387,251,1027,3750
10,395,396,265,1056,3750
11,408,412,277,1097,3750
1,500,200,50,750,3751
2,472,228,98,798,3751
3,435,263,134,832,3751
4,415,298,146,859,3751
5,414,337,173,924,3751
6,409,354,197,960,3751
7,394,369,223,986,3751
8,378,375,242,995,3751
9,372,405,250,1027,3751
10,388,407,264,1059,3751
11,395,418,265,1078,3751
1,500,200,50,750,3752
2,469,223,102,794,3752
3,447,262,143,852,3752
4,413,297,168,878,3752
5,409,323,193,925,3752
6,392,346,219,957,3752
7,385,365,240,990,3752
8,373,367,248,988,3752
9,387,386,255,1028,3752
10,374,389,277,1040,3752
11,392,398,293,1083,3752
1,500,200,50,750,3753
2,472,225,98,795,3753
3,423,246,158,827,3753
4,415,277,166,858,3753
5,405,284,220,909,3753
6,392,324,226,942,3753
7,386,362,239,987,3753
8,403,364,235,1002,3753
9,394,392,249,1035,3753
10,399,386,270,1055,3753
11,413,387,288,1088,3753
1,500,200,50,750,3754
2,453,222,100,775,3754
3,415,259,135,809,3754
4,418,285,160,863,3754
5,402,327,182,911,3754
6,427,343,198,968,3754
7,406,349,219,974,3754
8,400,359,241,1000,3754
9,419,362,247,1028,3754
10,417,400,245,1062,3754
11,405,403,267,1075,3754
1,500,200,50,750,3755
2,458,239,85,782,3755
3,433,265,128,826,3755
4,400,295,170,865,3755
5,407,300,198,905,3755
6,385,339,216,940,3755
7,378,347,240,965,3755
8,381,341,275,997,3755
9,390,384,255,1029,3755
10,382,389,262,1033,3755
11,423,405,270,1098,3755
1,500,200,50,750,3756
2,463,229,103,795,3756
3,426,254,140,820,3756
4,418,301,155,874,3756
5,428,298,187,913,3756
6,433,327,205,965,3756
7,400,356,212,968,3756
8,411,377,238,1026,3756
9,392,398,238,1028,3756
10,364,404,275,1043,3756
11,409,396,272,1077,3756
1,500,200,50,750,3757
2,475,232,85,792,3757
3,451,253,127,831,3757
4,423,284,148,855,3757
5,427,341,182,950,3757
6,385,367,206,958,3757
7,357,377,234,968,3757
8,394,358,262,1014,3757
9,395,373,264,1032,3757
10,407,394,269,1070,3757
11,395,411,274,1080,3757
1,500,200,50,750,3758
2,451,235,93,779,3758
3,421,275,130,826,3758
4,406,300,161,867,3758
5,416,311,181,908,3758
6,432,322,212,966,3758
7,418,334,225,977,3758
8,432,354,228,1014,3758
9,408,360,260,1028,3758
10,411,369,268,1048,3758
11,418,409,261,1088,3758
1,500,200,50,750,3759
2,475,226,91,792,3759
3,438,257,124,819,3759
4,418,290,158,866,3759
5,404,320,181,905,3759
6,396,350,202,948,3759
7,398,374,217,989,3759
8,404,347,253,1004,3759
9,395,384,253,1032,3759
10,403,416,257,1076,3759
11,414,394,276,1084,3759
1,500,200,50,750,3760
2,438,247,94,779,3760
3,430,249,142,821,3760
4,403,275,172,850,3760
5,410,331,168,909,3760
6,420,340,210,970,3760
7,411,337,241,989,3760
8,410,365,248,1023,3760
9,397,370,265,1032,3760
10,388,392,266,1046,3760
11,388,409,272,1069,3760
1,500,200,50,750,3761
2,460,220,107,787,3761
3,422,261,134,817,3761
4,404,296,163,863,3761
5,418,309,185,912,3761
6,413,342,197,952,3761
7,406,370,218,994,3761
8,396,399,226,1021,3761
9,390,385,260,1035,3761
10,386,403,268,1057,3761
11,399,383,292,1074,3761
1,500,200,50,750,3762
2,456,257,76,789,3762
3,428,276,120,824,3762
4,416,283,174,873,3762
5,399,310,194,903,3762
6,403,340,202,945,3762
7,414,354,215,983,3762
8,413,362,235,1010,3762
9,380,406,230,1016,3762
10,397,421,245,1063,3762
11,407,405,280,1092,3762
1,500,200,50,750,3763
2,462,225,85,772,3763
3,448,246,131,825,3763
4,441,277,141,859,3763
5,409,297,178,884,3763
6,425,315,207,947,3763
7,437,329,234,1000,3763
8,414,329,253,996,3763
9,402,388,248,1038,3763
10,393,410,259,1062,3763
11,395,396,300,1091,3763
1,500,200,50,750,3764
2,448,237,106,791,3764
3,429,271,126,826,3764
4,413,311,148,872,3764
5,409,331,168,908,3764
6,407,360,196,963,3764
7,388,364,221,973,3764
8,374,401,243,1018,3764
9,378,392,260,1030,3764
10,381,428,254,1063,3764
11,385,416,277,1078,3764
1,500,200,50,750,3765
2,458,233,84,775,3765
3,438,265,127,830,3765
4,423,282,153,858,3765
5,413,317,188,918,3765
6,394,350,204,948,3765
7,367,373,232,972,3765
8,361,386,256,1003,3765
9,364,380,279,1023,3765
10,381,391,280,1052,3765
11,375,398,300,1073,3765
1,500,200,50,750,3766
2,465,237,97,799,3766
3,429,244,143,816,3766
4,399,275,180,854,3766
5,395,310,206,911,3766
6,399,337,217,953,3766
7,400,353,233,986,3766
8,389,377,258,1024,3766
9,373,400,259,1032,3766
10,389,413,255,1057,3766
11,409,406,274,1089,3766
1,500,200,50,750,3767
2,470,229,87,786,3767
3,449,245,125,819,3767
4,419,279,163,861,3767
5,426,314,182,922,3767
6,406,328,213,947,3767
7,413,357,224,994,3767
8,404,363,234,1001,3767
9,400,370,265,1035,3767
10,409,366,283,1058,3767
11,415,398,280,1093,3767
1,500,200,50,750,3768
2,453,254,99,806,3768
3,421,274,139,834,3768
4,394,309,172,875,3768
5,380,336,195,911,3768
6,391,337,224,952,3768
7,390,359,229,978,3768
8,390,367,250,1007,3768
9,401,360,276,1037,3768
10,394,399,257,1050,3768
11,421,404,271,1096,3768
1,500,200,50,750,3769
2,468,222,106,796,3769
3,426,241,151,818,3769
4,414,269,174,857,3769
5,392,311,210,913,3769
6,414,341,217,972,3769
7,398,352,235,985,3769
8,373,393,243,1009,3769
9,371,414,263,1048,3769
10,389,402,267,1058,3769
11,388,395,283,1066,3769
1,500,200,50,750,3770
2,472,219,89,780,3770
3,450,239,137,826,3770
4,409,283,153,845,3770
5,431,310,169,910,3770
6,431,320,198,949,3770
7,423,332,232,987,3770
8,429,354,230,1013,3770
9,413,373,256,1042,3770
10,404,387,261,1052,3770
11,404,407,273,1084,3770
1,500,200,50,750,3771
2,482,215,103,800,3771
3,424,262,138,824,3771
4,399,305,159,863,3771
5,395,342,173,910,3771
6,389,370,205,964,3771
7,365,362,235,962,3771
8,398,401,239,1038,3771
9,377,407,253,1037,3771
10,381,407,275,1063,3771
11,377,399,297,1073,3771
1,500,200,50,750,3772
2,466,232,92,790,3772
3,428,247,144,819,3772
4,426,264,175,865,3772
5,418,304,200,922,3772
6,420,316,222,958,3772
7,398,344,244,986,3772
8,394,374,245,1013,3772
9,386,408,248,1042,3772
10,390,407,258,1055,3772
11,393,416,275,1084,3772
1,500,200,50,750,3773
2,468,217,97,782,3773
3,449,264,130,843,3773
4,434,282,150,866,3773
5,420,309,184,913,3773
6,430,357,188,975,3773
7,416,357,227,1000,3773
8,383,358,250,991,3773
9,390,372,256,1018,3773
10,389,377,271,1037,3773
11,402,410,266,1078,3773
1,500,200,50,750,3774
2,460,236,96,792,3774
3,450,256,122,828,3774
4,425,299,149,873,3774
5,418,304,192,914,3774
6,409,338,219,966,3774
7,408,326,249,983,3774
8,384,368,247,999,3774
9,374,399,271,1044,3774
10,357,409,272,1038,3774
11,388,401,286,1075,3774
1,500,200,50,750,3775
2,445,250,97,792,3775
3,426,273,129,828,3775
4,415,302,163,880,3775
5,403,316,193,912,3775
6,394,344,211,949,3775
7,379,351,229,959,3775
8,394,367,239,1000,3775
9,369,388,263,1020,3775
10,404,412,253,1069,3775
11,408,422,261,1091,3775
1,500,200,50,750,3776
2,459,212,124,795,3776
3,441,240,154,835,3776
4,434,285,168,887,3776
5,403,287,217,907,3776
6,411,313,234,958,3776
7,400,335,253,988,3776
8,374,358,260,992,3776
9,410,384,249,1043,3776
10,412,388,265,1065,3776
11,409,400,284,1093,3776
1,500,200,50,750,3777
2,467,232,101,800,3777
3,428,265,141,834,3777
4,399,279,191,869,3777
5,394,309,203,906,3777
6,411,304,225,940,3777
7,394,350,224,968,3777
8,386,364,256,1006,3777
9,399,379,276,1054,3777
10,396,363,303,1062,3777
11,372,382,314,1068,3777
1,500,200,50,750,3778
2,474,196,114,784,3778
3,439,247,144,830,3778
4,412,278,182,872,3778
5,402,307,200,909,3778
6,401,339,205,945,3778
7,402,384,213,999,3778
8,413,382,224,1019,3778
9,398,382,251,1031,3778
10,423,393,256,1072,3778
11,404,394,276,1074,3778
1,500,200,50,750,3779
2,474,218,95,787,3779
3,465,243,123,831,3779
4,436,291,144,871,3779
5,434,318,169,921,3779
6,430,345,184,959,3779
7,418,349,214,981,3779
8,416,352,236,1004,3779
9,426,353,263,1042,3779
10,424,363,280,1067,3779
11,416,377,284,1077,3779
1,500,200,50,750,3780
2,464,240,79,783,3780
3,452,262,127,841,3780
4,432,267,175,874,3780
5,426,308,166,900,3780
6,423,343,213,979,3780
7,393,349,235,977,3780
8,382,372,241,995,3780
9,377,392,273,1042,3780
10,370,405,283,1058,3780
11,382,405,282,1069,3780
1,500,200,50,750,3781
2,466,248,86,800,3781
3,438,271,123,832,3781
4,417,303,150,870,3781
5,420,315,177,912,3781
6,407,327,220,954,3781
7,405,354,213,972,3781
8,408,362,238,1008,3781
9,402,361,269,1032,3781
10,397,392,261,1050,3781
11,412,391,287,1090,3781
1,500,200,50,750,3782
2,479,218,93,790,3782
3,441,256,126,823,3782
4,414,306,152,872,3782
5,386,337,196,919,3782
6,408,318,216,942,3782
7,423,332,220,975,3782
8,425,347,234,1006,3782
9,444,355,250,1049,3782
10,440,347,255,1042,3782
11,419,368,278,1065,3782
1,500,200,50,750,3783
2,437,244,106,787,3783
3,414,273,138,825,3783
4,414,305,160,879,3783
5,396,317,191,904,3783
6,428,328,218,974,3783
7,391,340,239,970,3783
8,405,374,243,1022,3783
9,407,360,255,1022,3783
10,408,387,262,1057,3783
11,414,390,282,1086,3783
1,500,200,50,750,3784
2,464,226,103,793,3784
3,443,249,142,834,3784
4,402,286,177,865,3784
5,393,316,198,907,3784
6,426,309,222,957,3784
7,420,317,247,984,3784
8,424,351,242,1017,3784
9,401,389,234,1024,3784
10,403,383,251,1037,3784
11,424,401,273,1098,3784
1,500,200,50,750,3785
2,468,223,98,789,3785
3,423,268,130,821,3785
4,420,291,164,875,3785
5,403,333,186,922,3785
6,410,336,216,962,3785
7,401,352,217,970,3785
8,392,386,228,1006,3785
9,405,382,237,1024,3785
10,414,417,237,1068,3785
11,409,424,256,1089,3785
1,500,200,50,750,3786
2,456,213,117,786,3786
3,445,234,155,834,3786
4,431,263,173,867,3786
5,424,298,201,923,3786
6,417,337,204,958,3786
7,413,351,222,986,3786
8,390,369,245,1004,3786
9,384,367,264,1015,3786
10,388,380,295,1063,3786
11,407,393,282,1082,3786
1,500,200,50,750,3787
2,468,244,86,798,3787
3,430,282,126,838,3787
4,395,322,142,859,3787
5,392,349,170,911,3787
6,395,351,197,943,3787
7,410,351,210,971,3787
8,415,380,225,1020,3787
9,381,406,247,1034,3787
10,389,398,280,1067,3787
11,397,377,316,1090,3787
1,500,200,50,750,3788
2,455,233,97,785,3788
3,429,247,139,815,3788
4,397,260,197,854,3788
5,411,297,194,902,3788
6,399,359,197,955,3788
7,423,351,213,987,3788
8,402,376,209,987,3788
9,419,367,231,1017,3788
10,413,371,273,1057,3788
11,390,387,300,1077,3788
1,500,200,50,750,3789
2,449,233,107,789,3789
3,432,267,126,825,3789
4,432,297,149,878,3789
5,403,318,183,904,3789
6,412,334,217,963,3789
7,404,347,234,985,3789
8,405,372,229,1006,3789
9,388,386,248,1022,3789
10,383,387,260,1030,3789
11,396,435,257,1088,3789
1,500,200,50,750,3790
2,462,226,100,788,3790
3,434,247,149,830,3790
4,428,277,177,882,3790
5,410,303,193,906,3790
6,390,347,209,946,3790
7,382,370,243,995,3790
8,369,389,235,993,3790
9,369,402,264,1035,3790
10,388,419,256,1063,3790
11,387,415,276,1078,3790
1,500,200,50,750,3791
2,471,214,109,794,3791
3,452,250,137,839,3791
4,413,296,158,867,3791
5,411,317,179,907,3791
6,417,331,207,955,3791
7,407,343,233,983,3791
8,378,374,240,992,3791
9,400,394,252,1046,3791
10,394,395,286,1075,3791
11,371,424,288,1083,3791
1,500,200,50,750,3792
2,456,222,103,781,3792
3,427,258,140,825,3792
4,429,268,168,865,3792
5,437,293,194,924,3792
6,429,321,199,949,3792
7,420,352,216,988,3792
8,440,362,213,1015,3792
9,427,359,248,1034,3792
10,415,380,262,1057,3792
11,423,399,274,1096,3792
1,500,200,50,750,3793
2,443,226,109,778,3793
3,426,269,132,827,3793
4,430,292,159,881,3793
5,399,318,193,910,3793
6,401,347,203,951,3793
7,403,347,229,979,3793
8,380,378,235,993,3793
9,399,377,250,1026,3793
10,397,388,258,1043,3793
11,403,419,263,1085,3793
1,500,200,50,750,3794
2,453,229,105,787,3794
3,419,254,145,818,3794
4,395,277,185,857,3794
5,413,291,213,917,3794
6,422,318,225,965,3794
7,400,353,228,981,3794
8,413,365,230,1008,3794
9,392,392,235,1019,3794
10,390,409,246,1045,3794
11,392,428,265,1085,3794
1,500,200,50,750,3795
2,454,238,99,791,3795
3,422,275,121,818,3795
4,413,301,164,878,3795
5,406,321,187,914,3795
6,394,327,221,942,3795
7,376,349,238,963,3795
8,383,380,247,1010,3795
9,379,397,250,1026,3795
10,396,384,274,1054,3795
11,378,401,295,1074,3795
1,500,200,50,750,3796
2,453,240,91,784,3796
3,435,271,126,832,3796
4,432,295,155,882,3796
5,416,315,190,921,3796
6,426,331,211,968,3796
7,409,346,242,997,3796
8,397,357,249,1003,3796
9,375,379,263,1017,3796
10,381,403,272,1056,3796
11,389,423,281,1093,3796
1,500,200,50,750,3797
2,459,215,115,789,3797
3,419,254,151,824,3797
4,396,294,178,868,3797
5,401,308,197,906,3797
6,410,348,190,948,3797
7,423,354,200,977,3797
8,399,363,226,988,3797
9,413,388,245,1046,3797
10,419,383,266,1068,3797
11,418,381,289,1088,3797
1,500,200,50,750,3798
2,448,235,109,792,3798
3,402,267,148,817,3798
4,386,290,175,851,3798
5,389,329,192,910,3798
6,393,337,234,964,3798
7,391,347,244,982,3798
8,393,373,243,1009,3798
9,403,383,253,1039,3798
10,401,387,267,1055,3798
11,406,396,275,1077,3798
1,500,200,50,750,3799
2,461,235,91,787,3799
3,408,259,149,816,3799
4,398,304,167,869,3799
5,416,310,201,927,3799
6,387,325,229,941,3799
7,380,349,246,975,3799
8,385,377,253,1015,3799
9,389,408,250,1047,3799
10,390,389,267,1046,3799
11,424,401,252,1077,3799
1,500,200,50,750,3800
2,470,238,89,797,3800
3,429,295,119,843,3800
4,391,293,168,852,3800
5,422,288,202,912,3800
6,429,314,212,955,3800
7,423,330,225,978,3800
8,422,370,223,1015,3800
9,408,369,250,1027,3800
10,399,370,272,1041,3800
11,400,390,283,1073,3800
1,500,200,50,750,3801
2,456,218,115,789,3801
3,420,257,145,822,3801
4,418,289,169,876,3801
5,404,310,192,906,3801
6,408,346,218,972,3801
7,408,336,251,995,3801
8,379,344,266,989,3801
9,412,358,269,1039,3801
10,420,342,275,1037,3801
11,403,365,297,1065,3801
1,500,200,50,750,3802
2,440,249,98,787,3802
3,443,256,133,832,3802
4,413,295,166,874,3802
5,420,293,206,919,3802
6,432,312,229,973,3802
7,423,348,222,993,3802
8,406,364,240,1010,3802
9,396,403,249,1048,3802
10,410,394,271,1075,3802
11,405,391,288,1084,3802
1,500,200,50,750,3803
2,450,250,96,796,3803
3,429,276,129,834,3803
4,422,298,161,881,3803
5,412,326,184,922,3803
6,388,360,203,951,3803
7,394,380,212,986,3803
8,388,403,224,1015,3803
9,382,409,242,1033,3803
10,393,417,257,1067,3803
11,388,431,279,1098,3803
1,500,200,50,750,3804
2,454,235,92,781,3804
3,438,265,120,823,3804
4,402,310,150,862,3804
5,424,319,188,931,3804
6,386,361,206,953,3804
7,384,375,226,985,3804
8,391,372,246,1009,3804
9,381,388,239,1008,3804
10,400,377,266,1043,3804
11,412,399,261,1072,3804
1,500,200,50,750,3805
2,455,229,108,792,3805
3,413,247,146,806,3805
4,418,286,167,871,3805
5,408,308,200,916,3805
6,407,339,213,959,3805
7,389,362,231,982,3805
8,362,383,247,992,3805
9,381,391,265,1037,3805
10,388,401,270,1059,3805
11,370,424,273,1067,3805
1,500,200,50,750,3806
2,464,220,106,790,3806
3,435,252,136,823,3806
4,419,266,171,856,3806
5,438,296,190,924,3806
6,447,324,194,965,3806
7,426,330,235,991,3806
8,397,361,242,1000,3806
9,385,383,246,1014,3806
10,392,394,254,1040,3806
11,412,417,262,1091,3806
1,500,200,50,750,3807
2,451,232,98,781,3807
3,420,266,134,820,3807
4,409,273,181,863,3807
5,390,313,211,914,3807
6,387,320,243,950,3807
7,388,334,258,980,3807
8,390,338,289,1017,3807
9,390,354,289,1033,3807
10,373,375,307,1055,3807
11,367,394,302,1063,3807
1,500,200,50,750,3808
2,455,220,117,792,3808
3,414,259,143,816,3808
4,431,281,168,880,3808
5,413,319,175,907,3808
6,401,374,196,971,3808
7,374,378,214,966,3808
8,398,396,237,1031,3808
9,386,405,258,1049,3808
10,382,413,266,1061,3808
11,379,441,275,1095,3808
1,500,200,50,750,3809
2,446,221,110,777,3809
3,445,241,138,824,3809
4,431,262,171,864,3809
5,436,291,185,912,3809
6,446,319,201,966,3809
7,403,347,231,981,3809
8,403,361,251,1015,3809
9,398,366,268,1032,3809
10,365,393,268,1026,3809
11,402,405,275,1082,3809
1,500,200,50,750,3810
2,460,222,98,780,3810
3,453,242,143,838,3810
4,416,282,171,869,3810
5,393,319,187,899,3810
6,430,328,203,961,3810
7,423,325,221,969,3810
8,419,370,222,1011,3810
9,410,386,240,1036,3810
10,414,393,259,1066,3810
11,400,395,295,1090,3810
1,500,200,50,750,3811
2,445,234,109,788,3811
3,437,254,141,832,3811
4,418,259,165,842,3811
5,438,303,194,935,3811
6,409,333,201,943,3811
7,407,348,230,985,3811
8,402,380,242,1024,3811
9,388,387,256,1031,3811
10,410,389,287,1086,3811
11,402,399,285,1086,3811
1,500,200,50,750,3812
2,466,225,95,786,3812
3,437,232,146,815,3812
4,427,278,168,873,3812
5,407,314,196,917,3812
6,406,335,215,956,3812
7,401,341,234,976,3812
8,400,355,254,1009,3812
9,405,367,270,1042,3812
10,393,374,282,1049,3812
11,377,411,285,1073,3812
1,500,200,50,750,3813
2,459,247,86,792,3813
3,420,257,130,807,3813
4,443,281,169,893,3813
5,406,308,189,903,3813
6,412,347,195,954,3813
7,413,353,219,985,3813
8,402,385,221,1008,3813
9,387,409,232,1028,3813
10,374,398,282,1054,3813
11,372,414,301,1087,3813
1,500,200,50,750,3814
2,447,238,91,776,3814
3,422,269,141,832,3814
4,407,286,175,868,3814
5,396,326,188,910,3814
6,388,345,211,944,3814
7,368,346,235,949,3814
8,388,364,247,999,3814
9,405,381,258,1044,3814
10,392,399,270,1061,3814
11,384,401,296,1081,3814
1,500,200,50,750,3815
2,459,232,111,802,3815
3,433,265,144,842,3815
4,421,292,162,875,3815
5,420,296,210,926,3815
6,396,340,218,954,3815
7,404,362,214,980,3815
8,395,381,229,1005,3815
9,414,370,247,1031,3815
10,410,383,256,1049,3815
11,410,388,275,1073,3815
1,500,200,50,750,3816
2,459,236,100,795,3816
3,428,280,135,843,3816
4,433,309,143,885,3816
5,415,327,180,922,3816
6,424,344,209,977,3816
7,403,371,210,984,3816
8,410,364,226,1000,3816
9,394,374,254,1022,3816
10,401,394,259,1054,3816
11,409,424,260,1093,3816
1,500,200,50,750,3817
2,465,216,106,787,3817
3,434,249,140,823,3817
4,424,287,170,881,3817
5,389,324,186,899,3817
6,402,329,225,956,3817
7,413,345,241,999,3817
8,388,371,244,1003,3817
9,417,378,240,1035,3817
10,410,374,259,1043,3817
11,416,397,261,1074,3817
1,500,200,50,750,3818
2,490,223,95,808,3818
3,450,258,119,827,3818
4,430,288,155,873,3818
5,413,312,188,913,3818
6,428,344,190,962,3818
7,404,367,211,982,3818
8,386,370,225,981,3818
9,403,396,237,1036,3818
10,393,386,277,1056,3818
11,387,419,286,1092,3818
1,500,200,50,750,3819
2,452,230,98,780,3819
3,445,236,153,834,3819
4,443,255,171,869,3819
5,423,292,185,900,3819
6,437,316,204,957,3819
7,416,327,232,975,3819
8,438,347,228,1013,3819
9,411,352,257,1020,3819
10,419,395,258,1072,3819
11,421,401,254,1076,3819
1,500,200,50,750,3820
2,468,233,96,797,3820
3,413,255,148,816,3820
4,418,288,171,877,3820
5,422,307,190,919,3820
6,415,332,210,957,3820
7,409,360,211,980,3820
8,400,398,218,1016,3820
9,400,405,234,1039,3820
10,390,412,261,1063,3820
11,418,428,253,1099,3820
1,500,200,50,750,3821
2,467,221,96,784,3821
3,395,265,139,799,3821
4,400,307,143,850,3821
5,404,298,189,891,3821
6,420,330,212,962,3821
7,402,332,236,970,3821
8,405,362,248,1015,3821
9,399,364,275,1038,3821
10,402,411,253,1066,3821
11,412,414,258,1084,3821
1,500,200,50,750,3822
2,451,243,98,792,3822
3,426,260,141,827,3822
4,411,304,155,870,3822
5,394,306,202,902,3822
6,403,316,226,945,3822
7,394,337,247,978,3822
8,394,354,254,1002,3822
9,396,356,265,1017,3822
10,383,391,278,1052,3822
11,391,429,271,1091,3822
1,500,200,50,750,3823
2,479,223,93,795,3823
3,450,241,135,826,3823
4,444,259,168,871,3823
5,434,283,195,912,3823
6,436,329,196,961,3823
7,401,360,207,968,3823
8,408,373,222,1003,3823
9,423,370,260,1053,3823
10,393,393,268,1054,3823
11,389,410,289,1088,3823
1,500,200,50,750,3824
2,466,230,95,791,3824
3,434,258,131,823,3824
4,427,268,164,859,3824
5,420,300,183,903,3824
6,446,330,210,986,3824
7,416,345,207,968,3824
8,414,361,232,1007,3824
9,405,366,266,1037,3824
10,401,385,268,1054,3824
11,417,417,261,1095,3824
1,500,200,50,750,3825
2,450,230,114,794,3825
3,429,255,152,836,3825
4,398,278,171,847,3825
5,420,314,189,923,3825
6,394,335,210,939,3825
7,397,350,226,973,3825
8,400,359,248,1007,3825
9,376,383,266,1025,3825
10,380,393,286,1059,3825
11,415,394,287,1096,3825
1,500,200,50,750,3826
2,442,261,95,798,3826
3,425,268,136,829,3826
4,413,295,161,869,3826
5,392,346,164,902,3826
6,406,369,192,967,3826
7,393,364,224,981,3826
8,366,377,245,988,3826
9,388,379,247,1014,3826
10,405,412,250,1067,3826
11,409,424,263,1096,3826
1,500,200,50,750,3827
2,472,217,97,786,3827
3,435,247,142,824,3827
4,424,274,165,863,3827
5,429,288,187,904,3827
6,436,306,226,968,3827
7,411,332,245,988,3827
8,393,340,271,1004,3827
9,392,382,259,1033,3827
10,421,376,278,1075,3827
11,411,395,279,1085,3827
1,500,200,50,750,3828
2,448,244,98,790,3828
3,408,278,154,840,3828
4,386,294,188,868,3828
5,373,322,202,897,3828
6,371,352,213,936,3828
7,373,378,211,962,3828
8,398,378,230,1006,3828
9,398,358,259,1015,3828
10,399,380,273,1052,3828
11,409,413,255,1077,3828
1,500,200,50,750,3829
2,459,227,95,781,3829
3,429,253,141,823,3829
4,420,276,174,870,3829
5,407,300,193,900,3829
6,399,348,195,942,3829
7,404,356,208,968,3829
8,409,361,243,1013,3829
9,415,387,244,1046,3829
10,418,400,258,1076,3829
11,407,401,273,1081,3829
1,500,200,50,750,3830
2,463,221,103,787,3830
3,424,267,137,828,3830
4,417,300,157,874,3830
5,405,317,190,912,3830
6,381,350,222,953,3830
7,396,342,263,1001,3830
8,380,356,266,1002,3830
9,384,384,264,1032,3830
10,399,385,271,1055,3830
11,400,399,297,1096,3830
1,500,200,50,750,3831
2,465,224,101,790,3831
3,430,281,124,835,3831
4,392,307,158,857,3831
5,386,336,169,891,3831
6,410,345,197,952,3831
7,410,333,238,981,3831
8,381,376,249,1006,3831
9,391,377,279,1047,3831
10,382,380,295,1057,3831
11,379,407,295,1081,3831
1,500,200,50,750,3832
2,452,226,97,775,3832
3,442,241,143,826,3832
4,434,270,181,885,3832
5,424,297,198,919,3832
6,416,339,215,970,3832
7,415,342,230,987,3832
8,419,355,242,1016,3832
9,413,375,251,1039,3832
10,408,394,258,1060,3832
11,432,393,265,1090,3832
1,500,200,50,750,3833
2,449,237,102,788,3833
3,416,264,145,825,3833
4,399,298,169,866,3833
5,371,336,201,908,3833
6,398,341,215,954,3833
7,392,353,227,972,3833
8,403,368,239,1010,3833
9,380,376,263,1019,3833
10,395,396,268,1059,3833
11,412,392,292,1096,3833
1,500,200,50,750,3834
2,457,227,103,787,3834
3,433,260,145,838,3834
4,393,298,176,867,3834
5,401,315,201,917,3834
6,411,327,228,966,3834
7,396,358,237,991,3834
8,402,372,238,1012,3834
9,411,356,274,1041,3834
10,422,376,264,1062,3834
11,423,403,267,1093,3834
1,500,200,50,750,3835
2,444,239,99,782,3835
3,439,263,134,836,3835
4,408,301,157,866,3835
5,396,332,179,907,3835
6,404,351,205,960,3835
7,391,370,219,980,3835
8,380,379,234,993,3835
9,374,418,240,1032,3835
10,383,408,272,1063,3835
11,399,404,288,1091,3835
1,500,200,50,750,3836
2,472,215,107,794,3836
3,437,246,153,836,3836
4,418,278,171,867,3836
5,396,316,203,915,3836
6,387,364,209,960,3836
7,391,345,254,990,3836
8,401,356,254,1011,3836
9,401,365,266,1032,3836
10,391,392,279,1062,3836
11,383,396,302,1081,3836
1,500,200,50,750,3837
2,463,238,86,787,3837
3,430,285,120,835,3837
4,416,318,151,885,3837
5,406,330,182,918,3837
6,396,345,204,945,3837
7,398,340,230,968,3837
8,415,355,240,1010,3837
9,412,387,241,1040,3837
10,406,378,267,1051,3837
11,423,409,259,1091,3837
1,500,200,50,750,3838
2,476,228,100,804,3838
3,444,243,140,827,3838
4,438,267,171,876,3838
5,415,304,189,908,3838
6,431,329,200,960,3838
7,423,353,207,983,3838
8,435,364,217,1016,3838
9,434,363,244,1041,3838
10,425,364,258,1047,3838
11,421,393,263,1077,3838
1,500,200,50,750,3839
2,473,235,94,802,3839
3,434,271,133,838,3839
4,412,292,177,881,3839
5,426,302,194,922,3839
6,407,308,228,943,3839
7,411,322,260,993,3839
8,400,335,276,1011,3839
9,400,359,277,1036,3839
10,388,377,277,1042,3839
11,423,405,275,1103,3839
1,500,200,50,750,3840
2,466,219,100,785,3840
3,444,237,139,820,3840
4,463,274,150,887,3840
5,439,303,173,915,3840
6,448,335,185,968,3840
7,402,358,218,978,3840
8,403,374,221,998,3840
9,396,374,245,1015,3840
10,391,397,247,1035,3840
11,398,427,267,1092,3840
1,500,200,50,750,3841
2,460,231,95,786,3841
3,439,263,114,816,3841
4,412,290,155,857,3841
5,413,304,197,914,3841
6,414,327,203,944,3841
7,416,349,225,990,3841
8,425,332,242,999,3841
9,427,364,251,1042,3841
10,420,392,240,1052,3841
11,414,423,262,1099,3841
1,500,200,50,750,3842
2,446,240,102,788,3842
3,433,249,152,834,3842
4,409,306,154,869,3842
5,403,319,190,912,3842
6,374,329,225,928,3842
7,391,352,247,990,3842
8,386,377,255,1018,3842
9,375,374,274,1023,3842
10,406,418,258,1082,3842
11,406,419,255,1080,3842
1,500,200,50,750,3843
2,480,226,86,792,3843
3,461,249,127,837,3843
4,424,270,158,852,3843
5,415,330,186,931,3843
6,407,341,223,971,3843
7,389,346,249,984,3843
8,411,361,251,1023,3843
9,379,368,263,1010,3843
10,391,389,271,1051,3843
11,394,410,282,1086,3843
1,500,200,50,750,3844
2,453,244,88,785,3844
3,433,257,138,828,3844
4,417,276,171,864,3844
5,419,289,207,915,3844
6,412,309,228,949,3844
7,397,363,222,982,3844
8,372,376,241,989,3844
9,385,408,238,1031,3844
10,368,433,255,1056,3844
11,398,421,259,1078,3844
1,500,200,50,750,3845
2,433,233,120,786,3845
3,408,274,143,825,3845
4,392,306,171,869,3845
5,385,319,207,911,3845
6,423,363,193,979,3845
7,405,379,203,987,3845
8,399,385,222,1006,3845
9,409,402,236,1047,3845
10,402,421,240,1063,3845
11,380,444,259,1083,3845
1,500,200,50,750,3846
2,475,228,97,800,3846
3,453,255,132,840,3846
4,427,275,162,864,3846
5,426,303,181,910,3846
6,434,315,198,947,3846
7,438,343,203,984,3846
8,407,360,232,999,3846
9,410,364,257,1031,3846
10,402,375,272,1049,3846
11,396,406,275,1077,3846
1,500,200,50,750,3847
2,454,239,103,796,3847
3,407,254,148,809,3847
4,435,273,170,878,3847
5,423,282,200,905,3847
6,448,324,187,959,3847
7,413,350,210,973,3847
8,417,362,227,1006,3847
9,384,382,265,1031,3847
10,380,400,268,1048,3847
11,389,408,276,1073,3847
1,500,200,50,750,3848
2,452,225,101,778,3848
3,426,256,151,833,3848
4,397,299,169,865,3848
5,433,314,172,919,3848
6,441,310,217,968,3848
7,400,316,240,956,3848
8,418,347,247,1012,3848
9,411,373,245,1029,3848
10,414,395,252,1061,3848
11,407,426,257,1090,3848
1,500,200,50,750,3849
2,453,237,92,782,3849
3,442,265,136,843,3849
4,414,264,181,859,3849
5,424,297,197,918,3849
6,404,343,211,958,3849
7,406,375,233,1014,3849
8,400,348,267,1015,3849
9,388,379,267,1034,3849
10,395,396,256,1047,3849
11,420,393,277,1090,3849
1,500,200,50,750,3850
2,468,236,90,794,3850
3,441,255,128,824,3850
4,428,280,160,868,3850
5,425,302,179,906,3850
6,442,312,213,967,3850
7,424,360,201,985,3850
8,418,372,232,1022,3850
9,412,389,236,1037,3850
10,417,390,259,1066,3850
11,397,432,260,1089,3850
1,500,200,50,750,3851
2,470,226,101,797,3851
3,461,236,137,834,3851
4,436,246,183,865,3851
5,445,256,211,912,3851
6,441,319,213,973,3851
7,418,304,246,968,3851
8,412,346,255,1013,3851
9,397,346,282,1025,3851
10,385,367,289,1041,3851
11,407,397,291,1095,3851
1,500,200,50,750,3852
2,446,233,99,778,3852
3,413,279,130,822,3852
4,422,300,146,868,3852
5,424,319,164,907,3852
6,434,330,190,954,3852
7,414,351,216,981,3852
8,401,364,230,995,3852
9,432,372,229,1033,3852
10,395,387,268,1050,3852
11,405,388,289,1082,3852
1,500,200,50,750,3853
2,442,241,95,778,3853
3,406,292,117,815,3853
4,413,297,157,867,3853
5,402,303,203,908,3853
6,402,337,212,951,3853
7,384,357,233,974,3853
8,388,379,253,1020,3853
9,375,399,266,1040,3853
10,383,411,253,1047,3853
11,395,424,272,1091,3853
1,500,200,50,750,3854
2,450,242,99,791,3854
3,409,256,153,818,3854
4,415,289,175,879,3854
5,408,333,168,909,3854
6,397,360,199,956,3854
7,407,364,208,979,3854
8,396,376,237,1009,3854
9,409,390,240,1039,3854
10,410,393,251,1054,3854
11,408,400,270,1078,3854
1,500,200,50,750,3855
2,446,230,102,778,3855
3,409,262,130,801,3855
4,399,312,168,879,3855
5,397,326,199,922,3855
6,380,349,224,953,3855
7,397,362,225,984,3855
8,372,393,235,1000,3855
9,377,394,282,1053,3855
10,371,385,296,1052,3855
11,396,410,276,1082,3855
1,500,200,50,750,3856
2,452,236,99,787,3856
3,427,279,136,842,3856
4,398,288,175,861,3856
5,394,324,198,916,3856
6,372,362,212,946,3856
7,395,366,229,990,3856
8,391,371,242,1004,3856
9,410,396,226,1032,3856
10,400,401,265,1066,3856
11,387,405,283,1075,3856
1,500,200,50,750,3857
2,460,228,113,801,3857
3,417,268,133,818,3857
4,408,311,173,892,3857
5,371,351,189,911,3857
6,376,368,213,957,3857
7,374,374,229,977,3857
8,374,402,233,1009,3857
9,378,415,236,1029,3857
10,388,451,218,1057,3857
11,392,426,243,1061,3857
1,500,200,50,750,3858
2,450,233,98,781,3858
3,423,273,130,826,3858
4,405,302,150,857,3858
5,414,323,184,921,3858
6,392,336,224,952,3858
7,397,339,239,975,3858
8,428,374,228,1030,3858
9,392,394,238,1024,3858
10,392,377,280,1049,3858
11,419,385,300,1104,3858
1,500,200,50,750,3859
2,456,237,101,794,3859
3,406,270,146,822,3859
4,407,310,173,890,3859
5,382,342,191,915,3859
6,393,346,217,956,3859
7,376,360,241,977,3859
8,370,377,259,1006,3859
9,359,415,258,1032,3859
10,377,410,283,1070,3859
11,389,386,301,1076,3859
1,500,200,50,750,3860
2,466,213,107,786,3860
3,435,243,148,826,3860
4,425,279,151,855,3860
5,401,322,195,918,3860
6,389,342,227,958,3860
7,391,342,245,978,3860
8,372,381,242,995,3860
9,389,385,263,1037,3860
10,387,385,276,1048,3860
11,396,388,284,1068,3860
1,500,200,50,750,3861
2,463,244,98,805,3861
3,420,250,157,827,3861
4,395,288,174,857,3861
5,413,323,185,921,3861
6,389,354,219,962,3861
7,378,358,233,969,3861
8,383,394,240,1017,3861
9,370,397,247,1014,3861
10,394,387,292,1073,3861
11,393,405,300,1098,3861
1,500,200,50,750,3862
2,440,254,106,800,3862
3,409,266,149,824,3862
4,393,324,160,877,3862
5,365,344,196,905,3862
6,372,377,219,968,3862
7,355,385,246,986,3862
8,364,385,263,1012,3862
9,364,384,278,1026,3862
10,369,394,285,1048,3862
11,396,398,280,1074,3862
1,500,200,50,750,3863
2,446,238,89,773,3863
3,429,264,119,812,3863
4,419,305,146,870,3863
5,423,303,181,907,3863
6,432,298,214,944,3863
7,419,324,227,970,3863
8,433,363,231,1027,3863
9,405,375,253,1033,3863
10,410,362,272,1044,3863
11,420,398,278,1096,3863
1,500,200,50,750,3864
2,469,228,87,784,3864
3,463,240,132,835,3864
4,442,249,174,865,3864
5,437,281,191,909,3864
6,431,294,222,947,3864
7,413,331,235,979,3864
8,405,352,236,993,3864
9,400,382,252,1034,3864
10,409,394,262,1065,3864
11,399,384,291,1074,3864
1,500,200,50,750,3865
2,458,241,91,790,3865
3,434,250,137,821,3865
4,421,288,154,863,3865
5,427,292,185,904,3865
6,432,320,218,970,3865
7,396,313,258,967,3865
8,421,330,260,1011,3865
9,408,355,264,1027,3865
10,417,364,283,1064,3865
11,427,393,277,1097,3865
1,500,200,50,750,3866
2,465,245,85,795,3866
3,426,241,141,808,3866
4,422,275,161,858,3866
5,416,305,188,909,3866
6,410,346,210,966,3866
7,408,336,233,977,3866
8,414,369,223,1006,3866
9,417,396,235,1048,3866
10,399,412,245,1056,3866
11,434,415,259,1108,3866
1,500,200,50,750,3867
2,455,228,102,785,3867
3,420,271,145,836,3867
4,416,303,157,876,3867
5,407,322,189,918,3867
6,407,344,200,951,3867
7,400,363,211,974,3867
8,400,377,242,1019,3867
9,388,387,253,1028,3867
10,368,412,261,1041,3867
11,384,408,276,1068,3867
1,500,200,50,750,3868
2,453,235,100,788,3868
3,436,254,138,828,3868
4,431,277,164,872,3868
5,426,282,206,914,3868
6,409,321,241,971,3868
7,373,354,248,975,3868
8,375,379,248,1002,3868
9,391,383,262,1036,3868
10,400,394,269,1063,3868
11,383,427,268,1078,3868
1,500,200,50,750,3869
2,454,236,102,792,3869
3,422,260,140,822,3869
4,410,279,173,862,3869
5,416,324,181,921,3869
6,405,355,189,949,3869
7,395,356,222,973,3869
8,386,377,226,989,3869
9,404,384,253,1041,3869
10,405,391,251,1047,3869
11,419,405,272,1096,3869
1,500,200,50,750,3870
2,445,249,98,792,3870
3,413,261,140,814,3870
4,437,261,182,880,3870
5,418,311,205,934,3870
6,387,345,209,941,3870
7,375,364,235,974,3870
8,391,377,243,1011,3870
9,395,384,262,1041,3870
10,400,403,258,1061,3870
11,398,396,280,1074,3870
1,500,200,50,750,3871
2,461,229,92,782,3871
3,451,244,135,830,3871
4,421,265,177,863,3871
5,431,296,193,920,3871
6,431,326,195,952,3871
7,426,339,209,974,3871
8,428,341,234,1003,3871
9,403,368,248,1019,3871
10,396,401,248,1045,3871
11,407,416,251,1074,3871
1,500,200,50,750,3872
2,464,222,97,783,3872
3,438,271,126,835,3872
4,433,267,170,870,3872
5,428,315,187,930,3872
6,416,325,215,956,3872
7,408,346,232,986,3872
8,402,354,250,1006,3872
9,386,372,266,1024,3872
10,392,388,265,1045,3872
11,391,435,254,1080,3872
1,500,200,50,750,3873
2,469,234,94,797,3873
3,430,260,136,826,3873
4,412,282,171,865,3873
5,405,310,188,903,3873
6,411,351,220,982,3873
7,389,347,236,972,3873
8,391,384,224,999,3873
9,387,406,240,1033,3873
10,379,409,283,1071,3873
11,375,423,279,1077,3873
1,500,200,50,750,3874
2,442,252,101,795,3874
3,427,253,144,824,3874
4,423,292,157,872,3874
5,402,321,195,918,3874
6,412,317,215,944,3874
7,388,346,238,972,3874
8,394,372,252,1018,3874
9,402,382,259,1043,3874
10,370,413,264,1047,3874
11,390,407,279,1076,3874
1,500,200,50,750,3875
2,477,234,90,801,3875
3,433,272,123,828,3875
4,408,294,153,855,3875
5,424,302,183,909,3875
6,420,303,217,940,3875
7,427,324,233,984,3875
8,409,338,241,988,3875
9,410,360,251,1021,3875
10,401,394,264,1059,3875
11,405,397,284,1086,3875
1,500,200,50,750,3876
2,460,232,96,788,3876
3,444,267,117,828,3876
4,429,291,157,877,3876
5,402,338,169,909,3876
6,406,359,195,960,3876
7,394,357,229,980,3876
8,402,379,235,1016,3876
9,400,392,240,1032,3876
10,404,404,248,1056,3876
11,405,418,265,1088,3876
1,500,200,50,750,3877
2,462,223,102,787,3877
3,422,256,143,821,3877
4,408,276,180,864,3877
5,390,311,210,911,3877
6,418,329,218,965,3877
7,414,348,227,989,3877
8,403,359,247,1009,3877
9,412,365,251,1028,3877
10,407,393,260,1060,3877
11,421,422,262,1105,3877
1,500,200,50,750,3878
2,464,230,99,793,3878
3,425,254,127,806,3878
4,399,280,183,862,3878
5,409,309,198,916,3878
6,409,328,222,959,3878
7,395,347,238,980,3878
8,386,356,261,1003,3878
9,391,365,278,1034,3878
10,390,376,302,1068,3878
11,387,407,282,1076,3878
1,500,200,50,750,3879
2,454,227,98,779,3879
3,430,255,141,826,3879
4,413,282,180,875,3879
5,396,317,195,908,3879
6,417,331,216,964,3879
7,392,348,232,972,3879
8,403,379,230,1012,3879
9,406,399,221,1026,3879
10,408,394,260,1062,3879
11,395,387,286,1068,3879
1,500,200,50,750,3880
2,461,209,114,784,3880
3,436,254,137,827,3880
4,410,272,176,858,3880
5,428,302,196,926,3880
6,409,333,217,959,3880
7,385,359,239,983,3880
8,388,366,260,1014,3880
9,386,370,258,1014,3880
10,408,377,274,1059,3880
11,400,397,280,1077,3880
1,500,200,50,750,3881
2,459,228,103,790,3881
3,417,266,132,815,3881
4,429,305,150,884,3881
5,408,322,181,911,3881
6,417,331,202,950,3881
7,411,360,219,990,3881
8,388,374,240,1002,3881
9,377,393,261,1031,3881
10,387,409,277,1073,3881
11,390,420,275,1085,3881
1,500,200,50,750,3882
2,458,241,87,786,3882
3,436,264,119,819,3882
4,412,303,150,865,3882
5,414,312,191,917,3882
6,422,332,212,966,3882
7,402,338,231,971,3882
8,413,347,247,1007,3882
9,397,349,278,1024,3882
10,397,384,272,1053,3882
11,389,390,302,1081,3882
1,500,200,50,750,3883
2,455,239,82,776,3883
3,433,280,117,830,3883
4,416,299,144,859,3883
5,429,320,183,932,3883
6,418,330,212,960,3883
7,396,343,232,971,3883
8,394,384,226,1004,3883
9,398,378,264,1040,3883
10,386,402,272,1060,3883
11,391,393,290,1074,3883
1,500,200,50,750,3884
2,462,229,96,787,3884
3,435,254,141,830,3884
4,429,291,162,882,3884
5,411,322,185,918,3884
6,408,363,187,958,3884
7,401,385,195,981,3884
8,404,391,211,1006,3884
9,411,396,235,1042,3884
10,402,404,255,1061,3884
11,411,430,251,1092,3884
1,500,200,50,750,3885
2,471,223,98,792,3885
3,431,269,132,832,3885
4,432,278,170,880,3885
5,418,281,206,905,3885
6,418,313,237,968,3885
7,405,345,236,986,3885
8,388,367,243,998,3885
9,392,384,269,1045,3885
10,391,390,278,1059,3885
11,403,383,284,1070,3885
1,500,200,50,750,3886
2,471,221,99,791,3886
3,421,267,129,817,3886
4,422,280,158,860,3886
5,417,312,189,918,3886
6,425,326,223,974,3886
7,397,362,224,983,3886
8,379,381,245,1005,3886
9,374,375,260,1009,3886
10,400,410,268,1078,3886
11,374,403,296,1073,3886
1,500,200,50,750,3887
2,462,225,90,777,3887
3,452,245,127,824,3887
4,452,255,160,867,3887
5,432,299,188,919,3887
6,426,338,192,956,3887
7,413,343,234,990,3887
8,395,364,250,1009,3887
9,401,387,252,1040,3887
10,404,386,269,1059,3887
11,371,400,300,1071,3887
1,500,200,50,750,3888
2,466,222,112,800,3888
3,433,262,138,833,3888
4,430,301,147,878,3888
5,420,324,173,917,3888
6,408,342,198,948,3888
7,406,337,228,971,3888
8,389,381,234,1004,3888
9,378,390,265,1033,3888
10,389,400,269,1058,3888
11,401,406,281,1088,3888
1,500,200,50,750,3889
2,453,233,113,799,3889
3,411,266,141,818,3889
4,389,285,188,862,3889
5,396,313,194,903,3889
6,417,327,218,962,3889
7,422,339,222,983,3889
8,402,337,254,993,3889
9,424,363,244,1031,3889
10,430,379,252,1061,3889
11,415,399,277,1091,3889
1,500,200,50,750,3890
2,450,241,99,790,3890
3,418,281,124,823,3890
4,428,304,156,888,3890
5,400,309,191,900,3890
6,406,348,217,971,3890
7,380,345,253,978,3890
8,386,342,280,1008,3890
9,386,364,284,1034,3890
10,393,363,282,1038,3890
11,424,405,275,1104,3890
1,500,200,50,750,3891
2,450,233,101,784,3891
3,439,260,136,835,3891
4,413,279,171,863,3891
5,397,321,179,897,3891
6,422,328,213,963,3891
7,403,347,231,981,3891
8,369,382,238,989,3891
9,399,393,252,1044,3891
10,379,399,273,1051,3891
11,387,432,265,1084,3891
1,500,200,50,750,3892
2,475,225,99,799,3892
3,448,253,128,829,3892
4,423,284,164,871,3892
5,406,317,179,902,3892
6,411,351,195,957,3892
7,395,352,232,979,3892
8,394,392,219,1005,3892
9,392,389,244,1025,3892
10,391,400,255,1046,3892
11,431,417,249,1097,3892
1,500,200,50,750,3893
2,485,233,88,806,3893
3,431,268,127,826,3893
4,417,297,155,869,3893
5,401,321,185,907,3893
6,395,355,211,961,3893
7,388,362,226,976,3893
8,402,346,256,1004,3893
9,405,352,268,1025,3893
10,414,382,268,1064,3893
11,410,413,248,1071,3893
1,500,200,50,750,3894
2,458,228,106,792,3894
3,425,265,144,834,3894
4,396,319,155,870,3894
5,397,346,187,930,3894
6,389,362,212,963,3894
7,368,381,220,969,3894
8,392,396,226,1014,3894
9,394,405,243,1042,3894
10,397,381,274,1052,3894
11,396,418,269,1083,3894
1,500,200,50,750,3895
2,449,226,103,778,3895
3,438,243,143,824,3895
4,421,277,175,873,3895
5,407,308,195,910,3895
6,409,338,213,960,3895
7,392,354,237,983,3895
8,392,361,242,995,3895
9,398,377,256,1031,3895
10,417,403,253,1073,3895
11,402,423,263,1088,3895
1,500,200,50,750,3896
2,435,255,94,784,3896
3,402,281,137,820,3896
4,381,308,169,858,3896
5,393,329,196,918,3896
6,392,336,236,964,3896
7,374,355,239,968,3896
8,375,384,238,997,3896
9,383,395,246,1024,3896
10,406,377,277,1060,3896
11,444,378,279,1101,3896
1,500,200,50,750,3897
2,456,240,88,784,3897
3,431,278,115,824,3897
4,423,276,169,868,3897
5,404,312,180,896,3897
6,425,324,212,961,3897
7,404,338,244,986,3897
8,406,372,249,1027,3897
9,383,412,243,1038,3897
10,375,422,265,1062,3897
11,387,427,273,1087,3897
1,500,200,50,750,3898
2,450,235,115,800,3898
3,426,263,139,828,3898
4,415,285,184,884,3898
5,400,307,207,914,3898
6,434,319,222,975,3898
7,422,320,238,980,3898
8,411,352,252,1015,3898
9,391,371,269,1031,3898
10,399,383,286,1068,3898
11,390,403,284,1077,3898
1,500,200,50,750,3899
2,471,235,83,789,3899
3,435,260,128,823,3899
4,432,280,156,868,3899
5,420,307,195,922,3899
6,398,338,223,959,3899
7,362,374,242,978,3899
8,375,378,257,1010,3899
9,365,401,254,1020,3899
10,367,414,268,1049,3899
11,388,430,263,1081,3899
1,500,200,50,750,3900
2,475,230,93,798,3900
3,446,257,123,826,3900
4,410,295,155,860,3900
5,413,322,184,919,3900
6,411,348,205,964,3900
7,389,350,236,975,3900
8,384,363,257,1004,3900
9,405,358,264,1027,3900
10,412,385,269,1066,3900
11,385,389,277,1051,3900
1,500,200,50,750,3901
2,450,247,93,790,3901
3,422,276,130,828,3901
4,403,299,162,864,3901
5,412,333,181,926,3901
6,416,331,208,955,3901
7,418,337,234,989,3901
8,414,368,226,1008,3901
9,423,369,252,1044,3901
10,408,383,273,1064,3901
11,408,390,272,1070,3901
1,500,200,50,750,3902
2,462,220,90,772,3902
3,441,251,123,815,3902
4,438,277,157,872,3902
5,405,297,187,889,3902
6,409,334,205,948,3902
7,400,341,235,976,3902
8,395,368,243,1006,3902
9,392,358,273,1023,3902
10,414,367,256,1037,3902
11,439,371,270,1080,3902
1,500,200,50,750,3903
2,448,234,97,779,3903
3,437,263,131,831,3903
4,396,297,174,867,3903
5,402,319,184,905,3903
6,423,350,199,972,3903
7,389,371,219,979,3903
8,381,376,251,1008,3903
9,399,383,271,1053,3903
10,393,390,272,1055,3903
11,381,396,281,1058,3903
1,500,200,50,750,3904
2,449,218,104,771,3904
3,411,257,126,794,3904
4,385,302,165,852,3904
5,407,332,191,930,3904
6,405,343,203,951,3904
7,382,360,234,976,3904
8,372,371,246,989,3904
9,383,392,258,1033,3904
10,400,373,268,1041,3904
11,403,397,272,1072,3904
1,500,200,50,750,3905
2,461,225,102,788,3905
3,438,249,134,821,3905
4,422,288,167,877,3905
5,407,323,188,918,3905
6,395,338,206,939,3905
7,406,355,230,991,3905
8,395,368,239,1002,3905
9,389,377,261,1027,3905
10,399,399,245,1043,3905
11,419,400,269,1088,3905
1,500,200,50,750,3906
2,455,232,103,790,3906
3,420,272,133,825,3906
4,408,300,159,867,3906
5,401,332,189,922,3906
6,382,355,212,949,3906
7,404,341,235,980,3906
8,421,353,236,1010,3906
9,409,364,260,1033,3906
10,422,371,270,1063,3906
11,422,383,281,1086,3906
1,500,200,50,750,3907
2,459,211,102,772,3907
3,455,245,131,831,3907
4,415,264,174,853,3907
5,417,309,198,924,3907
6,411,334,221,966,3907
7,401,345,225,971,3907
8,418,341,250,1009,3907
9,416,375,238,1029,3907
10,404,392,249,1045,3907
11,417,391,258,1066,3907
1,500,200,50,750,3908
2,458,219,108,785,3908
3,433,268,126,827,3908
4,415,309,150,874,3908
5,389,325,197,911,3908
6,398,350,203,951,3908
7,397,332,231,960,3908
8,418,373,227,1018,3908
9,400,381,253,1034,3908
10,410,381,271,1062,3908
11,420,389,282,1091,3908
1,500,200,50,750,3909
2,469,232,100,801,3909
3,441,260,122,823,3909
4,433,267,165,865,3909
5,440,267,180,887,3909
6,436,333,212,981,3909
7,418,341,230,989,3909
8,389,376,239,1004,3909
9,380,394,257,1031,3909
10,384,402,270,1056,3909
11,380,420,287,1087,3909
1,500,200,50,750,3910
2,467,234,93,794,3910
3,421,269,131,821,3910
4,414,293,162,869,3910
5,408,314,194,916,3910
6,407,334,205,946,3910
7,416,353,211,980,3910
8,422,350,239,1011,3910
9,397,369,257,1023,3910
10,401,374,289,1064,3910
11,389,385,295,1069,3910
1,500,200,50,750,3911
2,453,220,112,785,3911
3,427,238,154,819,3911
4,430,256,178,864,3911
5,419,290,198,907,3911
6,436,329,205,970,3911
7,402,344,218,964,3911
8,398,391,228,1017,3911
9,415,381,249,1045,3911
10,414,384,257,1055,3911
11,433,378,272,1083,3911
1,500,200,50,750,3912
2,464,228,94,786,3912
3,414,273,141,828,3912
4,406,306,164,876,3912
5,396,317,203,916,3912
6,401,346,210,957,3912
7,404,342,226,972,3912
8,409,370,238,1017,3912
9,386,387,257,1030,3912
10,396,400,265,1061,3912
11,405,395,274,1074,3912
1,500,200,50,750,3913
2,458,235,97,790,3913
3,427,261,139,827,3913
4,421,292,171,884,3913
5,410,296,201,907,3913
6,437,310,200,947,3913
7,410,357,218,985,3913
8,392,371,236,999,3913
9,394,366,259,1019,3913
10,404,368,286,1058,3913
11,403,373,302,1078,3913
1,500,200,50,750,3914
2,448,228,102,778,3914
3,417,260,146,823,3914
4,405,279,167,851,3914
5,423,317,168,908,3914
6,429,325,212,966,3914
7,404,355,233,992,3914
8,406,393,216,1015,3914
9,390,385,238,1013,3914
10,410,377,246,1033,3914
11,421,394,277,1092,3914
1,500,200,50,750,3915
2,462,226,100,788,3915
3,437,255,119,811,3915
4,420,283,151,854,3915
5,428,298,178,904,3915
6,426,315,211,952,3915
7,429,329,233,991,3915
8,433,331,247,1011,3915
9,407,363,264,1034,3915
10,433,369,269,1071,3915
11,405,394,276,1075,3915
1,500,200,50,750,3916
2,470,226,94,790,3916
3,435,257,130,822,3916
4,424,280,158,862,3916
5,412,310,181,903,3916
6,432,343,194,969,3916
7,413,357,205,975,3916
8,402,390,222,1014,3916
9,385,395,238,1018,3916
10,390,413,247,1050,3916
11,400,432,274,1106,3916
1,500,200,50,750,3917
2,471,234,88,793,3917
3,430,273,127,830,3917
4,403,301,155,859,3917
5,418,317,176,911,3917
6,399,329,215,943,3917
7,370,362,235,967,3917
8,394,352,255,1001,3917
9,396,347,278,1021,3917
10,411,379,281,1071,3917
11,415,384,300,1099,3917
1,500,200,50,750,3918
2,465,231,98,794,3918
3,413,268,146,827,3918
4,401,300,158,859,3918
5,409,317,199,925,3918
6,389,340,223,952,3918
7,395,354,232,981,3918
8,381,387,247,1015,3918
9,380,389,262,1031,3918
10,378,410,270,1058,3918
11,385,435,275,1095,3918
1,500,200,50,750,3919
2,462,213,110,785,3919
3,433,251,131,815,3919
4,407,267,182,856,3919
5,384,305,217,906,3919
6,378,362,209,949,3919
7,376,371,230,977,3919
8,382,362,259,1003,3919
9,379,362,278,1019,3919
10,398,373,293,1064,3919
11,390,371,318,1079,3919
1,500,200,50,750,3920
2,450,224,95,769,3920
3,428,261,126,815,3920
4,435,283,147,865,3920
5,441,324,158,923,3920
6,407,338,203,948,3920
7,412,355,220,987,3920
8,408,371,227,1006,3920
9,410,372,257,1039,3920
10,404,394,254,1052,3920
11,421,400,262,1083,3920
1,500,200,50,750,3921
2,458,240,90,788,3921
3,432,266,141,839,3921
4,424,295,159,878,3921
5,386,337,188,911,3921
6,381,345,224,950,3921
7,375,373,236,984,3921
8,391,356,251,998,3921
9,409,366,271,1046,3921
10,407,371,290,1068,3921
11,382,413,273,1068,3921
1,500,200,50,750,3922
2,465,232,95,792,3922
3,436,269,126,831,3922
4,432,289,140,861,3922
5,423,325,166,914,3922
6,435,338,191,964,3922
7,408,359,202,969,3922
8,417,367,233,1017,3922
9,389,393,233,1015,3922
10,396,402,247,1045,3922
11,414,409,271,1094,3922
1,500,200,50,750,3923
2,454,235,97,786,3923
3,429,268,136,833,3923
4,405,298,164,867,3923
5,397,306,203,906,3923
6,421,303,230,954,3923
7,400,349,233,982,3923
8,406,358,239,1003,3923
9,413,384,240,1037,3923
10,418,385,260,1063,3923
11,428,393,260,1081,3923
1,500,200,50,750,3924
2,444,242,94,780,3924
3,406,274,134,814,3924
4,403,293,163,859,3924
5,386,328,199,913,3924
6,409,359,211,979,3924
7,393,336,250,979,3924
8,400,360,249,1009,3924
9,389,377,254,1020,3924
10,415,371,267,1053,3924
11,428,395,262,1085,3924
1,500,200,50,750,3925
2,446,239,97,782,3925
3,438,283,112,833,3925
4,402,319,146,867,3925
5,402,320,185,907,3925
6,410,343,198,951,3925
7,406,362,219,987,3925
8,379,377,243,999,3925
9,387,382,267,1036,3925
10,402,386,270,1058,3925
11,412,415,253,1080,3925
1,500,200,50,750,3926
2,463,235,81,779,3926
3,442,264,129,835,3926
4,431,290,156,877,3926
5,403,314,186,903,3926
6,416,344,213,973,3926
7,395,347,233,975,3926
8,401,348,246,995,3926
9,403,361,257,1021,3926
10,414,374,259,1047,3926
11,422,396,253,1071,3926
1,500,200,50,750,3927
2,450,234,98,782,3927
3,438,263,137,838,3927
4,413,292,158,863,3927
5,414,297,205,916,3927
6,402,335,220,957,3927
7,402,345,246,993,3927
8,396,352,255,1003,3927
9,384,382,253,1019,3927
10,399,403,259,1061,3927
11,395,415,268,1078,3927
1,500,200,50,750,3928
2,460,229,98,787,3928
3,435,267,125,827,3928
4,408,300,161,869,3928
5,398,327,188,913,3928
6,395,353,202,950,3928
7,396,360,214,970,3928
8,398,365,236,999,3928
9,393,372,261,1026,3928
10,395,389,271,1055,3928
11,422,391,274,1087,3928
1,500,200,50,750,3929
2,452,239,110,801,3929
3,425,263,146,834,3929
4,414,283,173,870,3929
5,423,279,205,907,3929
6,404,334,219,957,3929
7,391,353,237,981,3929
8,394,399,234,1027,3929
9,385,397,252,1034,3929
10,380,399,275,1054,3929
11,388,418,282,1088,3929
1,500,200,50,750,3930
2,463,229,98,790,3930
3,444,272,128,844,3930
4,409,300,157,866,3930
5,411,300,188,899,3930
6,424,351,208,983,3930
7,403,336,238,977,3930
8,399,362,238,999,3930
9,393,374,255,1022,3930
10,428,398,269,1095,3930
11,399,428,271,1098,3930
1,500,200,50,750,3931
2,474,223,92,789,3931
3,455,261,131,847,3931
4,422,297,160,879,3931
5,407,320,198,925,3931
6,403,328,225,956,3931
7,391,343,240,974,3931
8,379,390,225,994,3931
9,386,401,248,1035,3931
10,392,377,276,1045,3931
11,409,394,273,1076,3931
1,500,200,50,750,3932
2,457,230,88,775,3932
3,430,271,124,825,3932
4,427,287,157,871,3932
5,435,316,177,928,3932
6,427,324,196,947,3932
7,415,369,212,996,3932
8,396,397,215,1008,3932
9,394,398,247,1039,3932
10,398,411,248,1057,3932
11,381,402,299,1082,3932
1,500,200,50,750,3933
2,458,225,95,778,3933
3,424,270,126,820,3933
4,412,311,154,877,3933
5,394,311,207,912,3933
6,391,341,221,953,3933
7,389,365,226,980,3933
8,375,396,233,1004,3933
9,385,407,240,1032,3933
10,388,407,261,1056,3933
11,394,420,268,1082,3933
1,500,200,50,750,3934
2,464,231,95,790,3934
3,437,259,134,830,3934
4,422,284,156,862,3934
5,399,305,195,899,3934
6,419,335,204,958,3934
7,408,362,217,987,3934
8,407,366,233,1006,3934
9,373,385,258,1016,3934
10,383,402,266,1051,3934
11,363,416,280,1059,3934
1,500,200,50,750,3935
2,456,242,93,791,3935
3,430,271,133,834,3935
4,405,274,165,844,3935
5,417,336,167,920,3935
6,377,360,209,946,3935
7,369,392,205,966,3935
8,355,394,240,989,3935
9,378,412,242,1032,3935
10,388,414,265,1067,3935
11,409,382,292,1083,3935
1,500,200,50,750,3936
2,467,233,95,795,3936
3,427,263,141,831,3936
4,401,303,168,872,3936
5,389,324,201,914,3936
6,393,334,231,958,3936
7,405,339,253,997,3936
8,397,357,250,1004,3936
9,397,368,264,1029,3936
10,406,366,284,1056,3936
11,429,379,269,1077,3936
1,500,200,50,750,3937
2,462,231,107,800,3937
3,416,270,148,834,3937
4,399,288,180,867,3937
5,402,300,203,905,3937
6,417,327,221,965,3937
7,398,332,244,974,3937
8,403,359,259,1021,3937
9,378,378,270,1026,3937
10,378,395,280,1053,3937
11,372,431,270,1073,3937
1,500,200,50,750,3938
2,459,243,96,798,3938
3,419,276,141,836,3938
4,402,293,187,882,3938
5,384,308,230,922,3938
6,375,343,238,956,3938
7,369,374,249,992,3938
8,344,387,267,998,3938
9,344,413,280,1037,3938
10,363,426,271,1060,3938
11,385,412,288,1085,3938
1,500,200,50,750,3939
2,456,228,106,790,3939
3,431,258,144,833,3939
4,407,285,177,869,3939
5,423,295,192,910,3939
6,436,344,194,974,3939
7,391,372,217,980,3939
8,374,382,250,1006,3939
9,400,393,252,1045,3939
10,395,404,262,1061,3939
11,401,391,284,1076,3939
1,500,200,50,750,3940
2,472,225,98,795,3940
3,441,251,132,824,3940
4,428,276,166,870,3940
5,404,305,197,906,3940
6,426,322,220,968,3940
7,416,365,210,991,3940
8,422,362,220,1004,3940
9,410,372,250,1032,3940
10,415,391,272,1078,3940
11,407,400,268,1075,3940
1,500,200,50,750,3941
2,450,244,102,796,3941
3,422,266,144,832,3941
4,405,286,172,863,3941
5,401,311,203,915,3941
6,402,323,226,951,3941
7,397,363,229,989,3941
8,393,381,227,1001,3941
9,408,391,243,1042,3941
10,410,387,268,1065,3941
11,408,427,254,1089,3941
1,500,200,50,750,3942
2,451,236,105,792,3942
3,439,266,127,832,3942
4,401,301,154,856,3942
5,391,323,183,897,3942
6,418,344,204,966,3942
7,388,367,233,988,3942
8,391,372,244,1007,3942
9,402,401,252,1055,3942
10,382,407,275,1064,3942
11,373,408,305,1086,3942
1,500,200,50,750,3943
2,463,219,92,774,3943
3,454,259,110,823,3943
4,435,289,147,871,3943
5,410,315,189,914,3943
6,402,353,205,960,3943
7,401,359,226,986,3943
8,365,384,226,975,3943
9,412,376,247,1035,3943
10,393,401,255,1049,3943
11,387,414,276,1077,3943
1,500,200,50,750,3944
2,478,228,87,793,3944
3,427,256,137,820,3944
4,415,291,171,877,3944
5,409,315,187,911,3944
6,408,357,200,965,3944
7,417,359,209,985,3944
8,390,360,250,1000,3944
9,388,379,253,1020,3944
10,389,393,288,1070,3944
11,384,402,287,1073,3944
1,500,200,50,750,3945
2,461,223,94,778,3945
3,442,262,133,837,3945
4,421,276,174,871,3945
5,435,288,187,910,3945
6,426,317,213,956,3945
7,409,339,237,985,3945
8,412,362,238,1012,3945
9,418,380,233,1031,3945
10,412,388,257,1057,3945
11,414,413,256,1083,3945
1,500,200,50,750,3946
2,465,226,107,798,3946
3,424,263,128,815,3946
4,422,282,167,871,3946
5,399,316,186,901,3946
6,407,351,193,951,3946
7,399,361,207,967,3946
8,387,392,227,1006,3946
9,382,381,255,1018,3946
10,404,402,255,1061,3946
11,425,395,273,1093,3946
1,500,200,50,750,3947
2,447,243,109,799,3947
3,415,265,145,825,3947
4,406,293,182,881,3947
5,407,312,196,915,3947
6,421,344,203,968,3947
7,397,349,233,979,3947
8,395,381,227,1003,3947
9,391,403,233,1027,3947
10,399,419,240,1058,3947
11,404,407,263,1074,3947
1,500,200,50,750,3948
2,466,224,102,792,3948
3,435,241,150,826,3948
4,412,289,163,864,3948
5,415,310,191,916,3948
6,407,328,218,953,3948
7,390,339,250,979,3948
8,384,337,280,1001,3948
9,368,375,277,1020,3948
10,385,427,260,1072,3948
11,388,418,281,1087,3948
1,500,200,50,750,3949
2,459,231,103,793,3949
3,411,282,144,837,3949
4,401,306,165,872,3949
5,401,327,187,915,3949
6,404,347,204,955,3949
7,415,372,208,995,3949
8,409,384,217,1010,3949
9,397,391,242,1030,3949
10,409,392,276,1077,3949
11,385,408,287,1080,3949
1,500,200,50,750,3950
2,438,245,97,780,3950
3,428,264,146,838,3950
4,395,308,158,861,3950
5,401,327,203,931,3950
6,395,327,237,959,3950
7,392,343,237,972,3950
8,396,361,249,1006,3950
9,400,371,262,1033,3950
10,403,379,270,1052,3950
11,408,419,261,1088,3950
1,500,200,50,750,3951
2,429,233,107,769,3951
3,414,255,156,825,3951
4,413,288,173,874,3951
5,413,319,193,925,3951
6,402,361,204,967,3951
7,392,373,225,990,3951
8,397,382,244,1023,3951
9,390,373,261,1024,3951
10,411,369,281,1061,3951
11,413,384,283,1080,3951
1,500,200,50,750,3952
2,467,235,89,791,3952
3,428,264,132,824,3952
4,415,284,167,866,3952
5,424,310,196,930,3952
6,406,335,225,966,3952
7,407,361,225,993,3952
8,397,359,257,1013,3952
9,390,355,276,1021,3952
10,390,363,298,1051,3952
11,377,412,282,1071,3952
1,500,200,50,750,3953
2,462,230,97,789,3953
3,415,267,145,827,3953
4,402,288,176,866,3953
5,406,305,192,903,3953
6,399,325,226,950,3953
7,388,372,222,982,3953
8,396,367,243,1006,3953
9,395,386,257,1038,3953
10,396,383,263,1042,3953
11,416,403,250,1069,3953
1,500,200,50,750,3954
2,458,246,76,780,3954
3,414,284,117,815,3954
4,414,284,169,867,3954
5,403,300,185,888,3954
6,433,329,194,956,3954
7,411,342,224,977,3954
8,433,360,240,1033,3954
9,419,390,228,1037,3954
10,401,388,260,1049,3954
11,408,411,270,1089,3954
1,500,200,50,750,3955
2,463,224,94,781,3955
3,430,269,126,825,3955
4,408,298,157,863,3955
5,406,326,178,910,3955
6,420,328,217,965,3955
7,403,337,228,968,3955
8,402,367,246,1015,3955
9,408,377,248,1033,3955
10,409,419,240,1068,3955
11,413,415,257,1085,3955
1,500,200,50,750,3956
2,452,248,92,792,3956
3,415,279,138,832,3956
4,417,287,186,890,3956
5,385,282,227,894,3956
6,386,346,231,963,3956
7,371,341,256,968,3956
8,367,355,282,1004,3956
9,388,351,288,1027,3956
10,405,384,267,1056,3956
11,400,393,281,1074,3956
1,500,200,50,750,3957
2,466,238,90,794,3957
3,431,258,131,820,3957
4,407,289,171,867,3957
5,383,324,197,904,3957
6,412,334,216,962,3957
7,396,331,241,968,3957
8,398,347,248,993,3957
9,415,372,249,1036,3957
10,404,380,268,1052,3957
11,443,388,266,1097,3957
1,500,200,50,750,3958
2,460,228,96,784,3958
3,434,249,141,824,3958
4,417,286,162,865,3958
5,387,322,210,919,3958
6,402,353,208,963,3958
7,407,352,227,986,3958
8,403,385,238,1026,3958
9,395,382,252,1029,3958
10,428,377,276,1081,3958
11,421,382,283,1086,3958
1,500,200,50,750,3959
2,456,233,96,785,3959
3,452,257,128,837,3959
4,436,256,172,864,3959
5,427,286,208,921,3959
6,411,333,210,954,3959
7,404,351,243,998,3959
8,402,367,244,1013,3959
9,378,388,266,1032,3959
10,375,401,277,1053,3959
11,378,405,287,1070,3959
1,500,200,50,750,3960
2,460,219,105,784,3960
3,438,239,139,816,3960
4,434,265,154,853,3960
5,424,305,180,909,3960
6,410,333,206,949,3960
7,392,361,220,973,3960
8,404,382,235,1021,3960
9,384,379,263,1026,3960
10,405,406,259,1070,3960
11,385,400,288,1073,3960
1,500,200,50,750,3961
2,464,241,96,801,3961
3,426,266,135,827,3961
4,404,298,157,859,3961
5,420,329,192,941,3961
6,387,344,216,947,3961
7,379,356,246,981,3961
8,368,379,250,997,3961
9,373,378,281,1032,3961
10,386,379,310,1075,3961
11,393,400,300,1093,3961
1,500,200,50,750,3962
2,457,232,100,789,3962
3,415,262,144,821,3962
4,409,289,175,873,3962
5,395,315,195,905,3962
6,403,339,215,957,3962
7,401,345,235,981,3962
8,383,382,247,1012,3962
9,403,377,261,1041,3962
10,402,393,263,1058,3962
11,386,404,278,1068,3962
1,500,200,50,750,3963
2,455,225,102,782,3963
3,428,261,139,828,3963
4,412,286,173,871,3963
5,401,292,206,899,3963
6,422,315,232,969,3963
7,390,332,247,969,3963
8,386,351,260,997,3963
9,412,369,262,1043,3963
10,403,380,277,1060,3963
11,409,388,288,1085,3963
1,500,200,50,750,3964
2,453,227,111,791,3964
3,414,247,142,803,3964
4,437,284,152,873,3964
5,407,298,189,894,3964
6,431,322,204,957,3964
7,412,348,217,977,3964
8,407,371,239,1017,3964
9,370,400,247,1017,3964
10,369,413,281,1063,3964
11,363,433,276,1072,3964
1,500,200,50,750,3965
2,455,237,101,793,3965
3,446,252,134,832,3965
4,409,286,166,861,3965
5,423,290,204,917,3965
6,406,340,212,958,3965
7,394,364,213,971,3965
8,380,377,240,997,3965
9,391,383,257,1031,3965
10,405,403,257,1065,3965
11,403,394,264,1061,3965
1,500,200,50,750,3966
2,460,216,109,785,3966
3,435,259,131,825,3966
4,422,273,164,859,3966
5,440,306,172,918,3966
6,438,322,212,972,3966
7,402,351,229,982,3966
8,404,364,243,1011,3966
9,408,358,268,1034,3966
10,398,380,266,1044,3966
11,405,387,287,1079,3966
1,500,200,50,750,3967
2,456,249,94,799,3967
3,433,270,126,829,3967
4,396,299,155,850,3967
5,405,309,180,894,3967
6,418,322,209,949,3967
7,425,341,205,971,3967
8,423,360,229,1012,3967
9,399,378,238,1015,3967
10,412,371,262,1045,3967
11,412,376,298,1086,3967
1,500,200,50,750,3968
2,459,235,90,784,3968
3,449,248,126,823,3968
4,431,272,162,865,3968
5,395,298,205,898,3968
6,411,308,236,955,3968
7,407,331,240,978,3968
8,399,367,240,1006,3968
9,394,403,251,1048,3968
10,388,403,270,1061,3968
11,380,393,279,1052,3968
1,500,200,50,750,3969
2,462,231,95,788,3969
3,449,276,112,837,3969
4,426,290,138,854,3969
5,427,298,169,894,3969
6,444,313,189,946,3969
7,427,357,204,988,3969
8,417,365,208,990,3969
9,402,381,236,1019,3969
10,392,395,257,1044,3969
11,417,391,279,1087,3969
1,500,200,50,750,3970
2,455,235,100,790,3970
3,432,258,136,826,3970
4,411,292,170,873,3970
5,395,320,197,912,3970
6,405,353,207,965,3970
7,396,380,211,987,3970
8,385,394,215,994,3970
9,406,384,259,1049,3970
10,397,394,269,1060,3970
11,409,405,270,1084,3970
1,500,200,50,750,3971
2,453,249,89,791,3971
3,419,259,154,832,3971
4,421,275,183,879,3971
5,425,280,204,909,3971
6,409,315,207,931,3971
7,413,356,218,987,3971
8,402,349,240,991,3971
9,422,359,247,1028,3971
10,406,392,266,1064,3971
11,406,390,263,1059,3971
1,500,200,50,750,3972
2,451,232,108,791,3972
3,422,257,143,822,3972
4,388,285,174,847,3972
5,417,303,198,918,3972
6,378,333,227,938,3972
7,398,350,245,993,3972
8,383,359,260,1002,3972
9,396,371,260,1027,3972
10,420,398,264,1082,3972
11,395,415,269,1079,3972
1,500,200,50,750,3973
2,456,218,97,771,3973
3,448,241,141,830,3973
4,427,275,154,856,3973
5,431,288,184,903,3973
6,444,311,223,978,3973
7,421,348,221,990,3973
8,405,368,247,1020,3973
9,401,380,252,1033,3973
10,400,407,255,1062,3973
11,392,430,255,1077,3973
1,500,200,50,750,3974
2,451,230,94,775,3974
3,423,257,143,823,3974
4,411,276,175,862,3974
5,411,303,196,910,3974
6,429,337,207,973,3974
7,414,351,221,986,3974
8,402,350,244,996,3974
9,417,365,238,1020,3974
10,440,377,250,1067,3974
11,452,401,242,1095,3974
1,500,200,50,750,3975
2,458,225,99,782,3975
3,443,252,141,836,3975
4,411,290,159,860,3975
5,408,314,183,905,3975
6,402,336,207,945,3975
7,400,337,239,976,3975
8,404,359,244,1007,3975
9,411,370,245,1026,3975
10,413,408,241,1062,3975
11,411,432,257,1100,3975
1,500,200,50,750,3976
2,443,247,98,788,3976
3,422,259,144,825,3976
4,397,285,171,853,3976
5,413,306,200,919,3976
6,393,314,247,954,3976
7,393,358,233,984,3976
8,394,367,242,1003,3976
9,388,362,271,1021,3976
10,398,383,286,1067,3976
11,388,384,296,1068,3976
1,500,200,50,750,3977
2,462,217,103,782,3977
3,448,244,135,827,3977
4,463,248,163,874,3977
5,432,295,181,908,3977
6,439,323,192,954,3977
7,411,345,217,973,3977
8,402,378,242,1022,3977
9,383,371,270,1024,3977
10,417,368,272,1057,3977
11,403,393,279,1075,3977
1,500,200,50,750,3978
2,459,222,106,787,3978
3,420,270,128,818,3978
4,406,298,164,868,3978
5,399,321,175,895,3978
6,401,333,225,959,3978
7,399,361,236,996,3978
8,375,382,231,988,3978
9,386,394,247,1027,3978
10,420,413,248,1081,3978
11,401,426,253,1080,3978
1,500,200,50,750,3979
2,452,232,110,794,3979
3,429,264,150,843,3979
4,407,293,164,864,3979
5,400,325,198,923,3979
6,388,363,202,953,3979
7,390,382,220,992,3979
8,375,401,226,1002,3979
9,402,385,255,1042,3979
10,389,388,268,1045,3979
11,392,430,277,1099,3979
1,500,200,50,750,3980
2,476,223,96,795,3980
3,457,262,114,833,3980
4,441,270,153,864,3980
5,414,305,173,892,3980
6,424,333,195,952,3980
7,395,370,217,982,3980
8,390,380,242,1012,3980
9,395,375,255,1025,3980
10,392,371,278,1041,3980
11,384,384,296,1064,3980
1,500,200,50,750,3981
2,466,243,87,796,3981
3,439,265,128,832,3981
4,433,294,143,870,3981
5,406,333,166,905,3981
6,413,347,207,967,3981
7,384,368,221,973,3981
8,387,379,245,1011,3981
9,379,379,276,1034,3981
10,402,390,280,1072,3981
11,387,429,273,1089,3981
1,500,200,50,750,3982
2,457,231,95,783,3982
3,453,255,129,837,3982
4,424,296,142,862,3982
5,421,301,183,905,3982
6,404,336,206,946,3982
7,402,362,225,989,3982
8,382,364,261,1007,3982
9,393,389,251,1033,3982
10,388,414,245,1047,3982
11,378,422,268,1068,3982
1,500,200,50,750,3983
2,469,222,91,782,3983
3,433,264,123,820,3983
4,436,288,160,884,3983
5,416,313,177,906,3983
6,432,337,192,961,3983
7,423,339,210,972,3983
8,418,366,232,1016,3983
9,418,377,233,1028,3983
10,414,377,258,1049,3983
11,407,422,265,1094,3983
1,500,200,50,750,3984
2,440,227,113,780,3984
3,400,262,148,810,3984
4,381,291,189,861,3984
5,377,329,200,906,3984
6,387,332,240,959,3984
7,378,355,251,984,3984
8,369,386,245,1000,3984
9,362,386,269,1017,3984
10,380,406,265,1051,3984
11,396,395,283,1074,3984
1,500,200,50,750,3985
2,458,248,87,793,3985
3,436,279,126,841,3985
4,394,298,171,863,3985
5,383,333,187,903,3985
6,395,343,209,947,3985
7,395,343,237,975,3985
8,397,356,245,998,3985
9,403,377,249,1029,3985
10,383,404,271,1058,3985
11,393,433,260,1086,3985
1,500,200,50,750,3986
2,473,213,104,790,3986
3,440,255,132,827,3986
4,428,282,160,870,3986
5,415,310,173,898,3986
6,421,349,182,952,3986
7,409,366,208,983,3986
8,421,351,243,1015,3986
9,411,360,255,1026,3986
10,408,384,270,1062,3986
11,413,399,271,1083,3986
1,500,200,50,750,3987
2,446,231,103,780,3987
3,441,271,124,836,3987
4,401,272,181,854,3987
5,409,294,207,910,3987
6,409,337,228,974,3987
7,398,349,239,986,3987
8,410,358,244,1012,3987
9,412,353,262,1027,3987
10,403,383,263,1049,3987
11,409,378,290,1077,3987
1,500,200,50,750,3988
2,458,216,99,773,3988
3,454,251,136,841,3988
4,415,275,165,855,3988
5,403,279,214,896,3988
6,401,329,232,962,3988
7,385,359,229,973,3988
8,389,386,239,1014,3988
9,381,404,248,1033,3988
10,390,417,244,1051,3988
11,397,441,269,1107,3988
1,500,200,50,750,3989
2,452,243,94,789,3989
3,431,266,134,831,3989
4,428,290,165,883,3989
5,415,330,161,906,3989
6,449,329,174,952,3989
7,443,339,202,984,3989
8,406,387,216,1009,3989
9,395,380,259,1034,3989
10,377,411,259,1047,3989
11,410,389,280,1079,3989
1,500,200,50,750,3990
2,440,233,106,779,3990
3,430,275,130,835,3990
4,410,282,171,863,3990
5,408,309,198,915,3990
6,410,341,214,965,3990
7,390,338,241,969,3990
8,377,365,262,1004,3990
9,381,378,275,1034,3990
10,377,403,267,1047,3990
11,392,424,282,1098,3990
1,500,200,50,750,3991
2,471,228,95,794,3991
3,420,258,149,827,3991
4,415,281,184,880,3991
5,422,291,208,921,3991
6,408,303,220,931,3991
7,432,320,233,985,3991
8,420,347,242,1009,3991
9,419,374,245,1038,3991
10,399,387,276,1062,3991
11,397,414,275,1086,3991
1,500,200,50,750,3992
2,463,239,93,795,3992
3,430,251,142,823,3992
4,410,305,157,872,3992
5,387,319,205,911,3992
6,384,374,210,968,3992
7,364,387,221,972,3992
8,374,401,236,1011,3992
9,375,397,246,1018,3992
10,400,417,251,1068,3992
11,368,421,285,1074,3992
1,500,200,50,750,3993
2,448,228,104,780,3993
3,440,265,143,848,3993
4,430,275,162,867,3993
5,443,301,178,922,3993
6,441,322,197,960,3993
7,422,350,211,983,3993
8,417,360,230,1007,3993
9,406,373,245,1024,3993
10,427,370,272,1069,3993
11,434,395,279,1108,3993
1,500,200,50,750,3994
2,452,230,98,780,3994
3,424,257,136,817,3994
4,406,287,163,856,3994
5,411,319,189,919,3994
6,375,340,213,928,3994
7,397,361,211,969,3994
8,399,373,238,1010,3994
9,392,401,232,1025,3994
10,427,415,224,1066,3994
11,419,423,232,1074,3994
1,500,200,50,750,3995
2,477,217,101,795,3995
3,443,257,134,834,3995
4,425,280,163,868,3995
5,415,304,175,894,3995
6,443,334,206,983,3995
7,412,341,232,985,3995
8,414,369,231,1014,3995
9,403,388,240,1031,3995
10,394,413,258,1065,3995
11,387,431,258,1076,3995
1,500,200,50,750,3996
2,469,244,97,810,3996
3,437,259,133,829,3996
4,426,303,153,882,3996
5,404,331,178,913,3996
6,389,336,212,937,3996
7,384,370,240,994,3996
8,391,391,233,1015,3996
9,387,392,250,1029,3996
10,406,393,265,1064,3996
11,414,413,257,1084,3996
1,500,200,50,750,3997
2,454,246,95,795,3997
3,416,285,139,840,3997
4,401,300,177,878,3997
5,382,314,221,917,3997
6,396,341,227,964,3997
7,381,365,230,976,3997
8,383,392,227,1002,3997
9,410,387,244,1041,3997
10,408,386,266,1060,3997
11,427,384,272,1083,3997
1,500,200,50,750,3998
2,471,238,81,790,3998
3,454,271,115,840,3998
4,438,298,135,871,3998
5,410,319,182,911,3998
6,404,342,222,968,3998
7,391,349,245,985,3998
8,375,361,273,1009,3998
9,399,386,256,1041,3998
10,408,394,261,1063,3998
11,407,401,265,1073,3998
1,500,200,50,750,3999
2,482,205,95,782,3999
3,455,249,128,832,3999
4,430,281,154,865,3999
5,424,309,190,923,3999
6,406,316,217,939,3999
7,437,344,226,1007,3999
8,392,367,239,998,3999
9,387,402,243,1032,3999
10,405,392,265,1062,3999
11,417,400,269,1086,3999
1,500,200,50,750,4000
2,462,227,93,782,4000
3,423,264,140,827,4000
4,404,304,164,872,4000
5,383,345,177,905,4000
6,383,372,210,965,4000
7,368,415,199,982,4000
8,382,384,229,995,4000
9,397,387,264,1048,4000
10,385,385,291,1061,4000
11,388,401,293,1082,4000
1,500,200,50,750,4001
2,434,238,109,781,4001
3,424,247,157,828,4001
4,416,290,163,869,4001
5,412,303,202,917,4001
6,399,329,212,940,4001
7,391,355,220,966,4001
8,393,373,249,1015,4001
9,397,368,269,1034,4001
10,415,361,287,1063,4001
11,406,384,291,1081,4001
1,500,200,50,750,4002
2,456,233,96,785,4002
3,443,268,127,838,4002
4,425,287,161,873,4002
5,417,323,167,907,4002
6,399,365,205,969,4002
7,389,383,205,977,4002
8,392,393,230,1015,4002
9,392,384,258,1034,4002
10,411,413,240,1064,4002
11,420,410,263,1093,4002
1,500,200,50,750,4003
2,433,237,99,769,4003
3,440,267,142,849,4003
4,397,299,185,881,4003
5,387,317,204,908,4003
6,387,342,220,949,4003
7,392,371,221,984,4003
8,386,386,241,1013,4003
9,392,391,254,1037,4003
10,396,385,279,1060,4003
11,384,410,287,1081,4003
1,500,200,50,750,4004
2,467,223,95,785,4004
3,448,258,125,831,4004
4,445,273,153,871,4004
5,429,309,168,906,4004
6,447,333,192,972,4004
7,430,329,232,991,4004
8,402,353,244,999,4004
9,421,361,255,1037,4004
10,425,385,255,1065,4004
11,404,378,286,1068,4004
1,500,200,50,750,4005
2,449,240,100,789,4005
3,422,275,139,836,4005
4,402,302,184,888,4005
5,382,334,195,911,4005
6,365,358,219,942,4005
7,360,388,214,962,4005
8,375,400,232,1007,4005
9,381,387,271,1039,4005
10,365,399,285,1049,4005
11,365,402,314,1081,4005
1,500,200,50,750,4006
2,461,241,88,790,4006
3,432,259,122,813,4006
4,445,299,153,897,4006
5,420,322,184,926,4006
6,396,333,223,952,4006
7,381,366,237,984,4006
8,381,371,248,1000,4006
9,369,399,255,1023,4006
10,389,407,258,1054,4006
11,382,424,266,1072,4006
1,500,200,50,750,4007
2,453,223,100,776,4007
3,441,258,130,829,4007
4,425,277,158,860,4007
5,396,333,180,909,4007
6,412,339,204,955,4007
7,418,333,230,981,4007
8,401,357,239,997,4007
9,386,378,257,1021,4007
10,420,416,242,1078,4007
11,396,419,265,1080,4007
1,500,200,50,750,4008
2,475,220,93,788,4008
3,449,251,129,829,4008
4,440,277,146,863,4008
5,406,310,180,896,4008
6,422,347,197,966,4008
7,411,350,230,991,4008
8,402,358,247,1007,4008
9,394,367,279,1040,4008
10,385,393,292,1070,4008
11,372,417,287,1076,4008
1,500,200,50,750,4009
2,429,247,121,797,4009
3,417,270,138,825,4009
4,419,288,158,865,4009
5,417,302,192,911,4009
6,436,317,200,953,4009
7,423,338,216,977,4009
8,415,362,235,1012,4009
9,418,353,260,1031,4009
10,424,378,253,1055,4009
11,412,410,265,1087,4009
1,500,200,50,750,4010
2,472,229,87,788,4010
3,430,267,123,820,4010
4,427,278,156,861,4010
5,433,284,187,904,4010
6,442,321,213,976,4010
7,408,353,218,979,4010
8,394,381,236,1011,4010
9,387,371,264,1022,4010
10,378,399,265,1042,4010
11,382,409,276,1067,4010
1,500,200,50,750,4011
2,456,217,104,777,4011
3,430,263,130,823,4011
4,432,261,166,859,4011
5,421,316,192,929,4011
6,403,349,204,956,4011
7,397,372,222,991,4011
8,400,377,244,1021,4011
9,384,380,260,1024,4011
10,380,395,270,1045,4011
11,392,409,274,1075,4011
1,500,200,50,750,4012
2,439,242,93,774,4012
3,417,274,138,829,4012
4,388,300,163,851,4012
5,395,309,193,897,4012
6,417,330,214,961,4012
7,406,332,231,969,4012
8,414,338,257,1009,4012
9,395,361,272,1028,4012
10,412,383,271,1066,4012
11,436,370,279,1085,4012
1,500,200,50,750,4013
2,445,228,110,783,4013
3,434,253,132,819,4013
4,409,264,179,852,4013
5,403,315,194,912,4013
6,393,354,216,963,4013
7,368,351,247,966,4013
8,380,362,242,984,4013
9,384,385,259,1028,4013
10,401,377,274,1052,4013
11,399,404,272,1075,4013
1,500,200,50,750,4014
2,454,233,106,793,4014
3,427,278,127,832,4014
4,421,298,154,873,4014
5,412,320,172,904,4014
6,419,335,198,952,4014
7,430,334,211,975,4014
8,433,381,213,1027,4014
9,428,370,239,1037,4014
10,424,380,248,1052,4014
11,438,398,256,1092,4014
1,500,200,50,750,4015
2,450,240,101,791,4015
3,424,266,137,827,4015
4,403,291,174,868,4015
5,401,331,185,917,4015
6,422,334,207,963,4015
7,385,367,222,974,4015
8,389,377,238,1004,4015
9,381,422,242,1045,4015
10,367,426,259,1052,4015
11,401,435,258,1094,4015
1,500,200,50,750,4016
2,457,229,97,783,4016
3,437,248,142,827,4016
4,417,282,169,868,4016
5,406,335,174,915,4016
6,417,328,214,959,4016
7,399,356,225,980,4016
8,389,376,239,1004,4016
9,386,375,262,1023,4016
10,401,385,276,1062,4016
11,395,410,272,1077,4016
1,500,200,50,750,4017
2,461,201,118,780,4017
3,432,250,137,819,4017
4,430,280,152,862,4017
5,430,321,162,913,4017
6,417,319,202,938,4017
7,422,341,230,993,4017
8,408,354,245,1007,4017
9,384,386,243,1013,4017
10,391,385,278,1054,4017
11,391,414,284,1089,4017
1,500,200,50,750,4018
2,444,254,91,789,4018
3,424,279,120,823,4018
4,402,319,143,864,4018
5,398,317,198,913,4018
6,407,332,222,961,4018
7,409,357,223,989,4018
8,416,370,225,1011,4018
9,410,373,242,1025,4018
10,414,372,264,1050,4018
11,440,390,257,1087,4018
1,500,200,50,750,4019
2,481,220,91,792,4019
3,439,248,134,821,4019
4,436,272,166,874,4019
5,418,321,186,925,4019
6,420,357,197,974,4019
7,408,361,208,977,4019
8,400,370,236,1006,4019
9,380,376,254,1010,4019
10,404,406,259,1069,4019
11,401,413,267,1081,4019
1,500,200,50,750,4020
2,455,226,100,781,4020
3,448,249,141,838,4020
4,411,278,172,861,4020
5,427,313,202,942,4020
6,410,345,213,968,4020
7,413,346,222,981,4020
8,421,362,225,1008,4020
9,407,366,244,1017,4020
10,414,383,253,1050,4020
11,410,390,270,1070,4020
1,500,200,50,750,4021
2,460,233,91,784,4021
3,403,274,134,811,4021
4,394,310,167,871,4021
5,388,323,186,897,4021
6,419,319,208,946,4021
7,407,358,218,983,4021
8,395,369,238,1002,4021
9,384,375,262,1021,4021
10,387,365,281,1033,4021
11,412,393,269,1074,4021
1,500,200,50,750,4022
2,457,229,106,792,4022
3,430,255,141,826,4022
4,421,268,172,861,4022
5,415,315,178,908,4022
6,400,349,203,952,4022
7,382,364,223,969,4022
8,393,383,232,1008,4022
9,391,382,261,1034,4022
10,392,382,272,1046,4022
11,403,416,267,1086,4022
1,500,200,50,750,4023
2,466,235,98,799,4023
3,450,235,143,828,4023
4,447,265,166,878,4023
5,431,298,194,923,4023
6,421,309,218,948,4023
7,421,331,226,978,4023
8,417,357,220,994,4023
9,411,375,239,1025,4023
10,408,405,240,1053,4023
11,409,421,263,1093,4023
1,500,200,50,750,4024
2,443,243,97,783,4024
3,424,281,122,827,4024
4,421,296,161,878,4024
5,402,337,171,910,4024
6,398,344,219,961,4024
7,395,347,231,973,4024
8,385,361,233,979,4024
9,384,398,249,1031,4024
10,396,413,263,1072,4024
11,370,410,288,1068,4024
1,500,200,50,750,4025
2,460,247,91,798,4025
3,418,273,136,827,4025
4,414,302,159,875,4025
5,401,327,176,904,4025
6,408,342,211,961,4025
7,399,366,224,989,4025
8,390,376,226,992,4025
9,401,387,254,1042,4025
10,412,400,252,1064,4025
11,393,419,264,1076,4025
1,500,200,50,750,4026
2,457,213,112,782,4026
3,435,250,134,819,4026
4,449,272,151,872,4026
5,423,310,175,908,4026
6,428,333,203,964,4026
7,386,352,240,978,4026
8,383,381,255,1019,4026
9,383,380,264,1027,4026
10,396,375,296,1067,4026
11,398,416,258,1072,4026
1,500,200,50,750,4027
2,465,209,113,787,4027
3,442,232,153,827,4027
4,387,295,179,861,4027
5,388,314,220,922,4027
6,376,359,225,960,4027
7,359,384,234,977,4027
8,380,385,248,1013,4027
9,388,408,233,1029,4027
10,391,407,265,1063,4027
11,385,395,300,1080,4027
1,500,200,50,750,4028
2,461,224,92,777,4028
3,405,262,152,819,4028
4,407,298,174,879,4028
5,403,332,188,923,4028
6,379,360,209,948,4028
7,394,365,219,978,4028
8,401,371,235,1007,4028
9,409,391,239,1039,4028
10,383,410,265,1058,4028
11,398,419,285,1102,4028
1,500,200,50,750,4029
2,448,242,114,804,4029
3,426,263,152,841,4029
4,385,291,178,854,4029
5,411,311,196,918,4029
6,413,319,210,942,4029
7,404,366,204,974,4029
8,408,359,241,1008,4029
9,411,383,229,1023,4029
10,408,402,251,1061,4029
11,416,414,247,1077,4029
1,500,200,50,750,4030
2,450,241,98,789,4030
3,431,263,141,835,4030
4,438,292,159,889,4030
5,433,319,165,917,4030
6,434,326,188,948,4030
7,431,347,222,1000,4030
8,415,363,227,1005,4030
9,408,356,269,1033,4030
10,402,382,265,1049,4030
11,398,414,284,1096,4030
1,500,200,50,750,4031
2,473,240,90,803,4031
3,445,253,127,825,4031
4,432,295,149,876,4031
5,409,322,162,893,4031
6,410,365,174,949,4031
7,406,386,208,1000,4031
8,394,360,237,991,4031
9,409,385,253,1047,4031
10,377,424,257,1058,4031
11,376,418,279,1073,4031
1,500,200,50,750,4032
2,448,218,114,780,4032
3,433,265,146,844,4032
4,408,303,164,875,4032
5,387,329,195,911,4032
6,370,357,215,942,4032
7,387,360,245,992,4032
8,359,397,257,1013,4032
9,370,392,276,1038,4032
10,395,385,297,1077,4032
11,379,392,297,1068,4032
1,500,200,50,750,4033
2,456,238,92,786,4033
3,427,269,141,837,4033
4,419,267,185,871,4033
5,409,301,205,915,4033
6,426,340,207,973,4033
7,398,372,213,983,4033
8,389,359,241,989,4033
9,392,391,253,1036,4033
10,422,396,238,1056,4033
11,422,400,258,1080,4033
1,500,200,50,750,4034
2,450,247,91,788,4034
3,421,284,117,822,4034
4,404,309,138,851,4034
5,415,336,160,911,4034
6,441,347,179,967,4034
7,414,354,215,983,4034
8,419,351,232,1002,4034
9,411,379,244,1034,4034
10,439,397,245,1081,4034
11,411,404,270,1085,4034
1,500,200,50,750,4035
2,462,232,80,774,4035
3,433,286,116,835,4035
4,398,315,144,857,4035
5,381,346,183,910,4035
6,380,367,215,962,4035
7,380,382,226,988,4035
8,374,412,220,1006,4035
9,396,398,236,1030,4035
10,402,388,265,1055,4035
11,405,424,264,1093,4035
1,500,200,50,750,4036
2,454,218,94,766,4036
3,444,259,137,840,4036
4,419,297,160,876,4036
5,409,333,191,933,4036
6,390,347,221,958,4036
7,367,363,236,966,4036
8,379,394,244,1017,4036
9,402,386,254,1042,4036
10,397,402,249,1048,4036
11,410,433,241,1084,4036
1,500,200,50,750,4037
2,430,246,99,775,4037
3,437,264,138,839,4037
4,411,281,175,867,4037
5,401,308,200,909,4037
6,401,303,237,941,4037
7,401,354,241,996,4037
8,390,364,249,1003,4037
9,413,366,262,1041,4037
10,388,398,272,1058,4037
11,393,398,293,1084,4037
1,500,200,50,750,4038
2,459,224,111,794,4038
3,452,255,130,837,4038
4,410,283,170,863,4038
5,409,312,188,909,4038
6,426,338,213,977,4038
7,399,347,238,984,4038
8,392,352,249,993,4038
9,405,362,278,1045,4038
10,380,389,281,1050,4038
11,394,403,291,1088,4038
1,500,200,50,750,4039
2,473,223,97,793,4039
3,444,255,125,824,4039
4,428,279,170,877,4039
5,405,307,199,911,4039
6,429,332,209,970,4039
7,394,351,235,980,4039
8,391,362,251,1004,4039
9,382,395,257,1034,4039
10,397,386,286,1069,4039
11,407,400,294,1101,4039
1,500,200,50,750,4040
2,445,249,99,793,4040
3,407,277,140,824,4040
4,410,285,176,871,4040
5,392,307,215,914,4040
6,391,353,218,962,4040
7,399,369,212,980,4040
8,413,371,236,1020,4040
9,373,380,271,1024,4040
10,372,405,268,1045,4040
11,358,432,288,1078,4040
1,500,200,50,750,4041
2,446,233,109,788,4041
3,427,250,134,811,4041
4,426,283,149,858,4041
5,406,329,180,915,4041
6,405,324,215,944,4041
7,406,353,227,986,4041
8,398,372,245,1015,4041
9,387,376,265,1028,4041
10,377,400,285,1062,4041
11,400,378,300,1078,4041
1,500,200,50,750,4042
2,463,216,110,789,4042
3,424,247,144,815,4042
4,436,277,167,880,4042
5,417,299,197,913,4042
6,418,322,232,972,4042
7,398,357,229,984,4042
8,391,398,225,1014,4042
9,404,412,231,1047,4042
10,408,409,244,1061,4042
11,412,392,281,1085,4042
1,500,200,50,750,4043
2,471,220,89,780,4043
3,454,254,128,836,4043
4,418,278,170,866,4043
5,393,317,187,897,4043
6,420,341,193,954,4043
7,393,383,198,974,4043
8,387,364,248,999,4043
9,397,370,265,1032,4043
10,389,382,294,1065,4043
11,398,409,278,1085,4043
1,500,200,50,750,4044
2,452,227,106,785,4044
3,436,266,140,842,4044
4,408,297,161,866,4044
5,376,308,201,885,4044
6,393,309,230,932,4044
7,401,334,243,978,4044
8,404,361,252,1017,4044
9,400,369,270,1039,4044
10,409,384,264,1057,4044
11,421,403,260,1084,4044
1,500,200,50,750,4045
2,460,226,87,773,4045
3,429,271,136,836,4045
4,395,280,185,860,4045
5,390,317,204,911,4045
6,392,334,230,956,4045
7,388,378,213,979,4045
8,394,351,255,1000,4045
9,402,375,258,1035,4045
10,392,389,277,1058,4045
11,423,396,279,1098,4045
1,500,200,50,750,4046
2,455,227,112,794,4046
3,427,270,135,832,4046
4,440,286,154,880,4046
5,423,295,178,896,4046
6,424,335,187,946,4046
7,420,330,237,987,4046
8,405,344,249,998,4046
9,424,367,263,1054,4046
10,404,389,262,1055,4046
11,416,402,269,1087,4046
1,500,200,50,750,4047
2,474,232,94,800,4047
3,428,259,152,839,4047
4,402,277,177,856,4047
5,408,317,205,930,4047
6,397,322,233,952,4047
7,377,356,246,979,4047
8,383,371,248,1002,4047
9,368,405,250,1023,4047
10,391,398,266,1055,4047
11,411,404,280,1095,4047
1,500,200,50,750,4048
2,443,233,114,790,4048
3,436,271,125,832,4048
4,422,294,154,870,4048
5,385,320,188,893,4048
6,404,355,204,963,4048
7,391,359,235,985,4048
8,371,380,243,994,4048
9,395,369,270,1034,4048
10,388,406,265,1059,4048
11,382,429,269,1080,4048
1,500,200,50,750,4049
2,466,230,102,798,4049
3,425,264,143,832,4049
4,402,280,189,871,4049
5,417,302,203,922,4049
6,396,338,217,951,4049
7,416,344,207,967,4049
8,431,362,231,1024,4049
9,412,376,252,1040,4049
10,426,379,262,1067,4049
11,419,399,268,1086,4049
1,500,200,50,750,4050
2,476,224,100,800,4050
3,427,259,131,817,4050
4,411,295,169,875,4050
5,398,319,191,908,4050
6,395,332,216,943,4050
7,407,346,215,968,4050
8,414,388,225,1027,4050
9,403,390,255,1048,4050
10,373,411,274,1058,4050
11,376,416,288,1080,4050
1,500,200,50,750,4051
2,451,241,97,789,4051
3,444,251,131,826,4051
4,425,302,148,875,4051
5,427,338,168,933,4051
6,397,363,197,957,4051
7,393,360,222,975,4051
8,397,371,236,1004,4051
9,394,392,257,1043,4051
10,382,403,276,1061,4051
11,394,399,285,1078,4051
1,500,200,50,750,4052
2,475,244,91,810,4052
3,432,251,137,820,4052
4,414,287,162,863,4052
5,401,311,187,899,4052
6,445,324,211,980,4052
7,414,323,237,974,4052
8,418,360,229,1007,4052
9,398,387,232,1017,4052
10,397,387,256,1040,4052
11,402,417,273,1092,4052
1,500,200,50,750,4053
2,439,227,103,769,4053
3,444,253,125,822,4053
4,416,274,173,863,4053
5,425,306,188,919,4053
6,414,355,191,960,4053
7,425,373,202,1000,4053
8,412,356,232,1000,4053
9,400,390,239,1029,4053
10,393,419,242,1054,4053
11,401,413,263,1077,4053
1,500,200,50,750,4054
2,448,238,94,780,4054
3,425,267,145,837,4054
4,396,270,190,856,4054
5,415,292,203,910,4054
6,417,341,210,968,4054
7,409,326,250,985,4054
8,412,350,247,1009,4054
9,417,369,256,1042,4054
10,404,396,262,1062,4054
11,392,411,263,1066,4054
1,500,200,50,750,4055
2,437,251,101,789,4055
3,395,291,130,816,4055
4,386,303,174,863,4055
5,375,329,196,900,4055
6,390,366,208,964,4055
7,373,377,229,979,4055
8,401,391,240,1032,4055
9,372,399,253,1024,4055
10,371,398,284,1053,4055
11,362,421,304,1087,4055
1,500,200,50,750,4056
2,465,243,84,792,4056
3,436,288,121,845,4056
4,406,325,139,870,4056
5,399,337,174,910,4056
6,382,349,213,944,4056
7,396,334,247,977,4056
8,379,340,284,1003,4056
9,367,377,271,1015,4056
10,386,399,273,1058,4056
11,405,397,290,1092,4056
1,500,200,50,750,4057
2,472,218,110,800,4057
3,451,244,129,824,4057
4,446,279,160,885,4057
5,444,287,200,931,4057
6,428,323,218,969,4057
7,399,357,232,988,4057
8,376,398,240,1014,4057
9,385,403,247,1035,4057
10,369,409,262,1040,4057
11,379,447,259,1085,4057
1,500,200,50,750,4058
2,463,229,100,792,4058
3,443,242,143,828,4058
4,406,273,183,862,4058
5,419,307,194,920,4058
6,419,324,214,957,4058
7,389,344,252,985,4058
8,374,372,256,1002,4058
9,376,403,251,1030,4058
10,371,423,276,1070,4058
11,345,424,303,1072,4058
1,500,200,50,750,4059
2,470,231,79,780,4059
3,448,249,127,824,4059
4,430,282,154,866,4059
5,425,312,192,929,4059
6,419,326,217,962,4059
7,401,346,230,977,4059
8,376,372,258,1006,4059
9,382,370,267,1019,4059
10,419,386,271,1076,4059
11,421,388,277,1086,4059
1,500,200,50,750,4060
2,471,217,99,787,4060
3,457,259,124,840,4060
4,412,303,151,866,4060
5,396,306,198,900,4060
6,403,345,202,950,4060
7,394,368,214,976,4060
8,394,392,234,1020,4060
9,396,386,248,1030,4060
10,395,386,273,1054,4060
11,399,419,275,1093,4060
1,500,200,50,750,4061
2,469,227,101,797,4061
3,434,261,130,825,4061
4,412,321,147,880,4061
5,380,348,183,911,4061
6,400,352,210,962,4061
7,404,346,226,976,4061
8,398,355,238,991,4061
9,395,361,254,1010,4061
10,389,364,282,1035,4061
11,404,384,305,1093,4061
1,500,200,50,750,4062
2,434,257,91,782,4062
3,422,284,133,839,4062
4,401,305,155,861,4062
5,415,333,175,923,4062
6,407,346,179,932,4062
7,401,370,199,970,4062
8,389,364,244,997,4062
9,409,359,265,1033,4062
10,387,393,275,1055,4062
11,401,394,279,1074,4062
1,500,200,50,750,4063
2,443,264,89,796,4063
3,401,288,139,828,4063
4,398,302,170,870,4063
5,387,317,200,904,4063
6,384,352,213,949,4063
7,411,366,226,1003,4063
8,384,388,241,1013,4063
9,362,380,269,1011,4063
10,393,384,291,1068,4063
11,380,407,305,1092,4063
1,500,200,50,750,4064
2,453,243,87,783,4064
3,439,254,133,826,4064
4,428,289,148,865,4064
5,425,328,163,916,4064
6,418,350,189,957,4064
7,404,376,206,986,4064
8,409,389,220,1018,4064
9,399,382,244,1025,4064
10,393,407,262,1062,4064
11,412,413,268,1093,4064
1,500,200,50,750,4065
2,455,242,94,791,4065
3,433,254,123,810,4065
4,433,281,145,859,4065
5,424,311,181,916,4065
6,407,322,218,947,4065
7,398,364,225,987,4065
8,407,378,240,1025,4065
9,391,356,267,1014,4065
10,406,389,279,1074,4065
11,390,404,282,1076,4065
1,500,200,50,750,4066
2,434,233,111,778,4066
3,421,257,142,820,4066
4,428,281,171,880,4066
5,412,304,195,911,4066
6,421,332,219,972,4066
7,389,346,243,978,4066
8,389,363,257,1009,4066
9,399,381,264,1044,4066
10,405,386,276,1067,4066
11,402,413,259,1074,4066
1,500,200,50,750,4067
2,436,250,103,789,4067
3,422,275,127,824,4067
4,410,312,151,873,4067
5,404,330,177,911,4067
6,394,351,205,950,4067
7,396,377,209,982,4067
8,413,373,217,1003,4067
9,419,374,234,1027,4067
10,409,403,240,1052,4067
11,431,407,255,1093,4067
1,500,200,50,750,4068
2,449,239,101,789,4068
3,401,278,137,816,4068
4,399,309,164,872,4068
5,393,321,189,903,4068
6,409,353,204,966,4068
7,416,348,205,969,4068
8,422,357,225,1004,4068
9,406,380,236,1022,4068
10,402,386,268,1056,4068
11,409,397,280,1086,4068
1,500,200,50,750,4069
2,462,227,97,786,4069
3,416,271,135,822,4069
4,395,294,189,878,4069
5,407,317,203,927,4069
6,400,337,220,957,4069
7,391,361,231,983,4069
8,390,360,250,1000,4069
9,380,385,272,1037,4069
10,372,409,275,1056,4069
11,381,408,304,1093,4069
1,500,200,50,750,4070
2,465,233,97,795,4070
3,425,250,146,821,4070
4,401,298,164,863,4070
5,417,303,197,917,4070
6,418,323,222,963,4070
7,400,338,249,987,4070
8,383,357,270,1010,4070
9,370,395,278,1043,4070
10,368,424,278,1070,4070
11,359,417,292,1068,4070
1,500,200,50,750,4071
2,465,226,95,786,4071
3,444,248,139,831,4071
4,406,292,164,862,4071
5,405,314,180,899,4071
6,434,321,220,975,4071
7,410,341,229,980,4071
8,395,350,242,987,4071
9,408,344,262,1014,4071
10,416,389,272,1077,4071
11,428,369,287,1084,4071
1,500,200,50,750,4072
2,458,226,94,778,4072
3,425,255,142,822,4072
4,410,273,165,848,4072
5,412,288,213,913,4072
6,392,327,222,941,4072
7,387,343,235,965,4072
8,391,373,250,1014,4072
9,397,385,259,1041,4072
10,388,394,276,1058,4072
11,406,388,290,1084,4072
1,500,200,50,750,4073
2,469,236,90,795,4073
3,424,269,149,842,4073
4,412,279,175,866,4073
5,400,301,192,893,4073
6,428,323,217,968,4073
7,406,364,223,993,4073
8,397,389,238,1024,4073
9,406,375,251,1032,4073
10,423,393,251,1067,4073
11,400,403,277,1080,4073
1,500,200,50,750,4074
2,461,224,106,791,4074
3,429,260,141,830,4074
4,427,277,171,875,4074
5,407,298,206,911,4074
6,428,320,222,970,4074
7,395,350,230,975,4074
8,404,368,236,1008,4074
9,400,379,248,1027,4074
10,406,404,244,1054,4074
11,411,410,251,1072,4074
1,500,200,50,750,4075
2,447,230,103,780,4075
3,408,261,143,812,4075
4,401,294,170,865,4075
5,374,320,200,894,4075
6,373,374,202,949,4075
7,368,381,223,972,4075
8,368,364,271,1003,4075
9,366,406,272,1044,4075
10,357,421,282,1060,4075
11,352,423,307,1082,4075
1,500,200,50,750,4076
2,452,241,91,784,4076
3,434,259,130,823,4076
4,433,287,150,870,4076
5,423,290,180,893,4076
6,445,366,181,992,4076
7,411,369,197,977,4076
8,398,371,230,999,4076
9,407,406,228,1041,4076
10,434,386,244,1064,4076
11,437,393,258,1088,4076
1,500,200,50,750,4077
2,454,217,116,787,4077
3,429,269,137,835,4077
4,413,309,158,880,4077
5,398,318,193,909,4077
6,419,345,193,957,4077
7,407,359,203,969,4077
8,410,383,217,1010,4077
9,422,369,240,1031,4077
10,415,380,262,1057,4077
11,406,388,288,1082,4077
1,500,200,50,750,4078
2,446,235,101,782,4078
3,432,258,131,821,4078
4,432,281,161,874,4078
5,388,328,182,898,4078
6,394,361,212,967,4078
7,398,365,231,994,4078
8,380,380,239,999,4078
9,399,385,253,1037,4078
10,406,401,261,1068,4078
11,373,436,270,1079,4078
1,500,200,50,750,4079
2,471,236,92,799,4079
3,420,259,141,820,4079
4,408,290,155,853,4079
5,400,317,185,902,4079
6,431,313,215,959,4079
7,400,347,232,979,4079
8,418,367,232,1017,4079
9,396,364,247,1007,4079
10,411,361,266,1038,4079
11,438,398,279,1115,4079
1,500,200,50,750,4080
2,451,247,98,796,4080
3,415,260,147,822,4080
4,397,279,172,848,4080
5,432,300,200,932,4080
6,419,347,197,963,4080
7,402,358,225,985,4080
8,399,359,248,1006,4080
9,396,365,270,1031,4080
10,400,367,292,1059,4080
11,393,416,285,1094,4080
1,500,200,50,750,4081
2,461,243,88,792,4081
3,432,239,147,818,4081
4,424,285,144,853,4081
5,429,311,163,903,4081
6,436,339,183,958,4081
7,416,354,214,984,4081
8,411,375,225,1011,4081
9,412,393,235,1040,4081
10,400,397,259,1056,4081
11,391,391,286,1068,4081
1,500,200,50,750,4082
2,456,222,101,779,4082
3,422,269,130,821,4082
4,383,316,162,861,4082
5,374,323,209,906,4082
6,388,367,214,969,4082
7,388,376,222,986,4082
8,368,394,251,1013,4082
9,359,400,254,1013,4082
10,388,426,250,1064,4082
11,388,418,274,1080,4082
1,500,200,50,750,4083
2,460,236,95,791,4083
3,433,256,145,834,4083
4,423,288,166,877,4083
5,402,307,207,916,4083
6,409,336,214,959,4083
7,405,331,240,976,4083
8,391,368,253,1012,4083
9,375,397,247,1019,4083
10,387,405,267,1059,4083
11,389,406,279,1074,4083
1,500,200,50,750,4084
2,453,227,97,777,4084
3,438,253,133,824,4084
4,422,284,171,877,4084
5,421,291,202,914,4084
6,399,342,208,949,4084
7,409,333,238,980,4084
8,409,338,252,999,4084
9,410,382,246,1038,4084
10,417,412,229,1058,4084
11,433,398,253,1084,4084
1,500,200,50,750,4085
2,441,242,99,782,4085
3,422,267,137,826,4085
4,406,291,181,878,4085
5,416,304,204,924,4085
6,410,323,224,957,4085
7,403,330,244,977,4085
8,419,362,241,1022,4085
9,403,367,251,1021,4085
10,413,361,273,1047,4085
11,413,385,275,1073,4085
1,500,200,50,750,4086
2,468,236,82,786,4086
3,434,272,116,822,4086
4,406,295,149,850,4086
5,425,312,177,914,4086
6,411,344,206,961,4086
7,408,352,229,989,4086
8,385,348,255,988,4086
9,395,377,267,1039,4086
10,405,378,272,1055,4086
11,387,408,281,1076,4086
1,500,200,50,750,4087
2,461,222,99,782,4087
3,464,239,138,841,4087
4,455,263,156,874,4087
5,449,286,173,908,4087
6,453,322,192,967,4087
7,403,340,223,966,4087
8,415,357,244,1016,4087
9,407,373,250,1030,4087
10,406,401,256,1063,4087
11,431,406,258,1095,4087
1,500,200,50,750,4088
2,463,227,97,787,4088
3,440,268,136,844,4088
4,411,288,170,869,4088
5,406,325,170,901,4088
6,420,335,205,960,4088
7,405,351,220,976,4088
8,399,369,239,1007,4088
9,382,359,276,1017,4088
10,394,397,268,1059,4088
11,430,420,263,1113,4088
1,500,200,50,750,4089
2,451,227,100,778,4089
3,420,283,132,835,4089
4,389,329,158,876,4089
5,388,340,195,923,4089
6,386,345,227,958,4089
7,388,342,247,977,4089
8,402,375,261,1038,4089
9,404,393,249,1046,4089
10,388,389,267,1044,4089
11,392,415,287,1094,4089
1,500,200,50,750,4090
2,456,231,102,789,4090
3,405,292,128,825,4090
4,394,288,176,858,4090
5,370,336,198,904,4090
6,396,361,211,968,4090
7,368,367,251,986,4090
8,376,358,259,993,4090
9,369,386,286,1041,4090
10,345,394,307,1046,4090
11,363,415,302,1080,4090
1,500,200,50,750,4091
2,469,213,109,791,4091
3,435,245,151,831,4091
4,415,266,179,860,4091
5,411,312,188,911,4091
6,428,328,204,960,4091
7,403,348,229,980,4091
8,411,361,225,997,4091
9,392,383,246,1021,4091
10,397,403,273,1073,4091
11,381,422,278,1081,4091
1,500,200,50,750,4092
2,463,221,106,790,4092
3,425,260,134,819,4092
4,411,286,169,866,4092
5,406,308,194,908,4092
6,413,337,222,972,4092
7,401,348,227,976,4092
8,397,372,238,1007,4092
9,397,365,263,1025,4092
10,399,399,267,1065,4092
11,418,403,267,1088,4092
1,500,200,50,750,4093
2,452,248,88,788,4093
3,431,266,133,830,4093
4,432,289,148,869,4093
5,440,305,190,935,4093
6,417,358,181,956,4093
7,401,385,204,990,4093
8,390,387,219,996,4093
9,387,391,236,1014,4093
10,407,396,257,1060,4093
11,400,413,268,1081,4093
1,500,200,50,750,4094
2,470,229,89,788,4094
3,453,261,132,846,4094
4,421,278,169,868,4094
5,398,291,215,904,4094
6,399,347,217,963,4094
7,385,346,258,989,4094
8,390,361,265,1016,4094
9,398,371,269,1038,4094
10,395,372,273,1040,4094
11,422,374,287,1083,4094
1,500,200,50,750,4095
2,477,218,101,796,4095
3,448,257,122,827,4095
4,426,311,139,876,4095
5,421,308,171,900,4095
6,431,313,188,932,4095
7,451,331,201,983,4095
8,406,360,220,986,4095
9,405,381,254,1040,4095
10,369,390,287,1046,4095
11,388,415,304,1107,4095
1,500,200,50,750,4096
2,462,225,95,782,4096
3,463,261,131,855,4096
4,422,278,167,867,4096
5,415,317,182,914,4096
6,413,323,210,946,4096
7,412,344,217,973,4096
8,412,350,233,995,4096
9,414,367,244,1025,4096
10,403,398,267,1068,4096
11,403,410,284,1097,4096
1,500,200,50,750,4097
2,456,249,97,802,4097
3,426,273,127,826,4097
4,398,310,170,878,4097
5,371,352,194,917,4097
6,385,362,222,969,4097
7,386,363,230,979,4097
8,393,371,244,1008,4097
9,388,374,249,1011,4097
10,415,375,288,1078,4097
11,406,380,298,1084,4097
1,500,200,50,750,4098
2,468,236,94,798,4098
3,451,266,119,836,4098
4,458,282,136,876,4098
5,415,301,178,894,4098
6,429,341,190,960,4098
7,402,355,220,977,4098
8,392,379,225,996,4098
9,392,384,252,1028,4098
10,410,378,260,1048,4098
11,395,422,268,1085,4098
1,500,200,50,750,4099
2,477,211,117,805,4099
3,454,235,151,840,4099
4,440,266,171,877,4099
5,436,304,184,924,4099
6,422,336,209,967,4099
7,402,345,229,976,4099
8,386,364,256,1006,4099
9,377,390,256,1023,4099
10,394,386,277,1057,4099
11,400,374,315,1089,4099
1,500,200,50,750,4100
2,474,231,100,805,4100
3,444,245,141,830,4100
4,418,275,174,867,4100
5,412,300,200,912,4100
6,435,302,215,952,4100
7,422,351,216,989,4100
8,408,378,224,1010,4100
9,394,393,239,1026,4100
10,409,392,250,1051,4100
11,403,401,260,1064,4100
1,500,200,50,750,4101
2,478,238,86,802,4101
3,418,272,130,820,4101
4,409,301,168,878,4101
5,390,318,189,897,4101
6,407,325,218,950,4101
7,426,344,234,1004,4101
8,396,351,251,998,4101
9,408,360,268,1036,4101
10,389,387,273,1049,4101
11,404,402,271,1077,4101
1,500,200,50,750,4102
2,458,245,89,792,4102
3,429,271,131,831,4102
4,423,280,167,870,4102
5,397,319,201,917,4102
6,396,342,214,952,4102
7,396,363,241,1000,4102
8,388,377,250,1015,4102
9,385,433,229,1047,4102
10,375,411,265,1051,4102
11,402,417,285,1104,4102
1,500,200,50,750,4103
2,461,231,98,790,4103
3,450,241,139,830,4103
4,418,295,154,867,4103
5,409,297,199,905,4103
6,429,312,228,969,4103
7,393,362,226,981,4103
8,420,348,249,1017,4103
9,395,370,258,1023,4103
10,375,370,277,1022,4103
11,404,378,282,1064,4103
1,500,200,50,750,4104
2,460,219,103,782,4104
3,456,250,130,836,4104
4,429,267,161,857,4104
5,396,316,198,910,4104
6,399,324,227,950,4104
7,405,353,233,991,4104
8,382,352,265,999,4104
9,372,364,300,1036,4104
10,392,384,301,1077,4104
11,390,389,312,1091,4104
1,500,200,50,750,4105
2,487,242,75,804,4105
3,439,249,129,817,4105
4,442,250,180,872,4105
5,445,292,184,921,4105
6,423,325,219,967,4105
7,399,344,225,968,4105
8,404,360,248,1012,4105
9,375,385,257,1017,4105
10,363,428,265,1056,4105
11,372,448,282,1102,4105
1,500,200,50,750,4106
2,452,227,97,776,4106
3,438,257,136,831,4106
4,415,292,171,878,4106
5,417,311,187,915,4106
6,407,342,210,959,4106
7,412,356,230,998,4106
8,397,361,251,1009,4106
9,383,389,247,1019,4106
10,385,395,276,1056,4106
11,384,415,299,1098,4106
1,500,200,50,750,4107
2,451,246,92,789,4107
3,438,260,134,832,4107
4,413,291,157,861,4107
5,425,328,175,928,4107
6,400,357,206,963,4107
7,373,364,225,962,4107
8,382,382,248,1012,4107
9,364,394,261,1019,4107
10,368,401,286,1055,4107
11,396,411,283,1090,4107
1,500,200,50,750,4108
2,451,237,90,778,4108
3,426,270,125,821,4108
4,430,281,150,861,4108
5,423,306,184,913,4108
6,389,318,229,936,4108
7,375,354,238,967,4108
8,380,380,246,1006,4108
9,378,384,268,1030,4108
10,393,405,261,1059,4108
11,398,427,254,1079,4108
1,500,200,50,750,4109
2,461,227,94,782,4109
3,435,264,136,835,4109
4,420,274,170,864,4109
5,410,309,203,922,4109
6,405,333,215,953,4109
7,391,357,240,988,4109
8,395,371,240,1006,4109
9,383,391,256,1030,4109
10,393,408,264,1065,4109
11,387,414,275,1076,4109
1,500,200,50,750,4110
2,449,237,108,794,4110
3,401,269,150,820,4110
4,403,300,174,877,4110
5,405,325,183,913,4110
6,392,368,200,960,4110
7,369,372,233,974,4110
8,391,387,244,1022,4110
9,388,373,273,1034,4110
10,387,402,267,1056,4110
11,399,412,268,1079,4110
1,500,200,50,750,4111
2,445,228,100,773,4111
3,432,258,134,824,4111
4,428,284,163,875,4111
5,413,307,191,911,4111
6,420,337,211,968,4111
7,390,354,245,989,4111
8,389,362,258,1009,4111
9,374,384,276,1034,4111
10,385,381,277,1043,4111
11,409,390,281,1080,4111
1,500,200,50,750,4112
2,454,238,97,789,4112
3,431,278,113,822,4112
4,402,304,149,855,4112
5,401,347,183,931,4112
6,385,384,182,951,4112
7,406,383,200,989,4112
8,391,381,236,1008,4112
9,392,367,262,1021,4112
10,396,385,263,1044,4112
11,384,399,277,1060,4112
1,500,200,50,750,4113
2,480,229,83,792,4113
3,436,252,141,829,4113
4,415,290,162,867,4113
5,395,325,193,913,4113
6,398,338,224,960,4113
7,392,341,248,981,4113
8,396,364,247,1007,4113
9,409,355,278,1042,4113
10,388,379,287,1054,4113
11,391,391,299,1081,4113
1,500,200,50,750,4114
2,476,231,89,796,4114
3,436,259,133,828,4114
4,434,292,155,881,4114
5,405,311,193,909,4114
6,403,332,199,934,4114
7,417,353,216,986,4114
8,401,385,216,1002,4114
9,385,385,255,1025,4114
10,391,419,250,1060,4114
11,386,451,257,1094,4114
1,500,200,50,750,4115
2,453,226,105,784,4115
3,436,252,143,831,4115
4,422,290,164,876,4115
5,414,330,176,920,4115
6,428,348,194,970,4115
7,405,347,211,963,4115
8,397,347,247,991,4115
9,385,383,253,1021,4115
10,376,418,258,1052,4115
11,386,437,257,1080,4115
1,500,200,50,750,4116
2,467,227,107,801,4116
3,449,238,140,827,4116
4,428,298,158,884,4116
5,388,313,199,900,4116
6,404,346,219,969,4116
7,389,362,231,982,4116
8,391,379,240,1010,4116
9,409,384,241,1034,4116
10,413,396,256,1065,4116
11,421,388,273,1082,4116
1,500,200,50,750,4117
2,461,217,98,776,4117
3,441,255,137,833,4117
4,404,280,177,861,4117
5,403,296,213,912,4117
6,404,322,222,948,4117
7,411,351,227,989,4117
8,396,367,252,1015,4117
9,378,410,248,1036,4117
10,380,428,253,1061,4117
11,395,423,273,1091,4117
1,500,200,50,750,4118
2,470,209,104,783,4118
3,446,243,127,816,4118
4,435,274,158,867,4118
5,445,293,173,911,4118
6,445,325,192,962,4118
7,418,352,209,979,4118
8,404,368,227,999,4118
9,406,370,254,1030,4118
10,415,382,242,1039,4118
11,411,413,266,1090,4118
1,500,200,50,750,4119
2,447,244,106,797,4119
3,422,265,150,837,4119
4,397,287,180,864,4119
5,413,318,188,919,4119
6,383,347,222,952,4119
7,394,365,234,993,4119
8,377,406,224,1007,4119
9,382,404,249,1035,4119
10,384,406,270,1060,4119
11,374,417,295,1086,4119
1,500,200,50,750,4120
2,457,224,100,781,4120
3,449,255,135,839,4120
4,423,278,174,875,4120
5,414,292,192,898,4120
6,412,337,206,955,4120
7,387,347,229,963,4120
8,404,382,236,1022,4120
9,381,393,256,1030,4120
10,382,421,273,1076,4120
11,390,401,278,1069,4120
1,500,200,50,750,4121
2,458,255,80,793,4121
3,427,287,111,825,4121
4,411,293,168,872,4121
5,401,324,207,932,4121
6,378,327,233,938,4121
7,383,346,235,964,4121
8,382,369,254,1005,4121
9,375,368,287,1030,4121
10,400,391,272,1063,4121
11,411,392,282,1085,4121
1,500,200,50,750,4122
2,470,223,102,795,4122
3,456,256,129,841,4122
4,445,266,166,877,4122
5,432,296,177,905,4122
6,446,328,192,966,4122
7,416,351,203,970,4122
8,412,366,230,1008,4122
9,403,376,250,1029,4122
10,422,366,270,1058,4122
11,409,390,285,1084,4122
1,500,200,50,750,4123
2,453,246,93,792,4123
3,414,253,128,795,4123
4,400,323,152,875,4123
5,398,324,175,897,4123
6,427,348,207,982,4123
7,397,344,233,974,4123
8,388,357,257,1002,4123
9,412,351,282,1045,4123
10,383,373,287,1043,4123
11,409,409,277,1095,4123
1,500,200,50,750,4124
2,450,237,98,785,4124
3,419,265,151,835,4124
4,406,290,169,865,4124
5,412,323,187,922,4124
6,402,345,205,952,4124
7,408,350,233,991,4124
8,408,355,241,1004,4124
9,384,383,261,1028,4124
10,399,392,271,1062,4124
11,381,434,253,1068,4124
1,500,200,50,750,4125
2,447,240,104,791,4125
3,400,282,153,835,4125
4,387,312,176,875,4125
5,375,339,198,912,4125
6,400,324,230,954,4125
7,395,359,232,986,4125
8,383,380,242,1005,4125
9,405,375,264,1044,4125
10,404,392,282,1078,4125
11,379,398,289,1066,4125
1,500,200,50,750,4126
2,458,222,112,792,4126
3,437,252,133,822,4126
4,425,311,138,874,4126
5,411,338,158,907,4126
6,402,359,186,947,4126
7,408,376,193,977,4126
8,399,372,234,1005,4126
9,412,381,241,1034,4126
10,411,406,237,1054,4126
11,412,411,269,1092,4126
1,500,200,50,750,4127
2,466,231,106,803,4127
3,436,252,141,829,4127
4,423,265,170,858,4127
5,412,305,199,916,4127
6,404,348,222,974,4127
7,401,335,255,991,4127
8,388,360,258,1006,4127
9,383,369,268,1020,4127
10,434,388,240,1062,4127
11,410,383,267,1060,4127
1,500,200,50,750,4128
2,458,240,87,785,4128
3,424,259,135,818,4128
4,425,282,155,862,4128
5,423,303,186,912,4128
6,427,321,227,975,4128
7,398,340,250,988,4128
8,396,370,251,1017,4128
9,371,379,275,1025,4128
10,406,384,286,1076,4128
11,401,409,270,1080,4128
1,500,200,50,750,4129
2,450,242,95,787,4129
3,404,292,132,828,4129
4,387,319,166,872,4129
5,391,312,200,903,4129
6,407,354,224,985,4129
7,397,344,244,985,4129
8,394,358,241,993,4129
9,375,370,263,1008,4129
10,388,396,273,1057,4129
11,406,432,258,1096,4129
1,500,200,50,750,4130
2,479,218,97,794,4130
3,426,268,128,822,4130
4,415,306,154,875,4130
5,396,352,165,913,4130
6,412,339,214,965,4130
7,411,345,237,993,4130
8,404,344,238,986,4130
9,411,362,257,1030,4130
10,435,351,282,1068,4130
11,431,362,288,1081,4130
1,500,200,50,750,4131
2,460,225,118,803,4131
3,424,247,161,832,4131
4,413,269,181,863,4131
5,412,315,195,922,4131
6,390,319,234,943,4131
7,399,334,256,989,4131
8,392,364,242,998,4131
9,394,380,256,1030,4131
10,386,363,287,1036,4131
11,388,409,279,1076,4131
1,500,200,50,750,4132
2,463,217,109,789,4132
3,427,260,135,822,4132
4,418,279,170,867,4132
5,422,293,194,909,4132
6,432,351,192,975,4132
7,422,351,207,980,4132
8,403,369,224,996,4132
9,425,368,241,1034,4132
10,426,377,254,1057,4132
11,415,385,287,1087,4132
1,500,200,50,750,4133
2,454,246,92,792,4133
3,412,262,138,812,4133
4,400,293,176,869,4133
5,395,316,179,890,4133
6,399,333,227,959,4133
7,397,365,220,982,4133
8,396,362,243,1001,4133
9,412,388,240,1040,4133
10,394,398,258,1050,4133
11,427,403,286,1116,4133
1,500,200,50,750,4134
2,464,235,92,791,4134
3,441,267,120,828,4134
4,424,277,161,862,4134
5,444,290,184,918,4134
6,441,336,199,976,4134
7,411,331,232,974,4134
8,395,355,245,995,4134
9,391,385,251,1027,4134
10,377,409,269,1055,4134
11,368,421,290,1079,4134
1,500,200,50,750,4135
2,451,228,101,780,4135
3,412,282,126,820,4135
4,419,297,155,871,4135
5,410,307,196,913,4135
6,410,344,192,946,4135
7,395,349,229,973,4135
8,406,349,223,978,4135
9,402,381,243,1026,4135
10,407,376,271,1054,4135
11,402,397,292,1091,4135
1,500,200,50,750,4136
2,471,222,105,798,4136
3,435,262,135,832,4136
4,434,286,154,874,4136
5,419,307,177,903,4136
6,451,329,178,958,4136
7,444,332,202,978,4136
8,443,358,217,1018,4136
9,427,358,237,1022,4136
10,434,360,249,1043,4136
11,463,375,253,1091,4136
1,500,200,50,750,4137
2,450,222,105,777,4137
3,432,260,130,822,4137
4,421,294,155,870,4137
5,406,310,197,913,4137
6,413,336,206,955,4137
7,402,358,222,982,4137
8,417,352,245,1014,4137
9,413,367,262,1042,4137
10,402,388,277,1067,4137
11,410,402,277,1089,4137
1,500,200,50,750,4138
2,445,248,93,786,4138
3,437,270,134,841,4138
4,427,285,166,878,4138
5,415,297,196,908,4138
6,446,303,216,965,4138
7,419,351,225,995,4138
8,410,355,243,1008,4138
9,395,387,251,1033,4138
10,389,388,275,1052,4138
11,393,392,302,1087,4138
1,500,200,50,750,4139
2,458,230,100,788,4139
3,431,252,141,824,4139
4,408,278,178,864,4139
5,418,303,194,915,4139
6,415,341,215,971,4139
7,383,358,232,973,4139
8,395,362,244,1001,4139
9,407,377,240,1024,4139
10,396,386,266,1048,4139
11,371,395,300,1066,4139
1,500,200,50,750,4140
2,472,226,103,801,4140
3,433,249,152,834,4140
4,415,284,166,865,4140
5,410,298,179,887,4140
6,425,321,206,952,4140
7,404,350,226,980,4140
8,383,378,239,1000,4140
9,364,384,277,1025,4140
10,357,421,283,1061,4140
11,365,445,288,1098,4140
1,500,200,50,750,4141
2,452,240,93,785,4141
3,422,276,126,824,4141
4,418,290,167,875,4141
5,404,318,182,904,4141
6,426,327,206,959,4141
7,424,357,202,983,4141
8,423,334,247,1004,4141
9,414,370,258,1042,4141
10,409,366,279,1054,4141
11,406,414,273,1093,4141
1,500,200,50,750,4142
2,475,241,86,802,4142
3,414,256,139,809,4142
4,412,296,153,861,4142
5,416,322,179,917,4142
6,422,335,206,963,4142
7,401,355,223,979,4142
8,394,365,239,998,4142
9,425,392,229,1046,4142
10,421,385,254,1060,4142
11,393,404,278,1075,4142
1,500,200,50,750,4143
2,456,240,89,785,4143
3,432,275,127,834,4143
4,389,296,160,845,4143
5,383,312,196,891,4143
6,402,366,213,981,4143
7,383,373,222,978,4143
8,381,377,244,1002,4143
9,369,401,249,1019,4143
10,371,421,257,1049,4143
11,381,400,287,1068,4143
1,500,200,50,750,4144
2,459,236,96,791,4144
3,428,271,132,831,4144
4,397,288,183,868,4144
5,390,311,209,910,4144
6,388,324,228,940,4144
7,375,363,239,977,4144
8,362,390,237,989,4144
9,358,380,263,1001,4144
10,378,391,288,1057,4144
11,386,407,283,1076,4144
1,500,200,50,750,4145
2,452,242,106,800,4145
3,423,258,141,822,4145
4,416,287,165,868,4145
5,423,324,175,922,4145
6,426,341,197,964,4145
7,437,340,202,979,4145
8,400,345,252,997,4145
9,397,366,256,1019,4145
10,401,370,273,1044,4145
11,397,396,294,1087,4145
1,500,200,50,750,4146
2,451,228,106,785,4146
3,412,276,143,831,4146
4,392,316,163,871,4146
5,371,341,197,909,4146
6,374,357,224,955,4146
7,386,368,243,997,4146
8,370,400,232,1002,4146
9,377,388,261,1026,4146
10,360,421,262,1043,4146
11,384,434,260,1078,4146
1,500,200,50,750,4147
2,466,231,81,778,4147
3,434,272,125,831,4147
4,416,307,147,870,4147
5,401,352,170,923,4147
6,406,344,204,954,4147
7,400,372,210,982,4147
8,392,374,236,1002,4147
9,387,406,243,1036,4147
10,397,409,253,1059,4147
11,425,394,271,1090,4147
1,500,200,50,750,4148
2,451,239,91,781,4148
3,416,294,120,830,4148
4,402,323,149,874,4148
5,403,336,180,919,4148
6,399,373,196,968,4148
7,397,352,234,983,4148
8,405,373,234,1012,4148
9,416,368,252,1036,4148
10,415,380,252,1047,4148
11,442,383,270,1095,4148
1,500,200,50,750,4149
2,455,242,90,787,4149
3,438,278,115,831,4149
4,424,299,139,862,4149
5,403,325,163,891,4149
6,421,358,182,961,4149
7,401,353,229,983,4149
8,387,376,248,1011,4149
9,391,381,264,1036,4149
10,376,416,276,1068,4149
11,396,430,258,1084,4149
1,500,200,50,750,4150
2,445,230,99,774,4150
3,425,262,121,808,4150
4,400,308,163,871,4150
5,389,346,175,910,4150
6,400,348,205,953,4150
7,416,352,202,970,4150
8,410,383,228,1021,4150
9,388,409,233,1030,4150
10,392,422,248,1062,4150
11,396,408,276,1080,4150
1,500,200,50,750,4151
2,477,220,89,786,4151
3,456,244,118,818,4151
4,459,273,149,881,4151
5,431,310,179,920,4151
6,414,339,200,953,4151
7,401,360,216,977,4151
8,409,376,222,1007,4151
9,394,392,237,1023,4151
10,401,392,279,1072,4151
11,376,414,288,1078,4151
1,500,200,50,750,4152
2,442,234,107,783,4152
3,430,268,141,839,4152
4,429,275,167,871,4152
5,405,307,188,900,4152
6,397,366,188,951,4152
7,393,374,202,969,4152
8,388,370,247,1005,4152
9,398,377,251,1026,4152
10,422,376,250,1048,4152
11,434,375,264,1073,4152
1,500,200,50,750,4153
2,472,240,79,791,4153
3,458,263,103,824,4153
4,441,282,146,869,4153
5,426,299,171,896,4153
6,441,339,195,975,4153
7,398,363,217,978,4153
8,386,370,241,997,4153
9,389,367,268,1024,4153
10,411,378,271,1060,4153
11,412,386,294,1092,4153
1,500,200,50,750,4154
2,457,231,84,772,4154
3,438,267,133,838,4154
4,416,281,177,874,4154
5,425,282,212,919,4154
6,431,317,208,956,4154
7,419,340,222,981,4154
8,427,336,246,1009,4154
9,415,370,233,1018,4154
10,427,400,240,1067,4154
11,423,417,257,1097,4154
1,500,200,50,750,4155
2,474,216,96,786,4155
3,433,265,120,818,4155
4,440,280,158,878,4155
5,438,305,185,928,4155
6,411,325,220,956,4155
7,387,353,240,980,4155
8,385,367,260,1012,4155
9,387,384,267,1038,4155
10,371,382,273,1026,4155
11,377,418,275,1070,4155
1,500,200,50,750,4156
2,484,218,86,788,4156
3,450,253,122,825,4156
4,433,282,142,857,4156
5,413,302,179,894,4156
6,444,307,218,969,4156
7,413,333,231,977,4156
8,393,344,257,994,4156
9,402,372,254,1028,4156
10,387,393,282,1062,4156
11,396,393,276,1065,4156
1,500,200,50,750,4157
2,460,225,100,785,4157
3,442,250,144,836,4157
4,419,293,168,880,4157
5,416,319,191,926,4157
6,416,333,221,970,4157
7,393,359,225,977,4157
8,405,359,250,1014,4157
9,389,406,240,1035,4157
10,399,418,240,1057,4157
11,406,423,258,1087,4157
1,500,200,50,750,4158
2,466,233,93,792,4158
3,438,256,136,830,4158
4,424,270,170,864,4158
5,410,307,196,913,4158
6,406,330,201,937,4158
7,419,356,216,991,4158
8,420,371,216,1007,4158
9,407,385,243,1035,4158
10,403,399,252,1054,4158
11,410,404,264,1078,4158
1,500,200,50,750,4159
2,461,233,99,793,4159
3,429,241,142,812,4159
4,435,278,161,874,4159
5,434,277,196,907,4159
6,438,314,204,956,4159
7,422,324,232,978,4159
8,397,382,232,1011,4159
9,373,390,257,1020,4159
10,394,412,247,1053,4159
11,390,415,266,1071,4159
1,500,200,50,750,4160
2,458,233,107,798,4160
3,430,278,143,851,4160
4,413,289,163,865,4160
5,376,320,207,903,4160
6,379,341,235,955,4160
7,393,349,234,976,4160
8,387,377,232,996,4160
9,407,393,250,1050,4160
10,377,410,263,1050,4160
11,376,441,263,1080,4160
1,500,200,50,750,4161
2,469,231,100,800,4161
3,442,265,124,831,4161
4,417,288,151,856,4161
5,437,311,185,933,4161
6,426,322,210,958,4161
7,415,340,230,985,4161
8,398,361,244,1003,4161
9,401,394,249,1044,4161
10,375,415,277,1067,4161
11,382,418,287,1087,4161
1,500,200,50,750,4162
2,456,224,107,787,4162
3,418,248,152,818,4162
4,419,279,168,866,4162
5,410,317,191,918,4162
6,398,338,216,952,4162
7,395,373,225,993,4162
8,383,375,255,1013,4162
9,360,393,259,1012,4162
10,382,395,283,1060,4162
11,390,419,272,1081,4162
1,500,200,50,750,4163
2,468,226,102,796,4163
3,438,262,125,825,4163
4,416,293,161,870,4163
5,406,326,179,911,4163
6,418,328,205,951,4163
7,419,342,211,972,4163
8,400,364,235,999,4163
9,407,376,251,1034,4163
10,395,396,250,1041,4163
11,429,403,248,1080,4163
1,500,200,50,750,4164
2,465,244,95,804,4164
3,430,264,132,826,4164
4,388,280,176,844,4164
5,411,296,190,897,4164
6,403,339,217,959,4164
7,399,361,221,981,4164
8,397,380,233,1010,4164
9,381,394,259,1034,4164
10,390,407,259,1056,4164
11,427,411,262,1100,4164
1,500,200,50,750,4165
2,442,236,97,775,4165
3,411,293,128,832,4165
4,401,313,153,867,4165
5,389,333,193,915,4165
6,412,338,210,960,4165
7,391,371,223,985,4165
8,380,385,237,1002,4165
9,365,379,266,1010,4165
10,405,377,271,1053,4165
11,436,398,266,1100,4165
1,500,200,50,750,4166
2,462,231,96,789,4166
3,447,263,121,831,4166
4,421,281,158,860,4166
5,418,324,183,925,4166
6,427,314,218,959,4166
7,410,336,235,981,4166
8,430,328,254,1012,4166
9,421,362,245,1028,4166
10,422,379,268,1069,4166
11,432,403,258,1093,4166
1,500,200,50,750,4167
2,449,242,103,794,4167
3,422,262,139,823,4167
4,410,269,173,852,4167
5,420,316,195,931,4167
6,413,341,200,954,4167
7,387,359,232,978,4167
8,371,378,257,1006,4167
9,367,385,272,1024,4167
10,377,402,269,1048,4167
11,400,419,278,1097,4167
1,500,200,50,750,4168
2,462,251,78,791,4168
3,425,288,126,839,4168
4,408,304,147,859,4168
5,396,336,172,904,4168
6,408,353,199,960,4168
7,405,343,247,995,4168
8,398,354,253,1005,4168
9,400,375,262,1037,4168
10,382,397,266,1045,4168
11,404,424,264,1092,4168
1,500,200,50,750,4169
2,471,211,97,779,4169
3,432,265,113,810,4169
4,420,280,168,868,4169
5,421,281,204,906,4169
6,408,311,220,939,4169
7,413,334,230,977,4169
8,407,334,256,997,4169
9,412,362,259,1033,4169
10,399,398,244,1041,4169
11,427,419,248,1094,4169
1,500,200,50,750,4170
2,474,215,106,795,4170
3,436,262,130,828,4170
4,417,292,176,885,4170
5,411,312,190,913,4170
6,404,338,212,954,4170
7,393,383,223,999,4170
8,373,366,270,1009,4170
9,377,374,280,1031,4170
10,371,412,269,1052,4170
11,396,414,277,1087,4170
1,500,200,50,750,4171
2,461,234,95,790,4171
3,417,272,128,817,4171
4,423,286,164,873,4171
5,403,309,183,895,4171
6,389,352,206,947,4171
7,400,360,220,980,4171
8,406,385,224,1015,4171
9,382,387,250,1019,4171
10,406,397,253,1056,4171
11,402,421,277,1100,4171
1,500,200,50,750,4172
2,450,252,85,787,4172
3,438,263,132,833,4172
4,408,291,166,865,4172
5,405,309,194,908,4172
6,385,338,215,938,4172
7,390,343,256,989,4172
8,367,366,270,1003,4172
9,393,377,267,1037,4172
10,380,393,267,1040,4172
11,385,405,278,1068,4172
1,500,200,50,750,4173
2,458,232,102,792,4173
3,412,288,125,825,4173
4,413,296,164,873,4173
5,391,330,186,907,4173
6,408,348,214,970,4173
7,418,329,227,974,4173
8,404,359,249,1012,4173
9,412,372,267,1051,4173
10,392,389,282,1063,4173
11,385,409,274,1068,4173
1,500,200,50,750,4174
2,451,225,105,781,4174
3,430,264,133,827,4174
4,416,284,171,871,4174
5,402,323,204,929,4174
6,405,345,213,963,4174
7,383,377,222,982,4174
8,358,378,267,1003,4174
9,365,402,248,1015,4174
10,379,394,261,1034,4174
11,415,394,262,1071,4174
1,500,200,50,750,4175
2,466,219,107,792,4175
3,440,263,134,837,4175
4,411,286,160,857,4175
5,421,293,189,903,4175
6,438,330,194,962,4175
7,415,344,216,975,4175
8,399,385,225,1009,4175
9,402,391,235,1028,4175
10,402,395,249,1046,4175
11,420,410,260,1090,4175
1,500,200,50,750,4176
2,447,255,88,790,4176
3,419,269,139,827,4176
4,404,282,186,872,4176
5,402,331,190,923,4176
6,390,348,206,944,4176
7,387,367,220,974,4176
8,389,370,257,1016,4176
9,380,380,263,1023,4176
10,372,418,264,1054,4176
11,395,422,271,1088,4176
1,500,200,50,750,4177
2,464,228,88,780,4177
3,446,249,143,838,4177
4,435,266,164,865,4177
5,430,296,189,915,4177
6,432,312,216,960,4177
7,427,341,223,991,4177
8,388,363,249,1000,4177
9,380,386,263,1029,4177
10,392,393,283,1068,4177
11,391,403,280,1074,4177
1,500,200,50,750,4178
2,475,210,100,785,4178
3,460,236,135,831,4178
4,433,284,152,869,4178
5,399,291,193,883,4178
6,417,330,214,961,4178
7,415,334,232,981,4178
8,405,353,239,997,4178
9,408,363,262,1033,4178
10,403,369,277,1049,4178
11,437,377,292,1106,4178
1,500,200,50,750,4179
2,454,228,105,787,4179
3,459,250,134,843,4179
4,439,256,158,853,4179
5,418,287,196,901,4179
6,433,305,212,950,4179
7,416,337,236,989,4179
8,399,366,243,1008,4179
9,394,383,244,1021,4179
10,389,400,260,1049,4179
11,405,417,264,1086,4179
1,500,200,50,750,4180
2,452,234,101,787,4180
3,425,252,142,819,4180
4,429,274,167,870,4180
5,430,309,185,924,4180
6,419,345,196,960,4180
7,409,343,232,984,4180
8,419,350,238,1007,4180
9,402,369,240,1011,4180
10,420,388,256,1064,4180
11,424,410,270,1104,4180
1,500,200,50,750,4181
2,459,241,82,782,4181
3,434,284,105,823,4181
4,421,303,144,868,4181
5,419,308,165,892,4181
6,431,340,202,973,4181
7,413,348,230,991,4181
8,411,339,258,1008,4181
9,409,365,246,1020,4181
10,409,390,256,1055,4181
11,440,392,260,1092,4181
1,500,200,50,750,4182
2,461,233,103,797,4182
3,438,261,127,826,4182
4,421,311,144,876,4182
5,406,312,181,899,4182
6,407,330,222,959,4182
7,395,368,241,1004,4182
8,368,369,272,1009,4182
9,371,376,273,1020,4182
10,359,408,288,1055,4182
11,363,410,301,1074,4182
1,500,200,50,750,4183
2,455,229,115,799,4183
3,412,265,152,829,4183
4,401,304,169,874,4183
5,397,335,192,924,4183
6,404,350,210,964,4183
7,391,370,233,994,4183
8,371,396,250,1017,4183
9,390,386,260,1036,4183
10,395,400,258,1053,4183
11,381,417,267,1065,4183
1,500,200,50,750,4184
2,463,238,96,797,4184
3,405,277,131,813,4184
4,373,309,180,862,4184
5,390,321,201,912,4184
6,395,339,203,937,4184
7,405,365,207,977,4184
8,412,370,234,1016,4184
9,392,372,260,1024,4184
10,379,408,274,1061,4184
11,364,422,279,1065,4184
1,500,200,50,750,4185
2,463,216,104,783,4185
3,430,243,148,821,4185
4,385,292,178,855,4185
5,391,300,204,895,4185
6,393,338,229,960,4185
7,374,342,250,966,4185
8,398,369,249,1016,4185
9,394,362,280,1036,4185
10,405,385,284,1074,4185
11,393,394,291,1078,4185
1,500,200,50,750,4186
2,458,219,102,779,4186
3,443,257,142,842,4186
4,419,289,173,881,4186
5,417,306,198,921,4186
6,396,358,203,957,4186
7,378,367,242,987,4186
8,367,390,249,1006,4186
9,358,384,291,1033,4186
10,376,386,296,1058,4186
11,380,395,296,1071,4186
1,500,200,50,750,4187
2,445,248,91,784,4187
3,429,268,126,823,4187
4,428,283,161,872,4187
5,431,310,171,912,4187
6,413,328,205,946,4187
7,370,373,234,977,4187
8,373,372,264,1009,4187
9,367,379,285,1031,4187
10,359,395,290,1044,4187
11,382,416,296,1094,4187
1,500,200,50,750,4188
2,450,246,100,796,4188
3,416,266,134,816,4188
4,425,281,165,871,4188
5,403,318,203,924,4188
6,392,347,221,960,4188
7,386,350,229,965,4188
8,401,380,232,1013,4188
9,393,372,273,1038,4188
10,389,397,261,1047,4188
11,412,410,260,1082,4188
1,500,200,50,750,4189
2,453,232,102,787,4189
3,442,238,151,831,4189
4,396,271,187,854,4189
5,389,321,214,924,4189
6,388,330,228,946,4189
7,376,345,241,962,4189
8,395,380,236,1011,4189
9,406,371,254,1031,4189
10,411,379,268,1058,4189
11,399,411,276,1086,4189
1,500,200,50,750,4190
2,434,249,104,787,4190
3,423,268,141,832,4190
4,409,293,171,873,4190
5,383,317,202,902,4190
6,423,334,215,972,4190
7,413,339,223,975,4190
8,415,348,253,1016,4190
9,391,370,259,1020,4190
10,385,403,273,1061,4190
11,384,397,284,1065,4190
1,500,200,50,750,4191
2,484,233,88,805,4191
3,435,273,124,832,4191
4,417,269,174,860,4191
5,409,294,193,896,4191
6,424,309,227,960,4191
7,419,361,209,989,4191
8,401,387,227,1015,4191
9,411,370,257,1038,4191
10,420,402,245,1067,4191
11,417,413,257,1087,4191
1,500,200,50,750,4192
2,464,229,87,780,4192
3,429,248,135,812,4192
4,439,283,151,873,4192
5,429,295,187,911,4192
6,414,329,204,947,4192
7,408,338,241,987,4192
8,400,360,244,1004,4192
9,381,377,250,1008,4192
10,408,387,255,1050,4192
11,387,407,275,1069,4192
1,500,200,50,750,4193
2,465,230,104,799,4193
3,445,264,126,835,4193
4,421,297,155,873,4193
5,411,331,173,915,4193
6,403,353,210,966,4193
7,399,387,203,989,4193
8,404,369,226,999,4193
9,420,379,247,1046,4193
10,410,379,266,1055,4193
11,403,411,257,1071,4193
1,500,200,50,750,4194
2,468,238,92,798,4194
3,426,269,126,821,4194
4,423,293,158,874,4194
5,392,345,173,910,4194
6,406,346,208,960,4194
7,406,366,217,989,4194
8,409,384,223,1016,4194
9,381,397,248,1026,4194
10,390,398,262,1050,4194
11,402,416,276,1094,4194
1,500,200,50,750,4195
2,469,204,104,777,4195
3,437,254,136,827,4195
4,429,286,155,870,4195
5,414,308,186,908,4195
6,419,334,189,942,4195
7,418,362,207,987,4195
8,399,368,245,1012,4195
9,398,388,252,1038,4195
10,423,405,242,1070,4195
11,433,399,259,1091,4195
1,500,200,50,750,4196
2,446,243,97,786,4196
3,435,260,129,824,4196
4,417,259,185,861,4196
5,416,305,195,916,4196
6,395,351,206,952,4196
7,386,356,226,968,4196
8,396,358,239,993,4196
9,411,373,256,1040,4196
10,405,367,275,1047,4196
11,399,382,294,1075,4196
1,500,200,50,750,4197
2,451,227,109,787,4197
3,400,265,151,816,4197
4,397,292,178,867,4197
5,410,312,196,918,4197
6,426,321,222,969,4197
7,424,332,230,986,4197
8,413,342,238,993,4197
9,411,378,261,1050,4197
10,411,388,265,1064,4197
11,427,400,263,1090,4197
1,500,200,50,750,4198
2,464,214,99,777,4198
3,456,261,135,852,4198
4,406,295,168,869,4198
5,414,315,180,909,4198
6,407,346,209,962,4198
7,412,344,232,988,4198
8,430,360,225,1015,4198
9,381,381,261,1023,4198
10,381,375,293,1049,4198
11,374,388,316,1078,4198
1,500,200,50,750,4199
2,477,230,92,799,4199
3,422,255,138,815,4199
4,401,289,156,846,4199
5,411,321,200,932,4199
6,409,320,227,956,4199
7,401,342,222,965,4199
8,413,359,230,1002,4199
9,406,376,257,1039,4199
10,381,383,273,1037,4199
11,408,408,278,1094,4199
1,500,200,50,750,4200
2,454,230,103,787,4200
3,448,247,136,831,4200
4,437,273,160,870,4200
5,428,290,184,902,4200
6,424,314,206,944,4200
7,397,332,233,962,4200
8,424,357,234,1015,4200
9,411,391,227,1029,4200
10,421,400,246,1067,4200
11,448,405,257,1110,4200
1,500,200,50,750,4201
2,452,244,84,780,4201
3,418,290,111,819,4201
4,390,315,155,860,4201
5,397,319,199,915,4201
6,415,335,219,969,4201
7,387,368,226,981,4201
8,391,357,243,991,4201
9,414,365,252,1031,4201
10,406,388,258,1052,4201
11,422,410,264,1096,4201
1,500,200,50,750,4202
2,449,240,107,796,4202
3,409,277,127,813,4202
4,414,297,156,867,4202
5,396,333,198,927,4202
6,380,348,225,953,4202
7,406,359,239,1004,4202
8,401,352,249,1002,4202
9,414,365,254,1033,4202
10,421,371,274,1066,4202
11,398,406,277,1081,4202
1,500,200,50,750,4203
2,462,217,115,794,4203
3,417,268,144,829,4203
4,394,303,178,875,4203
5,394,311,202,907,4203
6,395,323,227,945,4203
7,403,332,245,980,4203
8,391,336,265,992,4203
9,401,372,259,1032,4203
10,388,379,269,1036,4203
11,413,371,289,1073,4203
1,500,200,50,750,4204
2,468,227,101,796,4204
3,444,239,142,825,4204
4,444,273,164,881,4204
5,416,300,209,925,4204
6,413,334,215,962,4204
7,388,362,235,985,4204
8,385,359,248,992,4204
9,379,392,247,1018,4204
10,379,427,263,1069,4204
11,393,430,264,1087,4204
1,500,200,50,750,4205
2,453,227,100,780,4205
3,435,243,144,822,4205
4,421,298,158,877,4205
5,412,276,206,894,4205
6,418,325,230,973,4205
7,382,349,255,986,4205
8,372,383,262,1017,4205
9,361,407,251,1019,4205
10,384,401,277,1062,4205
11,369,406,305,1080,4205
1,500,200,50,750,4206
2,459,201,116,776,4206
3,440,250,142,832,4206
4,413,281,182,876,4206
5,396,308,198,902,4206
6,400,332,213,945,4206
7,413,332,235,980,4206
8,400,359,249,1008,4206
9,409,404,222,1035,4206
10,404,397,239,1040,4206
11,409,426,256,1091,4206
1,500,200,50,750,4207
2,463,233,103,799,4207
3,417,270,144,831,4207
4,385,311,169,865,4207
5,373,319,193,885,4207
6,401,349,208,958,4207
7,394,352,238,984,4207
8,394,394,243,1031,4207
9,392,405,235,1032,4207
10,394,420,256,1070,4207
11,355,451,267,1073,4207
1,500,200,50,750,4208
2,467,227,83,777,4208
3,453,257,123,833,4208
4,441,273,163,877,4208
5,428,307,177,912,4208
6,413,328,209,950,4208
7,411,366,221,998,4208
8,389,380,240,1009,4208
9,406,384,253,1043,4208
10,391,399,269,1059,4208
11,376,427,267,1070,4208
1,500,200,50,750,4209
2,465,223,103,791,4209
3,432,252,132,816,4209
4,435,268,181,884,4209
5,402,324,195,921,4209
6,393,339,212,944,4209
7,394,371,202,967,4209
8,399,372,236,1007,4209
9,397,373,256,1026,4209
10,411,395,263,1069,4209
11,374,398,289,1061,4209
1,500,200,50,750,4210
2,459,242,89,790,4210
3,436,272,121,829,4210
4,416,284,163,863,4210
5,433,298,197,928,4210
6,425,323,206,954,4210
7,417,336,228,981,4210
8,414,345,235,994,4210
9,411,370,259,1040,4210
10,391,409,258,1058,4210
11,387,412,280,1079,4210
1,500,200,50,750,4211
2,454,232,95,781,4211
3,437,278,123,838,4211
4,411,295,156,862,4211
5,419,308,191,918,4211
6,417,322,217,956,4211
7,399,357,229,985,4211
8,385,358,246,989,4211
9,404,354,257,1015,4211
10,405,389,261,1055,4211
11,415,379,282,1076,4211
1,500,200,50,750,4212
2,470,226,96,792,4212
3,422,272,130,824,4212
4,397,324,158,879,4212
5,402,343,182,927,4212
6,412,354,194,960,4212
7,412,365,213,990,4212
8,395,367,237,999,4212
9,401,393,240,1034,4212
10,399,393,261,1053,4212
11,394,391,285,1070,4212
1,500,200,50,750,4213
2,448,251,91,790,4213
3,402,295,131,828,4213
4,400,301,167,868,4213
5,417,317,192,926,4213
6,397,349,211,957,4213
7,381,362,245,988,4213
8,364,395,241,1000,4213
9,390,379,262,1031,4213
10,410,390,260,1060,4213
11,433,401,265,1099,4213
1,500,200,50,750,4214
2,468,214,100,782,4214
3,440,255,137,832,4214
4,420,289,159,868,4214
5,413,308,188,909,4214
6,429,330,207,966,4214
7,406,350,241,997,4214
8,393,372,251,1016,4214
9,380,395,255,1030,4214
10,384,382,285,1051,4214
11,413,367,319,1099,4214
1,500,200,50,750,4215
2,455,231,94,780,4215
3,428,277,125,830,4215
4,404,312,148,864,4215
5,400,339,170,909,4215
6,405,360,195,960,4215
7,373,362,244,979,4215
8,376,365,264,1005,4215
9,372,382,277,1031,4215
10,386,394,279,1059,4215
11,390,412,293,1095,4215
1,500,200,50,750,4216
2,453,225,105,783,4216
3,435,250,140,825,4216
4,417,291,157,865,4216
5,412,312,181,905,4216
6,409,326,220,955,4216
7,376,365,237,978,4216
8,386,373,234,993,4216
9,403,385,243,1031,4216
10,387,391,285,1063,4216
11,386,411,273,1070,4216
1,500,200,50,750,4217
2,453,233,99,785,4217
3,447,255,134,836,4217
4,428,279,164,871,4217
5,411,304,188,903,4217
6,436,342,196,974,4217
7,417,357,216,990,4217
8,393,382,225,1000,4217
9,400,389,253,1042,4217
10,363,398,286,1047,4217
11,356,434,295,1085,4217
1,500,200,50,750,4218
2,462,236,99,797,4218
3,413,273,135,821,4218
4,409,291,164,864,4218
5,394,309,207,910,4218
6,391,348,211,950,4218
7,398,369,215,982,4218
8,384,376,244,1004,4218
9,411,363,254,1028,4218
10,407,397,255,1059,4218
11,397,374,299,1070,4218
1,500,200,50,750,4219
2,455,245,94,794,4219
3,442,270,126,838,4219
4,433,277,174,884,4219
5,388,320,205,913,4219
6,385,340,227,952,4219
7,391,352,242,985,4219
8,411,359,242,1012,4219
9,406,363,262,1031,4219
10,384,375,296,1055,4219
11,403,397,297,1097,4219
1,500,200,50,750,4220
2,446,235,96,777,4220
3,417,253,148,818,4220
4,442,271,177,890,4220
5,408,298,199,905,4220
6,444,320,213,977,4220
7,420,343,221,984,4220
8,403,370,235,1008,4220
9,414,385,230,1029,4220
10,430,379,254,1063,4220
11,416,382,281,1079,4220
1,500,200,50,750,4221
2,469,229,96,794,4221
3,439,269,129,837,4221
4,402,297,161,860,4221
5,400,315,197,912,4221
6,388,332,220,940,4221
7,407,363,219,989,4221
8,382,401,235,1018,4221
9,396,401,233,1030,4221
10,395,399,266,1060,4221
11,386,411,286,1083,4221
1,500,200,50,750,4222
2,466,257,78,801,4222
3,451,270,108,829,4222
4,445,273,145,863,4222
5,426,309,181,916,4222
6,420,319,195,934,4222
7,421,363,196,980,4222
8,417,370,213,1000,4222
9,439,356,244,1039,4222
10,421,384,250,1055,4222
11,433,396,261,1090,4222
1,500,200,50,750,4223
2,455,254,97,806,4223
3,425,276,128,829,4223
4,408,286,171,865,4223
5,409,311,206,926,4223
6,393,334,233,960,4223
7,403,337,244,984,4223
8,392,345,269,1006,4223
9,403,374,253,1030,4223
10,395,384,270,1049,4223
11,402,400,286,1088,4223
1,500,200,50,750,4224
2,461,219,114,794,4224
3,432,256,145,833,4224
4,408,292,153,853,4224
5,406,325,186,917,4224
6,403,338,216,957,4224
7,408,347,218,973,4224
8,414,361,246,1021,4224
9,416,367,257,1040,4224
10,387,380,281,1048,4224
11,398,404,277,1079,4224
1,500,200,50,750,4225
2,464,234,91,789,4225
3,440,266,140,846,4225
4,429,281,157,867,4225
5,413,305,185,903,4225
6,427,327,203,957,4225
7,407,358,207,972,4225
8,407,377,223,1007,4225
9,423,370,241,1034,4225
10,391,402,265,1058,4225
11,403,405,273,1081,4225
1,500,200,50,750,4226
2,445,226,105,776,4226
3,434,224,138,796,4226
4,425,278,160,863,4226
5,430,309,170,909,4226
6,431,350,194,975,4226
7,396,343,244,983,4226
8,380,354,259,993,4226
9,416,368,260,1044,4226
10,407,405,254,1066,4226
11,403,406,269,1078,4226
1,500,200,50,750,4227
2,442,255,82,779,4227
3,423,274,127,824,4227
4,407,295,162,864,4227
5,399,314,191,904,4227
6,390,338,220,948,4227
7,389,373,212,974,4227
8,410,388,219,1017,4227
9,416,394,239,1049,4227
10,384,404,267,1055,4227
11,398,405,286,1089,4227
1,500,200,50,750,4228
2,462,227,96,785,4228
3,437,268,119,824,4228
4,417,294,162,873,4228
5,399,317,191,907,4228
6,414,343,205,962,4228
7,375,386,214,975,4228
8,388,369,245,1002,4228
9,397,383,245,1025,4228
10,396,405,266,1067,4228
11,374,433,292,1099,4228
1,500,200,50,750,4229
2,453,234,104,791,4229
3,440,255,142,837,4229
4,414,287,162,863,4229
5,421,312,186,919,4229
6,428,335,185,948,4229
7,447,346,199,992,4229
8,425,357,225,1007,4229
9,408,379,247,1034,4229
10,411,372,258,1041,4229
11,427,395,257,1079,4229
1,500,200,50,750,4230
2,466,231,88,785,4230
3,448,247,125,820,4230
4,448,264,168,880,4230
5,418,307,185,910,4230
6,419,343,189,951,4230
7,422,348,220,990,4230
8,418,372,217,1007,4230
9,400,390,237,1027,4230
10,404,406,241,1051,4230
11,429,410,243,1082,4230
1,500,200,50,750,4231
2,442,237,108,787,4231
3,421,277,133,831,4231
4,403,287,177,867,4231
5,400,324,197,921,4231
6,376,339,218,933,4231
7,391,356,235,982,4231
8,373,379,247,999,4231
9,361,400,267,1028,4231
10,382,385,304,1071,4231
11,381,404,294,1079,4231
1,500,200,50,750,4232
2,459,215,104,778,4232
3,433,236,154,823,4232
4,427,283,164,874,4232
5,430,310,189,929,4232
6,411,326,223,960,4232
7,414,353,218,985,4232
8,408,356,231,995,4232
9,405,365,246,1016,4232
10,423,399,260,1082,4232
11,397,424,253,1074,4232
1,500,200,50,750,4233
2,464,236,93,793,4233
3,434,257,139,830,4233
4,401,311,159,871,4233
5,412,323,187,922,4233
6,416,332,206,954,4233
7,398,366,216,980,4233
8,412,375,230,1017,4233
9,407,393,244,1044,4233
10,404,393,263,1060,4233
11,377,399,290,1066,4233
1,500,200,50,750,4234
2,455,243,86,784,4234
3,444,239,141,824,4234
4,419,277,156,852,4234
5,418,289,192,899,4234
6,427,301,240,968,4234
7,403,321,253,977,4234
8,405,344,257,1006,4234
9,401,367,258,1026,4234
10,410,382,265,1057,4234
11,406,417,260,1083,4234
1,500,200,50,750,4235
2,461,233,101,795,4235
3,434,260,127,821,4235
4,409,282,176,867,4235
5,408,300,211,919,4235
6,415,326,229,970,4235
7,399,354,232,985,4235
8,379,382,242,1003,4235
9,374,407,245,1026,4235
10,371,401,268,1040,4235
11,387,446,261,1094,4235
1,500,200,50,750,4236
2,452,245,100,797,4236
3,412,266,152,830,4236
4,392,285,190,867,4236
5,378,325,199,902,4236
6,381,366,211,958,4236
7,366,406,217,989,4236
8,366,393,247,1006,4236
9,385,397,252,1034,4236
10,402,402,248,1052,4236
11,414,407,261,1082,4236
1,500,200,50,750,4237
2,448,237,103,788,4237
3,417,243,145,805,4237
4,419,273,179,871,4237
5,419,299,198,916,4237
6,404,321,219,944,4237
7,402,360,239,1001,4237
8,380,362,259,1001,4237
9,386,380,271,1037,4237
10,378,387,289,1054,4237
11,406,403,299,1108,4237
1,500,200,50,750,4238
2,448,228,109,785,4238
3,429,262,141,832,4238
4,401,293,169,863,4238
5,381,330,202,913,4238
6,401,331,228,960,4238
7,374,376,237,987,4238
8,372,407,236,1015,4238
9,362,384,281,1027,4238
10,369,382,303,1054,4238
11,391,400,291,1082,4238
1,500,200,50,750,4239
2,451,241,96,788,4239
3,437,264,130,831,4239
4,404,293,162,859,4239
5,429,330,176,935,4239
6,439,325,211,975,4239
7,413,338,233,984,4239
8,404,349,246,999,4239
9,410,386,249,1045,4239
10,391,404,259,1054,4239
11,416,395,266,1077,4239
1,500,200,50,750,4240
2,456,231,99,786,4240
3,425,273,138,836,4240
4,408,303,162,873,4240
5,402,319,190,911,4240
6,419,350,193,962,4240
7,382,376,220,978,4240
8,386,396,238,1020,4240
9,371,410,257,1038,4240
10,403,390,275,1068,4240
11,418,412,267,1097,4240
1,500,200,50,750,4241
2,481,225,91,797,4241
3,454,246,124,824,4241
4,439,278,152,869,4241
5,425,318,172,915,4241
6,451,330,189,970,4241
7,416,349,209,974,4241
8,429,353,223,1005,4241
9,396,362,256,1014,4241
10,400,399,256,1055,4241
11,391,419,273,1083,4241
1,500,200,50,750,4242
2,433,253,94,780,4242
3,418,267,133,818,4242
4,394,294,172,860,4242
5,407,301,207,915,4242
6,407,324,227,958,4242
7,395,358,239,992,4242
8,405,365,239,1009,4242
9,405,379,243,1027,4242
10,398,399,254,1051,4242
11,415,392,265,1072,4242
1,500,200,50,750,4243
2,438,232,108,778,4243
3,418,260,139,817,4243
4,406,283,180,869,4243
5,412,303,212,927,4243
6,383,346,220,949,4243
7,366,372,237,975,4243
8,383,385,246,1014,4243
9,386,407,246,1039,4243
10,380,435,255,1070,4243
11,392,406,284,1082,4243
1,500,200,50,750,4244
2,463,225,103,791,4244
3,449,250,139,838,4244
4,422,293,148,863,4244
5,425,316,192,933,4244
6,408,347,203,958,4244
7,407,369,203,979,4244
8,396,386,232,1014,4244
9,401,393,242,1036,4244
10,399,388,267,1054,4244
11,420,382,286,1088,4244
1,500,200,50,750,4245
2,479,206,101,786,4245
3,437,256,131,824,4245
4,426,286,159,871,4245
5,409,305,187,901,4245
6,410,343,215,968,4245
7,407,362,220,989,4245
8,390,367,235,992,4245
9,402,388,247,1037,4245
10,395,375,276,1046,4245
11,424,377,285,1086,4245
1,500,200,50,750,4246
2,458,231,87,776,4246
3,430,266,133,829,4246
4,421,274,157,852,4246
5,414,299,209,922,4246
6,437,325,209,971,4246
7,397,335,238,970,4246
8,388,372,258,1018,4246
9,381,393,255,1029,4246
10,385,414,259,1058,4246
11,410,437,248,1095,4246
1,500,200,50,750,4247
2,458,230,97,785,4247
3,416,271,135,822,4247
4,396,301,169,866,4247
5,386,324,192,902,4247
6,388,334,232,954,4247
7,375,338,267,980,4247
8,369,363,259,991,4247
9,404,367,267,1038,4247
10,405,390,277,1072,4247
11,379,392,295,1066,4247
1,500,200,50,750,4248
2,476,209,101,786,4248
3,454,239,137,830,4248
4,434,267,170,871,4248
5,412,298,186,896,4248
6,398,329,207,934,4248
7,411,333,240,984,4248
8,412,366,231,1009,4248
9,407,372,247,1026,4248
10,419,385,255,1059,4248
11,395,417,263,1075,4248
1,500,200,50,750,4249
2,459,240,92,791,4249
3,420,272,135,827,4249
4,404,300,167,871,4249
5,387,337,186,910,4249
6,399,360,204,963,4249
7,394,370,221,985,4249
8,390,386,243,1019,4249
9,388,397,251,1036,4249
10,415,393,250,1058,4249
11,414,405,267,1086,4249
1,500,200,50,750,4250
2,448,231,98,777,4250
3,437,249,134,820,4250
4,430,295,154,879,4250
5,411,323,175,909,4250
6,411,339,196,946,4250
7,397,357,232,986,4250
8,391,384,231,1006,4250
9,381,379,257,1017,4250
10,385,392,270,1047,4250
11,387,410,272,1069,4250
1,500,200,50,750,4251
2,457,226,113,796,4251
3,427,262,132,821,4251
4,427,286,152,865,4251
5,417,293,185,895,4251
6,400,352,199,951,4251
7,393,340,235,968,4251
8,398,377,241,1016,4251
9,386,380,254,1020,4251
10,419,401,244,1064,4251
11,431,408,268,1107,4251
1,500,200,50,750,4252
2,459,232,95,786,4252
3,441,257,138,836,4252
4,417,295,152,864,4252
5,414,320,185,919,4252
6,412,343,190,945,4252
7,403,375,198,976,4252
8,410,379,223,1012,4252
9,421,378,245,1044,4252
10,417,388,257,1062,4252
11,436,396,264,1096,4252
1,500,200,50,750,4253
2,459,222,97,778,4253
3,425,253,149,827,4253
4,411,286,177,874,4253
5,422,310,187,919,4253
6,417,338,204,959,4253
7,438,346,211,995,4253
8,428,343,239,1010,4253
9,406,357,262,1025,4253
10,408,390,267,1065,4253
11,387,420,269,1076,4253
1,500,200,50,750,4254
2,487,211,95,793,4254
3,461,241,124,826,4254
4,437,266,150,853,4254
5,444,285,175,904,4254
6,438,320,198,956,4254
7,412,349,210,971,4254
8,429,364,218,1011,4254
9,436,352,248,1036,4254
10,407,383,256,1046,4254
11,432,403,251,1086,4254
1,500,200,50,750,4255
2,454,231,92,777,4255
3,436,268,123,827,4255
4,421,285,158,864,4255
5,408,310,183,901,4255
6,396,339,222,957,4255
7,376,352,247,975,4255
8,371,366,265,1002,4255
9,385,379,264,1028,4255
10,385,402,258,1045,4255
11,400,432,264,1096,4255
1,500,200,50,750,4256
2,460,228,89,777,4256
3,446,267,122,835,4256
4,428,282,169,879,4256
5,425,282,197,904,4256
6,423,304,228,955,4256
7,409,331,235,975,4256
8,411,322,257,990,4256
9,419,357,263,1039,4256
10,423,391,266,1080,4256
11,408,394,270,1072,4256
1,500,200,50,750,4257
2,478,227,90,795,4257
3,446,267,119,832,4257
4,420,293,161,874,4257
5,408,312,174,894,4257
6,421,333,200,954,4257
7,381,356,224,961,4257
8,388,357,269,1014,4257
9,386,378,266,1030,4257
10,374,400,264,1038,4257
11,397,429,277,1103,4257
1,500,200,50,750,4258
2,448,229,108,785,4258
3,416,269,141,826,4258
4,405,307,159,871,4258
5,399,327,187,913,4258
6,396,345,208,949,4258
7,408,353,225,986,4258
8,410,367,222,999,4258
9,414,369,244,1027,4258
10,399,377,271,1047,4258
11,423,370,288,1081,4258
1,500,200,50,750,4259
2,462,235,98,795,4259
3,435,266,130,831,4259
4,417,284,173,874,4259
5,413,325,180,918,4259
6,402,348,210,960,4259
7,387,360,229,976,4259
8,384,343,265,992,4259
9,412,359,273,1044,4259
10,417,394,244,1055,4259
11,415,382,285,1082,4259
1,500,200,50,750,4260
2,437,247,103,787,4260
3,414,276,136,826,4260
4,400,297,166,863,4260
5,400,346,175,921,4260
6,402,368,200,970,4260
7,373,364,228,965,4260
8,375,383,242,1000,4260
9,372,412,251,1035,4260
10,381,411,257,1049,4260
11,373,433,271,1077,4260
1,500,200,50,750,4261
2,443,244,98,785,4261
3,429,259,147,835,4261
4,402,297,167,866,4261
5,413,318,187,918,4261
6,409,325,217,951,4261
7,399,346,235,980,4261
8,410,359,238,1007,4261
9,394,393,245,1032,4261
10,409,384,263,1056,4261
11,411,400,278,1089,4261
1,500,200,50,750,4262
2,447,232,100,779,4262
3,421,272,125,818,4262
4,411,307,161,879,4262
5,395,312,192,899,4262
6,403,341,224,968,4262
7,389,352,242,983,4262
8,387,373,249,1009,4262
9,408,382,252,1042,4262
10,389,402,254,1045,4262
11,395,406,275,1076,4262
1,500,200,50,750,4263
2,459,226,104,789,4263
3,412,267,139,818,4263
4,413,302,162,877,4263
5,388,323,200,911,4263
6,384,346,220,950,4263
7,387,344,246,977,4263
8,374,375,243,992,4263
9,385,396,250,1031,4263
10,373,409,277,1059,4263
11,372,420,290,1082,4263
1,500,200,50,750,4264
2,458,212,112,782,4264
3,414,272,139,825,4264
4,403,318,149,870,4264
5,390,338,181,909,4264
6,421,343,220,984,4264
7,388,357,242,987,4264
8,379,386,235,1000,4264
9,397,405,222,1024,4264
10,388,409,256,1053,4264
11,369,428,290,1087,4264
1,500,200,50,750,4265
2,467,213,95,775,4265
3,434,252,135,821,4265
4,427,272,172,871,4265
5,393,325,180,898,4265
6,411,337,208,956,4265
7,416,344,227,987,4265
8,390,367,232,989,4265
9,394,382,257,1033,4265
10,400,397,263,1060,4265
11,411,413,280,1104,4265
1,500,200,50,750,4266
2,452,233,104,789,4266
3,409,266,142,817,4266
4,432,297,157,886,4266
5,426,306,180,912,4266
6,452,338,191,981,4266
7,408,354,211,973,4266
8,389,386,235,1010,4266
9,379,409,238,1026,4266
10,377,409,267,1053,4266
11,396,383,296,1075,4266
1,500,200,50,750,4267
2,460,226,93,779,4267
3,440,264,126,830,4267
4,420,289,167,876,4267
5,403,306,195,904,4267
6,398,355,206,959,4267
7,377,359,237,973,4267
8,395,363,244,1002,4267
9,406,401,248,1055,4267
10,417,382,255,1054,4267
11,421,388,263,1072,4267
1,500,200,50,750,4268
2,443,234,100,777,4268
3,409,259,146,814,4268
4,393,280,186,859,4268
5,398,311,211,920,4268
6,406,330,231,967,4268
7,389,335,254,978,4268
8,396,356,249,1001,4268
9,395,388,257,1040,4268
10,387,422,249,1058,4268
11,424,417,255,1096,4268
1,500,200,50,750,4269
2,474,225,96,795,4269
3,451,237,125,813,4269
4,438,270,157,865,4269
5,420,284,194,898,4269
6,428,310,223,961,4269
7,408,356,213,977,4269
8,389,377,235,1001,4269
9,385,409,240,1034,4269
10,388,428,243,1059,4269
11,399,428,266,1093,4269
1,500,200,50,750,4270
2,450,221,119,790,4270
3,432,252,135,819,4270
4,419,288,172,879,4270
5,408,296,200,904,4270
6,410,318,211,939,4270
7,405,320,246,971,4270
8,396,348,256,1000,4270
9,388,385,262,1035,4270
10,385,417,252,1054,4270
11,403,415,264,1082,4270
1,500,200,50,750,4271
2,437,242,92,771,4271
3,421,285,128,834,4271
4,399,294,171,864,4271
5,390,315,204,909,4271
6,389,346,211,946,4271
7,389,373,228,990,4271
8,400,369,235,1004,4271
9,389,403,244,1036,4271
10,404,403,266,1073,4271
11,377,414,287,1078,4271
1,500,200,50,750,4272
2,462,227,93,782,4272
3,443,275,122,840,4272
4,383,309,162,854,4272
5,390,319,196,905,4272
6,395,342,199,936,4272
7,397,341,235,973,4272
8,395,351,258,1004,4272
9,396,367,257,1020,4272
10,404,389,273,1066,4272
11,416,397,281,1094,4272
1,500,200,50,750,4273
2,464,228,92,784,4273
3,433,261,127,821,4273
4,414,284,172,870,4273
5,414,290,214,918,4273
6,405,358,201,964,4273
7,399,381,205,985,4273
8,400,385,227,1012,4273
9,385,377,251,1013,4273
10,420,408,245,1073,4273
11,406,410,266,1082,4273
1,500,200,50,750,4274
2,453,257,93,803,4274
3,424,272,144,840,4274
4,406,301,164,871,4274
5,398,319,181,898,4274
6,419,351,209,979,4274
7,413,358,210,981,4274
8,395,373,218,986,4274
9,400,373,252,1025,4274
10,403,409,245,1057,4274
11,398,418,276,1092,4274
1,500,200,50,750,4275
2,460,233,90,783,4275
3,429,251,140,820,4275
4,412,280,170,862,4275
5,405,307,191,903,4275
6,439,331,209,979,4275
7,405,365,213,983,4275
8,396,377,228,1001,4275
9,400,415,225,1040,4275
10,384,412,246,1042,4275
11,425,419,252,1096,4275
1,500,200,50,750,4276
2,452,242,95,789,4276
3,418,273,134,825,4276
4,393,302,161,856,4276
5,404,311,193,908,4276
6,421,342,216,979,4276
7,408,350,227,985,4276
8,419,359,241,1019,4276
9,403,361,257,1021,4276
10,409,376,271,1056,4276
11,418,401,281,1100,4276
1,500,200,50,750,4277
2,448,235,94,777,4277
3,425,270,126,821,4277
4,427,304,160,891,4277
5,412,329,168,909,4277
6,406,344,178,928,4277
7,413,356,207,976,4277
8,417,356,232,1005,4277
9,384,389,238,1011,4277
10,406,412,244,1062,4277
11,412,414,258,1084,4277
1,500,200,50,750,4278
2,461,223,111,795,4278
3,430,243,147,820,4278
4,402,280,181,863,4278
5,394,308,196,898,4278
6,408,313,233,954,4278
7,389,326,255,970,4278
8,370,348,268,986,4278
9,384,387,259,1030,4278
10,409,357,279,1045,4278
11,399,401,291,1091,4278
1,500,200,50,750,4279
2,460,217,108,785,4279
3,433,268,139,840,4279
4,420,281,165,866,4279
5,425,309,183,917,4279
6,408,318,219,945,4279
7,402,341,237,980,4279
8,423,347,249,1019,4279
9,408,348,273,1029,4279
10,433,383,260,1076,4279
11,406,406,273,1085,4279
1,500,200,50,750,4280
2,466,234,91,791,4280
3,432,266,129,827,4280
4,403,295,170,868,4280
5,406,316,196,918,4280
6,402,336,221,959,4280
7,391,367,224,982,4280
8,394,355,257,1006,4280
9,408,373,276,1057,4280
10,413,382,268,1063,4280
11,409,398,277,1084,4280
1,500,200,50,750,4281
2,457,237,102,796,4281
3,421,279,126,826,4281
4,390,301,176,867,4281
5,383,306,209,898,4281
6,400,324,231,955,4281
7,392,334,255,981,4281
8,372,347,279,998,4281
9,386,380,275,1041,4281
10,382,406,293,1081,4281
11,368,405,307,1080,4281
1,500,200,50,750,4282
2,474,215,108,797,4282
3,440,238,150,828,4282
4,416,255,173,844,4282
5,425,287,198,910,4282
6,444,308,213,965,4282
7,413,323,252,988,4282
8,374,367,258,999,4282
9,393,359,266,1018,4282
10,395,379,277,1051,4282
11,415,392,282,1089,4282
1,500,200,50,750,4283
2,455,239,93,787,4283
3,425,265,127,817,4283
4,416,298,157,871,4283
5,409,330,183,922,4283
6,418,346,207,971,4283
7,408,363,219,990,4283
8,376,377,222,975,4283
9,412,380,249,1041,4283
10,390,391,270,1051,4283
11,405,394,295,1094,4283
1,500,200,50,750,4284
2,461,230,95,786,4284
3,449,251,135,835,4284
4,412,279,166,857,4284
5,423,297,186,906,4284
6,415,323,228,966,4284
7,388,362,235,985,4284
8,394,375,235,1004,4284
9,394,379,246,1019,4284
10,386,415,250,1051,4284
11,401,393,286,1080,4284
1,500,200,50,750,4285
2,483,216,99,798,4285
3,430,251,143,824,4285
4,426,276,173,875,4285
5,394,330,188,912,4285
6,393,347,219,959,4285
7,390,372,230,992,4285
8,403,367,245,1015,4285
9,385,376,263,1024,4285
10,396,396,259,1051,4285
11,400,403,276,1079,4285
1,500,200,50,750,4286
2,476,230,90,796,4286
3,437,236,142,815,4286
4,427,267,166,860,4286
5,407,308,178,893,4286
6,413,341,192,946,4286
7,410,351,234,995,4286
8,401,368,248,1017,4286
9,371,386,263,1020,4286
10,382,398,272,1052,4286
11,373,413,295,1081,4286
1,500,200,50,750,4287
2,480,234,100,814,4287
3,427,254,150,831,4287
4,418,281,172,871,4287
5,399,323,190,912,4287
6,407,372,190,969,4287
7,384,376,218,978,4287
8,395,396,221,1012,4287
9,399,397,244,1040,4287
10,404,405,250,1059,4287
11,419,402,265,1086,4287
1,500,200,50,750,4288
2,457,230,109,796,4288
3,419,258,146,823,4288
4,404,280,181,865,4288
5,411,287,203,901,4288
6,433,313,232,978,4288
7,383,361,226,970,4288
8,397,371,225,993,4288
9,384,389,240,1013,4288
10,377,406,255,1038,4288
11,396,411,262,1069,4288
1,500,200,50,750,4289
2,469,231,97,797,4289
3,422,264,125,811,4289
4,411,279,162,852,4289
5,415,316,178,909,4289
6,426,352,194,972,4289
7,406,362,207,975,4289
8,415,365,237,1017,4289
9,385,390,231,1006,4289
10,409,398,269,1076,4289
11,384,425,273,1082,4289
1,500,200,50,750,4290
2,462,223,101,786,4290
3,427,271,133,831,4290
4,413,298,162,873,4290
5,399,319,176,894,4290
6,418,333,213,964,4290
7,401,358,227,986,4290
8,393,380,245,1018,4290
9,384,394,249,1027,4290
10,397,416,267,1080,4290
11,390,425,265,1080,4290
1,500,200,50,750,4291
2,446,233,111,790,4291
3,429,253,144,826,4291
4,414,280,170,864,4291
5,424,310,178,912,4291
6,406,358,187,951,4291
7,417,364,219,1000,4291
8,411,345,247,1003,4291
9,411,369,245,1025,4291
10,428,368,271,1067,4291
11,427,381,273,1081,4291
1,500,200,50,750,4292
2,466,233,81,780,4292
3,458,257,119,834,4292
4,434,285,149,868,4292
5,430,323,173,926,4292
6,444,348,194,986,4292
7,421,377,198,996,4292
8,396,388,226,1010,4292
9,394,400,237,1031,4292
10,377,422,257,1056,4292
11,364,428,284,1076,4292
1,500,200,50,750,4293
2,454,225,100,779,4293
3,448,275,123,846,4293
4,395,294,165,854,4293
5,400,322,196,918,4293
6,410,331,223,964,4293
7,405,343,248,996,4293
8,405,351,244,1000,4293
9,418,356,260,1034,4293
10,401,381,273,1055,4293
11,427,397,263,1087,4293
1,500,200,50,750,4294
2,461,225,91,777,4294
3,436,261,131,828,4294
4,421,309,150,880,4294
5,399,334,172,905,4294
6,416,352,198,966,4294
7,397,388,200,985,4294
8,400,391,235,1026,4294
9,390,376,253,1019,4294
10,411,393,245,1049,4294
11,432,413,261,1106,4294
1,500,200,50,750,4295
2,460,234,98,792,4295
3,422,271,123,816,4295
4,430,301,157,888,4295
5,416,304,194,914,4295
6,417,343,193,953,4295
7,422,368,207,997,4295
8,399,365,243,1007,4295
9,408,382,244,1034,4295
10,427,399,241,1067,4295
11,408,412,271,1091,4295
1,500,200,50,750,4296
2,452,237,99,788,4296
3,435,275,117,827,4296
4,410,295,159,864,4296
5,394,337,191,922,4296
6,401,359,201,961,4296
7,400,357,243,1000,4296
8,382,382,227,991,4296
9,391,393,244,1028,4296
10,406,429,244,1079,4296
11,399,436,255,1090,4296
1,500,200,50,750,4297
2,478,230,105,813,4297
3,452,239,139,830,4297
4,419,270,173,862,4297
5,399,302,196,897,4297
6,411,324,226,961,4297
7,409,320,235,964,4297
8,404,337,258,999,4297
9,392,353,282,1027,4297
10,386,383,297,1066,4297
11,391,395,291,1077,4297
1,500,200,50,750,4298
2,447,241,90,778,4298
3,404,290,136,830,4298
4,410,301,178,889,4298
5,404,310,194,908,4298
6,410,333,224,967,4298
7,410,357,222,989,4298
8,399,357,257,1013,4298
9,406,395,243,1044,4298
10,391,406,256,1053,4298
11,398,420,276,1094,4298
1,500,200,50,750,4299
2,459,231,97,787,4299
3,450,261,130,841,4299
4,405,298,163,866,4299
5,398,311,182,891,4299
6,399,356,208,963,4299
7,384,368,219,971,4299
8,386,363,253,1002,4299
9,374,404,248,1026,4299
10,373,400,273,1046,4299
11,380,414,300,1094,4299
1,500,200,50,750,4300
2,468,214,103,785,4300
3,424,266,132,822,4300
4,409,275,184,868,4300
5,416,303,192,911,4300
6,422,346,200,968,4300
7,381,392,211,984,4300
8,371,392,238,1001,4300
9,361,406,263,1030,4300
10,368,415,279,1062,4300
11,404,425,265,1094,4300
1,500,200,50,750,4301
2,446,232,104,782,4301
3,424,283,125,832,4301
4,403,306,153,862,4301
5,384,343,188,915,4301
6,381,364,208,953,4301
7,365,396,230,991,4301
8,360,383,247,990,4301
9,364,399,274,1037,4301
10,364,426,271,1061,4301
11,355,458,258,1071,4301
1,500,200,50,750,4302
2,452,237,100,789,4302
3,418,267,155,840,4302
4,395,301,182,878,4302
5,379,324,208,911,4302
6,364,378,204,946,4302
7,367,370,232,969,4302
8,395,382,239,1016,4302
9,387,395,256,1038,4302
10,384,389,277,1050,4302
11,403,430,268,1101,4302
1,500,200,50,750,4303
2,456,228,99,783,4303
3,449,237,145,831,4303
4,419,261,166,846,4303
5,425,297,194,916,4303
6,429,328,202,959,4303
7,406,356,208,970,4303
8,405,388,229,1022,4303
9,396,381,246,1023,4303
10,394,408,250,1052,4303
11,410,425,268,1103,4303
1,500,200,50,750,4304
2,459,222,93,774,4304
3,434,254,135,823,4304
4,420,271,175,866,4304
5,422,271,216,909,4304
6,421,330,211,962,4304
7,390,352,225,967,4304
8,371,384,243,998,4304
9,392,399,256,1047,4304
10,380,385,280,1045,4304
11,401,403,285,1089,4304
1,500,200,50,750,4305
2,465,220,101,786,4305
3,461,235,137,833,4305
4,431,282,156,869,4305
5,416,314,188,918,4305
6,415,328,215,958,4305
7,412,341,228,981,4305
8,398,366,233,997,4305
9,397,377,243,1017,4305
10,401,392,261,1054,4305
11,395,416,281,1092,4305
1,500,200,50,750,4306
2,459,228,100,787,4306
3,439,257,124,820,4306
4,420,296,150,866,4306
5,431,313,180,924,4306
6,402,335,210,947,4306
7,417,334,229,980,4306
8,414,353,229,996,4306
9,418,373,233,1024,4306
10,415,378,267,1060,4306
11,413,391,272,1076,4306
1,500,200,50,750,4307
2,454,228,90,772,4307
3,398,290,132,820,4307
4,395,317,156,868,4307
5,399,350,173,922,4307
6,388,352,222,962,4307
7,391,348,232,971,4307
8,404,369,236,1009,4307
9,413,371,262,1046,4307
10,400,364,277,1041,4307
11,418,374,291,1083,4307
1,500,200,50,750,4308
2,463,220,101,784,4308
3,420,273,136,829,4308
4,389,288,175,852,4308
5,384,323,186,893,4308
6,382,344,193,919,4308
7,387,355,224,966,4308
8,427,375,220,1022,4308
9,415,377,241,1033,4308
10,396,392,258,1046,4308
11,418,429,243,1090,4308
1,500,200,50,750,4309
2,473,236,86,795,4309
3,438,244,133,815,4309
4,412,262,172,846,4309
5,426,288,200,914,4309
6,416,316,228,960,4309
7,402,327,254,983,4309
8,390,369,241,1000,4309
9,391,388,260,1039,4309
10,372,390,277,1039,4309
11,412,408,277,1097,4309
1,500,200,50,750,4310
2,456,225,106,787,4310
3,423,269,131,823,4310
4,399,284,174,857,4310
5,397,308,186,891,4310
6,402,344,204,950,4310
7,380,363,247,990,4310
8,387,367,263,1017,4310
9,398,388,253,1039,4310
10,394,381,286,1061,4310
11,406,429,278,1113,4310
1,500,200,50,750,4311
2,463,233,93,789,4311
3,435,265,131,831,4311
4,435,281,156,872,4311
5,418,300,187,905,4311
6,431,300,214,945,4311
7,441,317,223,981,4311
8,408,366,236,1010,4311
9,406,369,250,1025,4311
10,412,376,284,1072,4311
11,395,410,272,1077,4311
1,500,200,50,750,4312
2,451,234,96,781,4312
3,426,264,130,820,4312
4,415,273,161,849,4312
5,430,293,186,909,4312
6,422,339,189,950,4312
7,427,370,197,994,4312
8,383,392,226,1001,4312
9,386,391,250,1027,4312
10,410,395,256,1061,4312
11,418,415,254,1087,4312
1,500,200,50,750,4313
2,454,230,101,785,4313
3,424,266,143,833,4313
4,403,290,166,859,4313
5,379,326,193,898,4313
6,371,351,226,948,4313
7,383,385,226,994,4313
8,375,408,227,1010,4313
9,371,398,255,1024,4313
10,381,383,283,1047,4313
11,374,402,300,1076,4313
1,500,200,50,750,4314
2,448,242,89,779,4314
3,408,266,146,820,4314
4,390,299,182,871,4314
5,373,322,210,905,4314
6,408,347,216,971,4314
7,395,360,229,984,4314
8,380,397,239,1016,4314
9,361,412,242,1015,4314
10,409,410,252,1071,4314
11,398,417,256,1071,4314
1,500,200,50,750,4315
2,466,225,106,797,4315
3,449,245,133,827,4315
4,423,300,141,864,4315
5,418,315,170,903,4315
6,421,344,197,962,4315
7,403,349,227,979,4315
8,394,351,244,989,4315
9,385,397,253,1035,4315
10,406,404,255,1065,4315
11,395,421,277,1093,4315
1,500,200,50,750,4316
2,460,216,102,778,4316
3,446,256,134,836,4316
4,438,269,174,881,4316
5,430,305,183,918,4316
6,416,328,212,956,4316
7,405,362,217,984,4316
8,405,374,226,1005,4316
9,429,367,243,1039,4316
10,411,368,276,1055,4316
11,419,404,276,1099,4316
1,500,200,50,750,4317
2,443,240,97,780,4317
3,430,264,127,821,4317
4,418,290,163,871,4317
5,409,307,196,912,4317
6,411,361,190,962,4317
7,404,352,221,977,4317
8,403,371,228,1002,4317
9,390,399,238,1027,4317
10,414,412,235,1061,4317
11,404,427,240,1071,4317
1,500,200,50,750,4318
2,456,222,103,781,4318
3,458,255,141,854,4318
4,429,285,164,878,4318
5,424,303,188,915,4318
6,427,325,201,953,4318
7,421,351,229,1001,4318
8,403,358,248,1009,4318
9,404,370,270,1044,4318
10,387,375,290,1052,4318
11,413,404,285,1102,4318
1,500,200,50,750,4319
2,456,236,106,798,4319
3,415,261,149,825,4319
4,409,298,158,865,4319
5,400,325,191,916,4319
6,378,374,201,953,4319
7,380,390,219,989,4319
8,392,381,245,1018,4319
9,386,395,246,1027,4319
10,410,419,261,1090,4319
11,407,417,262,1086,4319
1,500,200,50,750,4320
2,449,238,93,780,4320
3,424,285,122,831,4320
4,410,314,134,858,4320
5,393,312,182,887,4320
6,422,332,201,955,4320
7,403,345,230,978,4320
8,392,368,246,1006,4320
9,377,400,256,1033,4320
10,368,405,273,1046,4320
11,390,409,291,1090,4320
1,500,200,50,750,4321
2,468,224,101,793,4321
3,450,248,127,825,4321
4,400,281,174,855,4321
5,409,304,204,917,4321
6,404,345,215,964,4321
7,404,336,244,984,4321
8,396,352,238,986,4321
9,398,399,251,1048,4321
10,386,389,269,1044,4321
11,394,381,287,1062,4321
1,500,200,50,750,4322
2,459,237,90,786,4322
3,440,265,128,833,4322
4,434,280,142,856,4322
5,435,322,166,923,4322
6,398,326,214,938,4322
7,418,337,224,979,4322
8,418,353,248,1019,4322
9,393,363,264,1020,4322
10,403,383,267,1053,4322
11,391,409,278,1078,4322
1,500,200,50,750,4323
2,460,235,97,792,4323
3,433,254,137,824,4323
4,434,283,159,876,4323
5,417,324,194,935,4323
6,409,329,220,958,4323
7,407,359,212,978,4323
8,382,377,244,1003,4323
9,371,389,263,1023,4323
10,383,400,267,1050,4323
11,399,408,272,1079,4323
1,500,200,50,750,4324
2,446,219,115,780,4324
3,431,247,146,824,4324
4,410,289,175,874,4324
5,404,317,195,916,4324
6,406,337,212,955,4324
7,402,337,229,968,4324
8,418,355,253,1026,4324
9,382,379,264,1025,4324
10,395,362,297,1054,4324
11,385,368,324,1077,4324
1,500,200,50,750,4325
2,469,222,85,776,4325
3,453,252,128,833,4325
4,439,267,154,860,4325
5,423,307,179,909,4325
6,423,336,193,952,4325
7,396,346,214,956,4325
8,418,349,232,999,4325
9,434,359,232,1025,4325
10,399,393,266,1058,4325
11,396,402,281,1079,4325
1,500,200,50,750,4326
2,470,221,94,785,4326
3,446,262,121,829,4326
4,437,305,146,888,4326
5,423,308,176,907,4326
6,427,337,196,960,4326
7,428,339,208,975,4326
8,423,357,248,1028,4326
9,409,363,253,1025,4326
10,414,381,265,1060,4326
11,407,410,268,1085,4326
1,500,200,50,750,4327
2,466,241,89,796,4327
3,427,262,130,819,4327
4,399,283,176,858,4327
5,396,318,202,916,4327
6,407,338,211,956,4327
7,399,352,235,986,4327
8,392,370,245,1007,4327
9,390,413,221,1024,4327
10,397,432,233,1062,4327
11,405,413,256,1074,4327
1,500,200,50,750,4328
2,453,245,93,791,4328
3,410,271,134,815,4328
4,429,287,174,890,4328
5,408,305,205,918,4328
6,397,325,235,957,4328
7,396,320,248,964,4328
8,407,342,251,1000,4328
9,396,384,249,1029,4328
10,386,407,267,1060,4328
11,399,415,294,1108,4328
1,500,200,50,750,4329
2,462,225,106,793,4329
3,421,274,128,823,4329
4,421,281,172,874,4329
5,384,329,192,905,4329
6,379,352,222,953,4329
7,366,375,235,976,4329
8,384,373,261,1018,4329
9,358,378,287,1023,4329
10,390,408,279,1077,4329
11,367,413,283,1063,4329
1,500,200,50,750,4330
2,431,261,97,789,4330
3,404,286,131,821,4330
4,395,309,165,869,4330
5,416,328,179,923,4330
6,404,341,207,952,4330
7,427,349,205,981,4330
8,419,351,232,1002,4330
9,416,376,238,1030,4330
10,419,403,245,1067,4330
11,415,412,258,1085,4330
1,500,200,50,750,4331
2,457,227,99,783,4331
3,446,238,147,831,4331
4,423,287,163,873,4331
5,402,321,189,912,4331
6,434,356,186,976,4331
7,382,395,195,972,4331
8,411,396,208,1015,4331
9,394,386,244,1024,4331
10,401,395,263,1059,4331
11,393,410,282,1085,4331
1,500,200,50,750,4332
2,454,235,102,791,4332
3,425,273,127,825,4332
4,410,293,163,866,4332
5,420,310,178,908,4332
6,393,340,205,938,4332
7,407,360,222,989,4332
8,426,368,232,1026,4332
9,409,375,247,1031,4332
10,407,416,249,1072,4332
11,403,433,254,1090,4332
1,500,200,50,750,4333
2,456,247,90,793,4333
3,432,270,136,838,4333
4,420,297,155,872,4333
5,420,289,189,898,4333
6,421,312,209,942,4333
7,409,346,215,970,4333
8,422,372,235,1029,4333
9,413,370,239,1022,4333
10,411,396,237,1044,4333
11,429,415,242,1086,4333
1,500,200,50,750,4334
2,474,230,90,794,4334
3,436,240,146,822,4334
4,404,275,184,863,4334
5,403,299,207,909,4334
6,394,344,220,958,4334
7,377,387,214,978,4334
8,377,389,244,1010,4334
9,365,438,232,1035,4334
10,377,416,273,1066,4334
11,378,402,297,1077,4334
1,500,200,50,750,4335
2,454,226,101,781,4335
3,447,243,138,828,4335
4,419,292,164,875,4335
5,400,305,194,899,4335
6,400,342,214,956,4335
7,396,379,214,989,4335
8,394,392,223,1009,4335
9,389,401,251,1041,4335
10,395,396,280,1071,4335
11,396,422,278,1096,4335
1,500,200,50,750,4336
2,435,246,100,781,4336
3,402,275,146,823,4336
4,389,319,167,875,4336
5,399,332,194,925,4336
6,414,355,212,981,4336
7,390,382,202,974,4336
8,400,375,226,1001,4336
9,415,376,238,1029,4336
10,402,387,251,1040,4336
11,406,398,263,1067,4336
1,500,200,50,750,4337
2,460,237,101,798,4337
3,416,267,143,826,4337
4,419,296,157,872,4337
5,410,295,207,912,4337
6,412,317,233,962,4337
7,395,356,231,982,4337
8,381,379,245,1005,4337
9,382,391,257,1030,4337
10,369,398,288,1055,4337
11,386,416,296,1098,4337
1,500,200,50,750,4338
2,445,217,120,782,4338
3,418,241,151,810,4338
4,428,300,175,903,4338
5,387,325,196,908,4338
6,423,348,214,985,4338
7,397,368,222,987,4338
8,394,367,235,996,4338
9,392,394,261,1047,4338
10,374,413,272,1059,4338
11,388,420,282,1090,4338
1,500,200,50,750,4339
2,465,237,83,785,4339
3,426,274,125,825,4339
4,401,307,158,866,4339
5,406,313,201,920,4339
6,405,337,206,948,4339
7,413,343,221,977,4339
8,418,376,224,1018,4339
9,409,378,239,1026,4339
10,414,432,225,1071,4339
11,439,402,242,1083,4339
1,500,200,50,750,4340
2,453,240,99,792,4340
3,436,261,130,827,4340
4,397,297,163,857,4340
5,393,322,193,908,4340
6,390,351,212,953,4340
7,411,371,204,986,4340
8,414,370,224,1008,4340
9,395,376,256,1027,4340
10,394,410,264,1068,4340
11,406,386,293,1085,4340
1,500,200,50,750,4341
2,475,220,95,790,4341
3,437,249,143,829,4341
4,407,286,180,873,4341
5,388,316,199,903,4341
6,385,342,212,939,4341
7,379,357,246,982,4341
8,381,381,239,1001,4341
9,372,389,266,1027,4341
10,375,393,283,1051,4341
11,382,405,289,1076,4341
1,500,200,50,750,4342
2,462,239,81,782,4342
3,436,251,143,830,4342
4,423,271,175,869,4342
5,395,304,205,904,4342
6,403,339,213,955,4342
7,404,344,239,987,4342
8,399,357,250,1006,4342
9,408,381,261,1050,4342
10,381,407,268,1056,4342
11,405,403,289,1097,4342
1,500,200,50,750,4343
2,450,236,101,787,4343
3,434,267,134,835,4343
4,423,293,152,868,4343
5,406,311,195,912,4343
6,401,334,209,944,4343
7,377,369,226,972,4343
8,372,387,237,996,4343
9,362,429,240,1031,4343
10,362,435,262,1059,4343
11,398,431,264,1093,4343
1,500,200,50,750,4344
2,466,246,100,812,4344
3,423,261,140,824,4344
4,402,283,162,847,4344
5,421,303,201,925,4344
6,420,329,228,977,4344
7,402,330,234,966,4344
8,425,354,236,1015,4344
9,426,379,235,1040,4344
10,402,419,234,1055,4344
11,407,416,263,1086,4344
1,500,200,50,750,4345
2,463,212,113,788,4345
3,447,251,136,834,4345
4,407,288,159,854,4345
5,408,322,182,912,4345
6,390,348,216,954,4345
7,391,365,227,983,4345
8,389,386,234,1009,4345
9,405,392,239,1036,4345
10,387,400,274,1061,4345
11,391,405,295,1091,4345
1,500,200,50,750,4346
2,441,235,107,783,4346
3,404,275,137,816,4346
4,383,291,165,839,4346
5,398,326,182,906,4346
6,396,343,223,962,4346
7,378,354,247,979,4346
8,383,372,236,991,4346
9,370,412,240,1022,4346
10,384,406,264,1054,4346
11,387,427,268,1082,4346
1,500,200,50,750,4347
2,468,239,85,792,4347
3,447,275,120,842,4347
4,410,289,168,867,4347
5,392,320,191,903,4347
6,405,358,207,970,4347
7,406,368,211,985,4347
8,423,373,225,1021,4347
9,424,371,242,1037,4347
10,413,412,250,1075,4347
11,389,424,264,1077,4347
1,500,200,50,750,4348
2,453,233,108,794,4348
3,426,259,136,821,4348
4,425,296,159,880,4348
5,401,320,183,904,4348
6,435,329,207,971,4348
7,414,326,231,971,4348
8,414,348,251,1013,4348
9,411,344,274,1029,4348
10,419,358,279,1056,4348
11,440,371,280,1091,4348
1,500,200,50,750,4349
2,451,241,83,775,4349
3,435,253,135,823,4349
4,401,284,179,864,4349
5,392,322,187,901,4349
6,402,350,199,951,4349
7,407,349,220,976,4349
8,394,361,234,989,4349
9,394,364,264,1022,4349
10,402,422,247,1071,4349
11,395,427,258,1080,4349
1,500,200,50,750,4350
2,461,233,96,790,4350
3,413,273,144,830,4350
4,391,296,182,869,4350
5,403,314,212,929,4350
6,394,343,222,959,4350
7,387,366,235,988,4350
8,366,366,261,993,4350
9,375,398,262,1035,4350
10,378,413,271,1062,4350
11,380,404,290,1074,4350
1,500,200,50,750,4351
2,484,222,96,802,4351
3,448,253,134,835,4351
4,432,285,148,865,4351
5,421,321,181,923,4351
6,408,334,210,952,4351
7,399,354,231,984,4351
8,401,359,261,1021,4351
9,384,359,281,1024,4351
10,412,356,284,1052,4351
11,430,404,255,1089,4351
1,500,200,50,750,4352
2,453,244,101,798,4352
3,419,266,140,825,4352
4,396,297,169,862,4352
5,384,344,186,914,4352
6,399,363,203,965,4352
7,380,364,240,984,4352
8,373,383,257,1013,4352
9,386,381,275,1042,4352
10,380,390,284,1054,4352
11,385,400,276,1061,4352
1,500,200,50,750,4353
2,458,230,91,779,4353
3,425,270,128,823,4353
4,426,282,156,864,4353
5,417,317,186,920,4353
6,423,328,213,964,4353
7,403,360,209,972,4353
8,409,375,221,1005,4353
9,413,369,254,1036,4353
10,382,387,271,1040,4353
11,388,403,268,1059,4353
1,500,200,50,750,4354
2,454,242,98,794,4354
3,419,270,139,828,4354
4,417,292,160,869,4354
5,407,306,177,890,4354
6,393,348,199,940,4354
7,375,372,219,966,4354
8,386,387,235,1008,4354
9,401,388,241,1030,4354
10,399,393,262,1054,4354
11,401,394,290,1085,4354
1,500,200,50,750,4355
2,468,228,91,787,4355
3,455,254,123,832,4355
4,442,271,158,871,4355
5,433,286,180,899,4355
6,455,291,212,958,4355
7,431,320,201,952,4355
8,449,335,208,992,4355
9,430,365,231,1026,4355
10,436,389,234,1059,4355
11,426,390,267,1083,4355
1,500,200,50,750,4356
2,474,226,93,793,4356
3,448,254,131,833,4356
4,430,295,161,886,4356
5,395,332,198,925,4356
6,379,348,225,952,4356
7,384,348,248,980,4356
8,382,362,246,990,4356
9,402,382,240,1024,4356
10,422,377,274,1073,4356
11,404,409,275,1088,4356
1,500,200,50,750,4357
2,460,202,111,773,4357
3,439,250,130,819,4357
4,413,283,166,862,4357
5,404,328,181,913,4357
6,411,343,211,965,4357
7,399,368,220,987,4357
8,387,371,244,1002,4357
9,394,361,269,1024,4357
10,384,408,265,1057,4357
11,389,435,255,1079,4357
1,500,200,50,750,4358
2,448,225,102,775,4358
3,420,256,146,822,4358
4,417,301,168,886,4358
5,397,314,196,907,4358
6,422,339,208,969,4358
7,400,340,232,972,4358
8,413,346,258,1017,4358
9,390,361,266,1017,4358
10,403,395,254,1052,4358
11,406,406,278,1090,4358
1,500,200,50,750,4359
2,483,219,100,802,4359
3,434,245,158,837,4359
4,422,274,176,872,4359
5,404,310,202,916,4359
6,386,343,224,953,4359
7,393,366,225,984,4359
8,397,355,259,1011,4359
9,404,363,262,1029,4359
10,408,375,257,1040,4359
11,405,406,263,1074,4359
1,500,200,50,750,4360
2,452,222,102,776,4360
3,426,249,133,808,4360
4,420,300,160,880,4360
5,386,339,180,905,4360
6,387,349,223,959,4360
7,382,363,239,984,4360
8,368,401,227,996,4360
9,397,416,242,1055,4360
10,372,393,291,1056,4360
11,374,410,291,1075,4360
1,500,200,50,750,4361
2,433,234,109,776,4361
3,402,286,131,819,4361
4,402,298,164,864,4361
5,407,321,180,908,4361
6,414,361,183,958,4361
7,387,367,226,980,4361
8,385,395,224,1004,4361
9,379,414,236,1029,4361
10,369,441,261,1071,4361
11,361,428,301,1090,4361
1,500,200,50,750,4362
2,457,235,97,789,4362
3,437,260,129,826,4362
4,412,289,169,870,4362
5,397,337,192,926,4362
6,401,340,215,956,4362
7,389,338,242,969,4362
8,419,357,243,1019,4362
9,393,373,252,1018,4362
10,403,388,271,1062,4362
11,404,415,274,1093,4362
1,500,200,50,750,4363
2,454,239,94,787,4363
3,425,273,130,828,4363
4,416,306,145,867,4363
5,401,330,190,921,4363
6,413,358,195,966,4363
7,385,371,224,980,4363
8,379,374,251,1004,4363
9,383,389,261,1033,4363
10,400,371,287,1058,4363
11,397,392,277,1066,4363
1,500,200,50,750,4364
2,448,252,103,803,4364
3,418,271,142,831,4364
4,417,311,157,885,4364
5,400,319,188,907,4364
6,429,330,194,953,4364
7,424,334,216,974,4364
8,412,365,213,990,4364
9,435,371,235,1041,4364
10,426,383,255,1064,4364
11,411,411,253,1075,4364
1,500,200,50,750,4365
2,456,240,93,789,4365
3,423,275,132,830,4365
4,397,312,153,862,4365
5,402,327,192,921,4365
6,406,313,237,956,4365
7,378,339,256,973,4365
8,375,377,256,1008,4365
9,381,386,271,1038,4365
10,380,395,280,1055,4365
11,383,397,294,1074,4365
1,500,200,50,750,4366
2,454,238,92,784,4366
3,411,273,153,837,4366
4,391,296,189,876,4366
5,399,321,209,929,4366
6,396,354,226,976,4366
7,392,376,233,1001,4366
8,387,403,225,1015,4366
9,393,390,251,1034,4366
10,393,394,269,1056,4366
11,408,432,258,1098,4366
1,500,200,50,750,4367
2,462,231,92,785,4367
3,442,287,114,843,4367
4,409,320,133,862,4367
5,420,336,172,928,4367
6,427,322,210,959,4367
7,422,326,224,972,4367
8,422,347,235,1004,4367
9,417,366,248,1031,4367
10,443,344,270,1057,4367
11,449,377,268,1094,4367
1,500,200,50,750,4368
2,454,237,104,795,4368
3,428,255,145,828,4368
4,423,280,157,860,4368
5,402,320,184,906,4368
6,419,363,188,970,4368
7,409,349,219,977,4368
8,389,377,236,1002,4368
9,390,398,256,1044,4368
10,385,389,268,1042,4368
11,387,418,268,1073,4368
1,500,200,50,750,4369
2,443,244,94,781,4369
3,390,296,145,831,4369
4,377,313,170,860,4369
5,367,344,199,910,4369
6,369,353,232,954,4369
7,373,376,241,990,4369
8,380,396,249,1025,4369
9,387,402,247,1036,4369
10,373,425,262,1060,4369
11,378,420,281,1079,4369
1,500,200,50,750,4370
2,480,239,85,804,4370
3,451,251,126,828,4370
4,424,291,159,874,4370
5,397,322,186,905,4370
6,404,351,199,954,4370
7,390,376,223,989,4370
8,395,370,237,1002,4370
9,418,367,254,1039,4370
10,399,399,257,1055,4370
11,384,424,262,1070,4370
1,500,200,50,750,4371
2,456,222,108,786,4371
3,419,273,141,833,4371
4,411,279,183,873,4371
5,422,313,181,916,4371
6,408,336,205,949,4371
7,401,360,223,984,4371
8,380,382,246,1008,4371
9,391,366,264,1021,4371
10,387,390,268,1045,4371
11,399,395,301,1095,4371
1,500,200,50,750,4372
2,465,233,96,794,4372
3,426,270,133,829,4372
4,417,291,152,860,4372
5,415,322,184,921,4372
6,429,329,205,963,4372
7,421,361,204,986,4372
8,403,395,205,1003,4372
9,410,405,226,1041,4372
10,419,390,251,1060,4372
11,412,401,267,1080,4372
1,500,200,50,750,4373
2,437,262,97,796,4373
3,420,285,120,825,4373
4,411,287,165,863,4373
5,429,313,208,950,4373
6,397,336,216,949,4373
7,384,361,227,972,4373
8,375,380,245,1000,4373
9,387,409,252,1048,4373
10,365,424,271,1060,4373
11,390,406,277,1073,4373
1,500,200,50,750,4374
2,455,230,98,783,4374
3,430,275,143,848,4374
4,411,284,175,870,4374
5,400,319,193,912,4374
6,401,350,217,968,4374
7,375,377,224,976,4374
8,396,370,237,1003,4374
9,411,407,238,1056,4374
10,392,396,273,1061,4374
11,397,402,280,1079,4374
1,500,200,50,750,4375
2,456,230,92,778,4375
3,433,280,123,836,4375
4,401,310,151,862,4375
5,406,326,180,912,4375
6,404,358,188,950,4375
7,416,369,193,978,4375
8,393,409,205,1007,4375
9,405,402,224,1031,4375
10,415,386,253,1054,4375
11,409,398,278,1085,4375
1,500,200,50,750,4376
2,465,232,97,794,4376
3,429,267,144,840,4376
4,414,299,158,871,4376
5,417,330,180,927,4376
6,433,329,203,965,4376
7,395,344,224,963,4376
8,420,374,224,1018,4376
9,387,376,254,1017,4376
10,397,385,260,1042,4376
11,387,405,273,1065,4376
1,500,200,50,750,4377
2,440,247,100,787,4377
3,436,249,141,826,4377
4,414,299,168,881,4377
5,394,331,192,917,4377
6,394,342,215,951,4377
7,405,331,247,983,4377
8,392,358,259,1009,4377
9,404,356,277,1037,4377
10,394,364,280,1038,4377
11,412,404,262,1078,4377
1,500,200,50,750,4378
2,440,230,106,776,4378
3,409,260,142,811,4378
4,414,293,174,881,4378
5,401,313,190,904,4378
6,430,349,205,984,4378
7,389,370,222,981,4378
8,379,365,250,994,4378
9,365,360,288,1013,4378
10,386,364,302,1052,4378
11,382,416,270,1068,4378
1,500,200,50,750,4379
2,458,234,97,789,4379
3,410,257,136,803,4379
4,416,284,175,875,4379
5,406,302,203,911,4379
6,410,346,219,975,4379
7,393,354,226,973,4379
8,404,356,251,1011,4379
9,396,374,274,1044,4379
10,372,407,272,1051,4379
11,372,413,287,1072,4379
1,500,200,50,750,4380
2,455,240,92,787,4380
3,421,278,115,814,4380
4,437,305,148,890,4380
5,421,315,164,900,4380
6,420,325,195,940,4380
7,446,327,217,990,4380
8,427,328,243,998,4380
9,433,359,241,1033,4380
10,408,350,284,1042,4380
11,424,345,308,1077,4380
1,500,200,50,750,4381
2,463,234,88,785,4381
3,428,276,117,821,4381
4,407,302,152,861,4381
5,410,321,173,904,4381
6,424,345,210,979,4381
7,397,374,212,983,4381
8,398,375,236,1009,4381
9,424,385,246,1055,4381
10,403,394,260,1057,4381
11,405,405,277,1087,4381
1,500,200,50,750,4382
2,466,225,90,781,4382
3,441,250,132,823,4382
4,439,272,171,882,4382
5,439,285,188,912,4382
6,455,315,203,973,4382
7,431,336,208,975,4382
8,420,346,245,1011,4382
9,429,378,235,1042,4382
10,398,391,265,1054,4382
11,400,389,305,1094,4382
1,500,200,50,750,4383
2,447,231,99,777,4383
3,442,258,139,839,4383
4,412,310,151,873,4383
5,423,330,168,921,4383
6,419,354,192,965,4383
7,396,356,215,967,4383
8,404,365,234,1003,4383
9,394,379,254,1027,4383
10,400,388,268,1056,4383
11,418,387,285,1090,4383
1,500,200,50,750,4384
2,457,233,89,779,4384
3,453,235,142,830,4384
4,432,274,155,861,4384
5,416,296,187,899,4384
6,431,338,201,970,4384
7,429,335,226,990,4384
8,410,354,237,1001,4384
9,418,374,228,1020,4384
10,424,370,251,1045,4384
11,418,392,254,1064,4384
1,500,200,50,750,4385
2,470,236,81,787,4385
3,421,266,141,828,4385
4,407,295,168,870,4385
5,379,324,200,903,4385
6,401,326,231,958,4385
7,367,355,247,969,4385
8,378,380,255,1013,4385
9,373,403,261,1037,4385
10,382,395,274,1051,4385
11,401,415,248,1064,4385
1,500,200,50,750,4386
2,471,225,96,792,4386
3,439,284,113,836,4386
4,432,310,138,880,4386
5,408,318,171,897,4386
6,403,382,187,972,4386
7,391,383,209,983,4386
8,378,399,215,992,4386
9,409,396,238,1043,4386
10,386,416,261,1063,4386
11,384,422,273,1079,4386
1,500,200,50,750,4387
2,451,239,97,787,4387
3,413,268,143,824,4387
4,391,303,168,862,4387
5,395,323,204,922,4387
6,390,324,241,955,4387
7,395,346,238,979,4387
8,405,350,248,1003,4387
9,396,357,269,1022,4387
10,403,381,269,1053,4387
11,410,387,282,1079,4387
1,500,200,50,750,4388
2,454,252,93,799,4388
3,420,280,125,825,4388
4,423,279,163,865,4388
5,450,311,171,932,4388
6,420,342,196,958,4388
7,419,371,203,993,4388
8,403,362,234,999,4388
9,406,395,244,1045,4388
10,411,399,258,1068,4388
11,407,416,270,1093,4388
1,500,200,50,750,4389
2,463,227,100,790,4389
3,454,256,141,851,4389
4,411,306,150,867,4389
5,402,321,189,912,4389
6,393,327,223,943,4389
7,394,360,234,988,4389
8,395,357,244,996,4389
9,408,347,282,1037,4389
10,416,371,267,1054,4389
11,428,385,272,1085,4389
1,500,200,50,750,4390
2,466,235,92,793,4390
3,433,259,129,821,4390
4,403,286,173,862,4390
5,406,309,207,922,4390
6,385,337,227,949,4390
7,398,350,225,973,4390
8,404,351,262,1017,4390
9,399,357,267,1023,4390
10,416,363,281,1060,4390
11,416,402,275,1093,4390
1,500,200,50,750,4391
2,455,253,97,805,4391
3,422,269,140,831,4391
4,415,290,150,855,4391
5,425,342,160,927,4391
6,421,350,205,976,4391
7,402,346,227,975,4391
8,404,371,236,1011,4391
9,382,398,253,1033,4391
10,373,404,274,1051,4391
11,394,416,271,1081,4391
1,500,200,50,750,4392
2,467,227,93,787,4392
3,437,264,130,831,4392
4,417,298,147,862,4392
5,406,325,191,922,4392
6,407,363,197,967,4392
7,391,370,215,976,4392
8,408,357,249,1014,4392
9,385,383,262,1030,4392
10,390,387,277,1054,4392
11,390,410,289,1089,4392
1,500,200,50,750,4393
2,466,220,98,784,4393
3,440,267,133,840,4393
4,406,298,159,863,4393
5,404,327,183,914,4393
6,411,349,208,968,4393
7,400,353,229,982,4393
8,393,382,230,1005,4393
9,383,386,256,1025,4393
10,391,399,262,1052,4393
11,375,405,287,1067,4393
1,500,200,50,750,4394
2,459,235,91,785,4394
3,424,260,132,816,4394
4,429,284,159,872,4394
5,410,329,179,918,4394
6,429,340,203,972,4394
7,418,356,213,987,4394
8,415,361,247,1023,4394
9,378,388,264,1030,4394
10,385,415,262,1062,4394
11,389,421,273,1083,4394
1,500,200,50,750,4395
2,466,217,103,786,4395
3,407,260,144,811,4395
4,409,268,186,863,4395
5,408,304,198,910,4395
6,432,336,206,974,4395
7,413,349,228,990,4395
8,420,348,236,1004,4395
9,416,374,247,1037,4395
10,407,364,287,1058,4395
11,415,374,300,1089,4395
1,500,200,50,750,4396
2,463,233,98,794,4396
3,422,278,130,830,4396
4,392,300,164,856,4396
5,392,329,194,915,4396
6,389,330,232,951,4396
7,392,362,228,982,4396
8,399,355,246,1000,4396
9,403,387,247,1037,4396
10,397,401,249,1047,4396
11,407,417,260,1084,4396
1,500,200,50,750,4397
2,441,230,97,768,4397
3,433,262,128,823,4397
4,417,280,164,861,4397
5,419,319,167,905,4397
6,392,332,217,941,4397
7,409,372,217,998,4397
8,373,387,239,999,4397
9,374,378,268,1020,4397
10,384,397,270,1051,4397
11,391,409,289,1089,4397
1,500,200,50,750,4398
2,452,228,102,782,4398
3,438,252,138,828,4398
4,442,279,160,881,4398
5,431,309,177,917,4398
6,425,337,204,966,4398
7,404,362,228,994,4398
8,390,379,243,1012,4398
9,393,380,251,1024,4398
10,389,373,281,1043,4398
11,411,401,270,1082,4398
1,500,200,50,750,4399
2,465,239,81,785,4399
3,440,281,109,830,4399
4,432,292,146,870,4399
5,406,311,187,904,4399
6,412,327,208,947,4399
7,411,326,239,976,4399
8,393,340,263,996,4399
9,417,365,256,1038,4399
10,405,389,260,1054,4399
11,404,418,256,1078,4399
1,500,200,50,750,4400
2,445,235,94,774,4400
3,427,258,143,828,4400
4,421,273,170,864,4400
5,422,306,193,921,4400
6,416,330,215,961,4400
7,382,354,235,971,4400
8,375,387,231,993,4400
9,391,399,248,1038,4400
10,374,410,268,1052,4400
11,370,439,276,1085,4400
1,500,200,50,750,4401
2,444,247,95,786,4401
3,419,265,139,823,4401
4,399,294,171,864,4401
5,409,340,191,940,4401
6,388,357,213,958,4401
7,388,361,245,994,4401
8,379,373,254,1006,4401
9,369,373,284,1026,4401
10,377,387,285,1049,4401
11,417,377,299,1093,4401
1,500,200,50,750,4402
2,449,238,103,790,4402
3,425,262,133,820,4402
4,395,280,172,847,4402
5,403,319,194,916,4402
6,397,371,203,971,4402
7,392,391,204,987,4402
8,393,385,228,1006,4402
9,389,417,236,1042,4402
10,359,423,267,1049,4402
11,371,443,276,1090,4402
1,500,200,50,750,4403
2,447,230,104,781,4403
3,422,258,152,832,4403
4,412,302,162,876,4403
5,403,322,187,912,4403
6,415,345,215,975,4403
7,377,368,224,969,4403
8,393,372,246,1011,4403
9,407,370,268,1045,4403
10,391,386,282,1059,4403
11,389,403,284,1076,4403
1,500,200,50,750,4404
2,460,234,96,790,4404
3,445,255,139,839,4404
4,420,278,161,859,4404
5,435,314,177,926,4404
6,421,332,185,938,4404
7,417,358,197,972,4404
8,399,381,206,986,4404
9,403,400,238,1041,4404
10,407,383,269,1059,4404
11,403,398,270,1071,4404
1,500,200,50,750,4405
2,445,245,99,789,4405
3,410,267,151,828,4405
4,397,284,188,869,4405
5,403,301,212,916,4405
6,400,334,237,971,4405
7,382,375,232,989,4405
8,375,373,263,1011,4405
9,383,385,258,1026,4405
10,391,402,266,1059,4405
11,393,409,288,1090,4405
1,500,200,50,750,4406
2,441,233,105,779,4406
3,422,253,147,822,4406
4,417,285,161,863,4406
5,412,304,193,909,4406
6,423,340,206,969,4406
7,400,343,227,970,4406
8,384,365,239,988,4406
9,385,383,245,1013,4406
10,397,389,258,1044,4406
11,392,404,291,1087,4406
1,500,200,50,750,4407
2,469,231,97,797,4407
3,433,259,140,832,4407
4,435,293,160,888,4407
5,432,306,171,909,4407
6,452,337,177,966,4407
7,443,347,198,988,4407
8,430,357,214,1001,4407
9,429,367,233,1029,4407
10,420,377,254,1051,4407
11,422,402,267,1091,4407
1,500,200,50,750,4408
2,472,221,105,798,4408
3,454,247,132,833,4408
4,434,265,164,863,4408
5,418,290,194,902,4408
6,415,315,213,943,4408
7,407,346,236,989,4408
8,381,389,236,1006,4408
9,383,405,256,1044,4408
10,386,405,259,1050,4408
11,384,439,257,1080,4408
1,500,200,50,750,4409
2,449,228,110,787,4409
3,435,270,135,840,4409
4,394,307,164,865,4409
5,412,297,205,914,4409
6,429,324,211,964,4409
7,421,344,220,985,4409
8,437,347,229,1013,4409
9,426,370,235,1031,4409
10,416,387,250,1053,4409
11,428,412,245,1085,4409
1,500,200,50,750,4410
2,432,246,102,780,4410
3,433,254,145,832,4410
4,416,286,166,868,4410
5,423,303,182,908,4410
6,408,326,220,954,4410
7,391,343,244,978,4410
8,379,357,268,1004,4410
9,375,384,279,1038,4410
10,383,359,307,1049,4410
11,423,361,310,1094,4410
1,500,200,50,750,4411
2,469,216,105,790,4411
3,438,256,138,832,4411
4,426,265,176,867,4411
5,412,319,185,916,4411
6,412,354,200,966,4411
7,402,353,227,982,4411
8,397,366,240,1003,4411
9,396,385,250,1031,4411
10,374,402,265,1041,4411
11,410,420,261,1091,4411
1,500,200,50,750,4412
2,448,234,108,790,4412
3,419,265,154,838,4412
4,412,298,168,878,4412
5,392,321,190,903,4412
6,410,342,213,965,4412
7,395,376,219,990,4412
8,376,388,226,990,4412
9,395,395,257,1047,4412
10,403,384,267,1054,4412
11,389,407,297,1093,4412
1,500,200,50,750,4413
2,463,222,99,784,4413
3,437,244,132,813,4413
4,429,273,155,857,4413
5,429,309,186,924,4413
6,423,320,214,957,4413
7,401,319,248,968,4413
8,425,346,240,1011,4413
9,412,350,254,1016,4413
10,423,373,264,1060,4413
11,432,389,265,1086,4413
1,500,200,50,750,4414
2,443,250,97,790,4414
3,430,259,142,831,4414
4,408,296,162,866,4414
5,393,335,183,911,4414
6,387,348,206,941,4414
7,391,356,233,980,4414
8,376,385,226,987,4414
9,383,401,251,1035,4414
10,386,394,272,1052,4414
11,399,415,281,1095,4414
1,500,200,50,750,4415
2,457,231,98,786,4415
3,436,261,133,830,4415
4,412,274,167,853,4415
5,408,316,194,918,4415
6,413,320,205,938,4415
7,419,348,224,991,4415
8,391,375,248,1014,4415
9,380,399,236,1015,4415
10,411,403,235,1049,4415
11,407,413,261,1081,4415
1,500,200,50,750,4416
2,471,239,88,798,4416
3,430,263,136,829,4416
4,426,279,152,857,4416
5,407,320,179,906,4416
6,377,363,205,945,4416
7,378,369,217,964,4416
8,420,374,232,1026,4416
9,407,383,244,1034,4416
10,407,360,284,1051,4416
11,416,369,271,1056,4416
1,500,200,50,750,4417
2,436,228,116,780,4417
3,400,269,154,823,4417
4,434,276,162,872,4417
5,417,296,190,903,4417
6,422,327,202,951,4417
7,392,341,235,968,4417
8,413,377,213,1003,4417
9,393,373,254,1020,4417
10,395,387,271,1053,4417
11,410,393,273,1076,4417
1,500,200,50,750,4418
2,460,220,108,788,4418
3,445,256,136,837,4418
4,442,282,162,886,4418
5,434,311,178,923,4418
6,409,338,201,948,4418
7,402,358,218,978,4418
8,415,360,246,1021,4418
9,384,394,248,1026,4418
10,402,401,264,1067,4418
11,398,419,264,1081,4418
1,500,200,50,750,4419
2,455,214,102,771,4419
3,434,267,140,841,4419
4,429,273,162,864,4419
5,425,314,185,924,4419
6,423,337,197,957,4419
7,409,348,222,979,4419
8,395,370,224,989,4419
9,385,392,239,1016,4419
10,398,403,255,1056,4419
11,409,440,255,1104,4419
1,500,200,50,750,4420
2,474,230,87,791,4420
3,445,266,127,838,4420
4,387,308,174,869,4420
5,375,335,199,909,4420
6,393,342,227,962,4420
7,380,355,250,985,4420
8,390,356,253,999,4420
9,405,383,255,1043,4420
10,395,393,257,1045,4420
11,402,430,263,1095,4420
1,500,200,50,750,4421
2,477,214,101,792,4421
3,453,262,123,838,4421
4,425,298,147,870,4421
5,412,320,175,907,4421
6,392,341,216,949,4421
7,382,355,239,976,4421
8,383,375,256,1014,4421
9,369,366,283,1018,4421
10,355,378,310,1043,4421
11,387,391,321,1099,4421
1,500,200,50,750,4422
2,464,234,100,798,4422
3,430,268,129,827,4422
4,424,276,164,864,4422
5,420,314,187,921,4422
6,417,334,207,958,4422
7,422,310,241,973,4422
8,403,355,239,997,4422
9,409,371,254,1034,4422
10,420,405,243,1068,4422
11,414,407,268,1089,4422
1,500,200,50,750,4423
2,461,213,116,790,4423
3,430,247,160,837,4423
4,447,281,158,886,4423
5,406,286,205,897,4423
6,425,330,203,958,4423
7,416,352,231,999,4423
8,383,378,241,1002,4423
9,391,378,276,1045,4423
10,376,400,280,1056,4423
11,384,414,292,1090,4423
1,500,200,50,750,4424
2,456,241,107,804,4424
3,410,269,140,819,4424
4,418,267,186,871,4424
5,398,312,204,914,4424
6,390,343,216,949,4424
7,385,359,235,979,4424
8,391,353,255,999,4424
9,398,362,259,1019,4424
10,386,388,276,1050,4424
11,393,403,292,1088,4424
1,500,200,50,750,4425
2,460,237,102,799,4425
3,417,275,134,826,4425
4,403,286,173,862,4425
5,420,297,194,911,4425
6,421,340,199,960,4425
7,395,372,211,978,4425
8,398,383,242,1023,4425
9,379,385,262,1026,4425
10,401,384,276,1061,4425
11,391,412,281,1084,4425
1,500,200,50,750,4426
2,470,220,102,792,4426
3,437,260,141,838,4426
4,415,279,166,860,4426
5,398,300,200,898,4426
6,419,333,213,965,4426
7,401,355,231,987,4426
8,395,369,242,1006,4426
9,387,380,264,1031,4426
10,404,399,250,1053,4426
11,406,412,269,1087,4426
1,500,200,50,750,4427
2,459,235,99,793,4427
3,428,268,135,831,4427
4,427,277,162,866,4427
5,431,306,189,926,4427
6,426,316,218,960,4427
7,410,312,245,967,4427
8,412,338,265,1015,4427
9,401,370,261,1032,4427
10,394,369,290,1053,4427
11,383,415,302,1100,4427
1,500,200,50,750,4428
2,445,248,101,794,4428
3,438,272,121,831,4428
4,420,288,156,864,4428
5,411,317,187,915,4428
6,388,336,216,940,4428
7,399,372,223,994,4428
8,390,361,254,1005,4428
9,390,378,259,1027,4428
10,412,378,269,1059,4428
11,424,372,284,1080,4428
1,500,200,50,750,4429
2,470,232,91,793,4429
3,438,251,134,823,4429
4,409,271,183,863,4429
5,426,289,211,926,4429
6,399,325,225,949,4429
7,407,349,226,982,4429
8,394,393,222,1009,4429
9,397,404,250,1051,4429
10,396,397,262,1055,4429
11,392,416,284,1092,4429
1,500,200,50,750,4430
2,459,232,95,786,4430
3,426,262,131,819,4430
4,412,288,170,870,4430
5,395,327,185,907,4430
6,407,342,205,954,4430
7,409,360,233,1002,4430
8,396,383,225,1004,4430
9,377,405,236,1018,4430
10,410,400,262,1072,4430
11,396,416,271,1083,4430
1,500,200,50,750,4431
2,452,245,90,787,4431
3,414,263,136,813,4431
4,406,306,171,883,4431
5,389,334,198,921,4431
6,393,369,198,960,4431
7,392,377,215,984,4431
8,406,379,236,1021,4431
9,381,390,242,1013,4431
10,402,401,243,1046,4431
11,403,425,252,1080,4431
1,500,200,50,750,4432
2,453,232,95,780,4432
3,429,274,132,835,4432
4,401,312,161,874,4432
5,404,351,172,927,4432
6,402,372,190,964,4432
7,386,384,214,984,4432
8,370,389,233,992,4432
9,382,404,248,1034,4432
10,397,395,276,1068,4432
11,398,424,273,1095,4432
1,500,200,50,750,4433
2,465,240,89,794,4433
3,439,259,134,832,4433
4,432,266,166,864,4433
5,427,274,206,907,4433
6,422,318,218,958,4433
7,429,343,218,990,4433
8,417,351,238,1006,4433
9,412,373,246,1031,4433
10,400,395,241,1036,4433
11,415,421,256,1092,4433
1,500,200,50,750,4434
2,459,233,98,790,4434
3,431,273,126,830,4434
4,409,316,146,871,4434
5,429,328,173,930,4434
6,425,340,204,969,4434
7,412,344,218,974,4434
8,405,369,241,1015,4434
9,404,360,268,1032,4434
10,407,371,276,1054,4434
11,404,399,282,1085,4434
1,500,200,50,750,4435
2,452,243,86,781,4435
3,434,265,121,820,4435
4,422,290,151,863,4435
5,414,319,179,912,4435
6,439,322,197,958,4435
7,411,347,219,977,4435
8,404,371,238,1013,4435
9,381,389,250,1020,4435
10,372,420,270,1062,4435
11,397,416,278,1091,4435
1,500,200,50,750,4436
2,470,225,101,796,4436
3,430,249,131,810,4436
4,427,291,155,873,4436
5,397,310,181,888,4436
6,411,361,197,969,4436
7,401,361,225,987,4436
8,381,372,254,1007,4436
9,396,406,243,1045,4436
10,386,402,270,1058,4436
11,389,398,271,1058,4436
1,500,200,50,750,4437
2,449,227,113,789,4437
3,423,249,140,812,4437
4,412,276,179,867,4437
5,401,305,200,906,4437
6,409,319,216,944,4437
7,404,345,230,979,4437
8,391,359,247,997,4437
9,395,388,248,1031,4437
10,407,399,265,1071,4437
11,368,431,280,1079,4437
1,500,200,50,750,4438
2,439,240,101,780,4438
3,414,282,137,833,4438
4,391,309,170,870,4438
5,369,348,186,903,4438
6,384,363,198,945,4438
7,372,370,242,984,4438
8,374,406,239,1019,4438
9,360,406,263,1029,4438
10,362,400,291,1053,4438
11,403,408,284,1095,4438
1,500,200,50,750,4439
2,462,245,93,800,4439
3,424,275,138,837,4439
4,398,286,174,858,4439
5,418,308,209,935,4439
6,408,329,207,944,4439
7,402,353,226,981,4439
8,390,387,231,1008,4439
9,376,403,255,1034,4439
10,402,406,270,1078,4439
11,397,418,279,1094,4439
1,500,200,50,750,4440
2,463,221,99,783,4440
3,442,256,140,838,4440
4,404,274,180,858,4440
5,408,300,197,905,4440
6,416,339,215,970,4440
7,418,362,213,993,4440
8,408,370,224,1002,4440
9,414,378,236,1028,4440
10,405,381,260,1046,4440
11,404,412,263,1079,4440
1,500,200,50,750,4441
2,469,237,91,797,4441
3,418,289,119,826,4441
4,421,315,148,884,4441
5,393,327,194,914,4441
6,388,363,218,969,4441
7,368,378,224,970,4441
8,381,387,237,1005,4441
9,374,386,261,1021,4441
10,366,415,277,1058,4441
11,364,414,281,1059,4441
1,500,200,50,750,4442
2,457,239,100,796,4442
3,433,257,132,822,4442
4,422,268,175,865,4442
5,407,303,187,897,4442
6,376,353,216,945,4442
7,374,378,213,965,4442
8,365,394,241,1000,4442
9,392,391,264,1047,4442
10,380,412,259,1051,4442
11,370,410,289,1069,4442
1,500,200,50,750,4443
2,479,216,109,804,4443
3,440,261,127,828,4443
4,424,286,157,867,4443
5,426,301,195,922,4443
6,405,320,225,950,4443
7,391,339,241,971,4443
8,389,357,255,1001,4443
9,422,369,244,1035,4443
10,401,400,251,1052,4443
11,416,396,262,1074,4443
1,500,200,50,750,4444
2,466,222,110,798,4444
3,429,266,138,833,4444
4,405,293,173,871,4444
5,411,316,198,925,4444
6,409,340,211,960,4444
7,401,347,222,970,4444
8,434,382,215,1031,4444
9,409,394,226,1029,4444
10,384,422,249,1055,4444
11,391,413,282,1086,4444
1,500,200,50,750,4445
2,442,229,100,771,4445
3,441,273,125,839,4445
4,435,282,166,883,4445
5,418,310,170,898,4445
6,416,309,218,943,4445
7,408,333,233,974,4445
8,386,362,236,984,4445
9,394,363,266,1023,4445
10,382,396,264,1042,4445
11,409,407,283,1099,4445
1,500,200,50,750,4446
2,464,233,93,790,4446
3,411,266,142,819,4446
4,400,296,167,863,4446
5,412,328,189,929,4446
6,398,352,203,953,4446
7,382,387,226,995,4446
8,369,373,247,989,4446
9,387,381,256,1024,4446
10,400,402,261,1063,4446
11,397,406,282,1085,4446
1,500,200,50,750,4447
2,448,235,106,789,4447
3,425,261,135,821,4447
4,415,290,159,864,4447
5,394,327,186,907,4447
6,419,343,209,971,4447
7,388,371,211,970,4447
8,417,378,237,1032,4447
9,396,395,236,1027,4447
10,398,398,271,1067,4447
11,386,441,268,1095,4447
1,500,200,50,750,4448
2,446,240,97,783,4448
3,404,278,151,833,4448
4,390,303,173,866,4448
5,376,323,191,890,4448
6,388,358,218,964,4448
7,365,374,238,977,4448
8,353,389,247,989,4448
9,383,385,262,1030,4448
10,391,384,278,1053,4448
11,396,399,294,1089,4448
1,500,200,50,750,4449
2,434,246,117,797,4449
3,428,251,160,839,4449
4,403,283,180,866,4449
5,405,305,188,898,4449
6,434,321,220,975,4449
7,405,337,244,986,4449
8,416,333,254,1003,4449
9,394,393,261,1048,4449
10,389,401,265,1055,4449
11,387,408,279,1074,4449
1,500,200,50,750,4450
2,449,230,111,790,4450
3,430,252,148,830,4450
4,410,295,172,877,4450
5,405,307,197,909,4450
6,400,333,236,969,4450
7,366,351,258,975,4450
8,381,372,272,1025,4450
9,361,393,268,1022,4450
10,368,408,284,1060,4450
11,364,398,302,1064,4450
1,500,200,50,750,4451
2,454,243,95,792,4451
3,442,279,121,842,4451
4,420,280,169,869,4451
5,427,302,186,915,4451
6,432,315,207,954,4451
7,403,351,223,977,4451
8,378,366,253,997,4451
9,394,399,243,1036,4451
10,389,411,265,1065,4451
11,378,422,275,1075,4451
1,500,200,50,750,4452
2,463,221,102,786,4452
3,447,247,138,832,4452
4,435,276,160,871,4452
5,409,310,184,903,4452
6,427,337,206,970,4452
7,436,347,209,992,4452
8,436,352,235,1023,4452
9,410,354,258,1022,4452
10,406,389,262,1057,4452
11,390,391,283,1064,4452
1,500,200,50,750,4453
2,462,223,98,783,4453
3,440,246,127,813,4453
4,458,280,142,880,4453
5,422,312,170,904,4453
6,420,330,197,947,4453
7,430,335,219,984,4453
8,410,367,227,1004,4453
9,390,408,226,1024,4453
10,416,417,233,1066,4453
11,420,414,262,1096,4453
1,500,200,50,750,4454
2,455,226,94,775,4454
3,433,250,135,818,4454
4,440,283,166,889,4454
5,426,308,185,919,4454
6,422,328,216,966,4454
7,411,328,234,973,4454
8,401,360,242,1003,4454
9,394,366,262,1022,4454
10,414,384,264,1062,4454
11,400,385,292,1077,4454
1,500,200,50,750,4455
2,466,234,91,791,4455
3,439,257,132,828,4455
4,410,276,173,859,4455
5,413,316,190,919,4455
6,397,333,216,946,4455
7,408,355,216,979,4455
8,395,352,247,994,4455
9,406,394,254,1054,4455
10,396,400,254,1050,4455
11,412,393,289,1094,4455
1,500,200,50,750,4456
2,449,249,96,794,4456
3,416,273,144,833,4456
4,381,290,191,862,4456
5,389,325,186,900,4456
6,410,360,203,973,4456
7,399,355,231,985,4456
8,386,348,251,985,4456
9,418,374,261,1053,4456
10,422,393,239,1054,4456
11,422,394,271,1087,4456
1,500,200,50,750,4457
2,459,233,94,786,4457
3,436,248,145,829,4457
4,419,284,176,879,4457
5,404,310,191,905,4457
6,404,343,216,963,4457
7,370,349,247,966,4457
8,374,367,256,997,4457
9,393,393,271,1057,4457
10,377,384,296,1057,4457
11,383,413,294,1090,4457
1,500,200,50,750,4458
2,462,227,114,803,4458
3,443,235,146,824,4458
4,419,265,175,859,4458
5,393,323,202,918,4458
6,402,356,209,967,4458
7,406,367,211,984,4458
8,395,364,250,1009,4458
9,372,392,263,1027,4458
10,386,434,260,1080,4458
11,390,428,268,1086,4458
1,500,200,50,750,4459
2,463,221,103,787,4459
3,436,254,134,824,4459
4,431,260,181,872,4459
5,409,301,208,918,4459
6,390,320,245,955,4459
7,386,331,249,966,4459
8,390,349,253,992,4459
9,398,376,260,1034,4459
10,401,407,284,1092,4459
11,407,434,265,1106,4459
1,500,200,50,750,4460
2,463,214,94,771,4460
3,443,248,129,820,4460
4,435,274,166,875,4460
5,417,315,174,906,4460
6,440,332,188,960,4460
7,435,344,211,990,4460
8,418,345,240,1003,4460
9,410,364,253,1027,4460
10,428,385,249,1062,4460
11,412,393,274,1079,4460
1,500,200,50,750,4461
2,462,235,91,788,4461
3,426,256,129,811,4461
4,438,299,152,889,4461
5,393,334,183,910,4461
6,385,351,215,951,4461
7,400,372,224,996,4461
8,373,384,233,990,4461
9,384,421,229,1034,4461
10,388,410,258,1056,4461
11,387,428,267,1082,4461
1,500,200,50,750,4462
2,446,236,105,787,4462
3,404,286,146,836,4462
4,381,314,173,868,4462
5,413,328,188,929,4462
6,398,350,189,937,4462
7,386,381,217,984,4462
8,375,381,258,1014,4462
9,371,399,279,1049,4462
10,364,410,279,1053,4462
11,358,434,298,1090,4462
1,500,200,50,750,4463
2,456,228,94,778,4463
3,447,245,132,824,4463
4,456,255,163,874,4463
5,414,304,192,910,4463
6,403,336,216,955,4463
7,389,362,234,985,4463
8,403,375,232,1010,4463
9,408,374,241,1023,4463
10,421,381,244,1046,4463
11,420,408,257,1085,4463
1,500,200,50,750,4464
2,458,230,91,779,4464
3,421,266,133,820,4464
4,421,291,155,867,4464
5,403,315,188,906,4464
6,396,352,194,942,4464
7,386,368,227,981,4464
8,396,354,260,1010,4464
9,382,395,264,1041,4464
10,400,380,268,1048,4464
11,404,403,274,1081,4464
1,500,200,50,750,4465
2,450,230,92,772,4465
3,437,247,127,811,4465
4,421,283,147,851,4465
5,424,297,179,900,4465
6,444,322,200,966,4465
7,409,340,232,981,4465
8,395,372,226,993,4465
9,395,388,242,1025,4465
10,404,401,266,1071,4465
11,399,400,278,1077,4465
1,500,200,50,750,4466
2,465,221,93,779,4466
3,430,238,152,820,4466
4,413,284,182,879,4466
5,404,302,216,922,4466
6,406,326,236,968,4466
7,381,349,238,968,4466
8,376,360,250,986,4466
9,413,369,273,1055,4466
10,394,364,290,1048,4466
11,423,402,275,1100,4466
1,500,200,50,750,4467
2,451,233,104,788,4467
3,433,270,119,822,4467
4,438,297,150,885,4467
5,397,324,185,906,4467
6,399,348,201,948,4467
7,379,374,222,975,4467
8,376,370,258,1004,4467
9,348,385,291,1024,4467
10,372,381,299,1052,4467
11,382,386,306,1074,4467
1,500,200,50,750,4468
2,456,240,94,790,4468
3,441,253,129,823,4468
4,410,274,181,865,4468
5,396,303,212,911,4468
6,423,335,234,992,4468
7,401,343,230,974,4468
8,395,351,258,1004,4468
9,397,361,277,1035,4468
10,415,396,249,1060,4468
11,403,406,269,1078,4468
1,500,200,50,750,4469
2,463,228,108,799,4469
3,410,256,149,815,4469
4,404,265,206,875,4469
5,394,290,217,901,4469
6,407,343,223,973,4469
7,384,363,235,982,4469
8,390,383,236,1009,4469
9,378,398,245,1021,4469
10,389,393,280,1062,4469
11,376,420,264,1060,4469
1,500,200,50,750,4470
2,458,224,108,790,4470
3,461,255,129,845,4470
4,420,249,174,843,4470
5,429,286,199,914,4470
6,418,326,212,956,4470
7,400,337,230,967,4470
8,401,398,223,1022,4470
9,386,400,242,1028,4470
10,392,412,257,1061,4470
11,405,399,272,1076,4470
1,500,200,50,750,4471
2,451,236,95,782,4471
3,434,278,124,836,4471
4,421,266,170,857,4471
5,430,294,195,919,4471
6,421,335,216,972,4471
7,393,362,212,967,4471
8,413,383,227,1023,4471
9,414,389,242,1045,4471
10,405,410,239,1054,4471
11,410,411,278,1099,4471
1,500,200,50,750,4472
2,444,241,112,797,4472
3,435,252,145,832,4472
4,404,270,177,851,4472
5,425,313,184,922,4472
6,429,351,196,976,4472
7,403,363,223,989,4472
8,395,375,249,1019,4472
9,368,393,261,1022,4472
10,409,392,281,1082,4472
11,387,412,291,1090,4472
1,500,200,50,750,4473
2,467,221,96,784,4473
3,435,268,126,829,4473
4,422,287,153,862,4473
5,420,318,181,919,4473
6,420,321,212,953,4473
7,412,342,225,979,4473
8,402,372,228,1002,4473
9,396,377,254,1027,4473
10,401,403,265,1069,4473
11,394,413,280,1087,4473
1,500,200,50,750,4474
2,434,216,115,765,4474
3,414,232,150,796,4474
4,409,268,166,843,4474
5,413,302,177,892,4474
6,447,338,191,976,4474
7,408,369,212,989,4474
8,407,356,238,1001,4474
9,410,373,235,1018,4474
10,401,394,270,1065,4474
11,407,392,289,1088,4474
1,500,200,50,750,4475
2,444,229,116,789,4475
3,421,251,145,817,4475
4,410,268,168,846,4475
5,402,316,202,920,4475
6,393,333,223,949,4475
7,369,385,220,974,4475
8,360,393,249,1002,4475
9,382,381,259,1022,4475
10,409,406,263,1078,4475
11,383,407,281,1071,4475
1,500,200,50,750,4476
2,460,237,86,783,4476
3,431,263,131,825,4476
4,400,323,153,876,4476
5,385,337,187,909,4476
6,390,337,209,936,4476
7,409,350,219,978,4476
8,395,367,243,1005,4476
9,400,392,244,1036,4476
10,404,407,251,1062,4476
11,393,425,253,1071,4476
1,500,200,50,750,4477
2,469,217,97,783,4477
3,431,267,131,829,4477
4,418,302,163,883,4477
5,395,315,201,911,4477
6,410,341,208,959,4477
7,427,331,224,982,4477
8,422,363,228,1013,4477
9,422,387,231,1040,4477
10,415,378,273,1066,4477
11,406,385,279,1070,4477
1,500,200,50,750,4478
2,463,237,86,786,4478
3,434,267,115,816,4478
4,416,298,149,863,4478
5,426,301,181,908,4478
6,418,326,194,938,4478
7,419,337,225,981,4478
8,402,346,258,1006,4478
9,393,371,274,1038,4478
10,393,371,287,1051,4478
11,407,380,280,1067,4478
1,500,200,50,750,4479
2,464,230,97,791,4479
3,428,249,140,817,4479
4,405,262,193,860,4479
5,397,308,213,918,4479
6,410,335,218,963,4479
7,376,354,243,973,4479
8,373,376,260,1009,4479
9,382,383,271,1036,4479
10,402,391,271,1064,4479
11,387,408,275,1070,4479
1,500,200,50,750,4480
2,471,231,94,796,4480
3,436,262,133,831,4480
4,405,261,198,864,4480
5,399,326,201,926,4480
6,403,329,221,953,4480
7,420,357,213,990,4480
8,391,357,250,998,4480
9,403,388,246,1037,4480
10,396,384,272,1052,4480
11,407,401,277,1085,4480
1,500,200,50,750,4481
2,457,235,92,784,4481
3,436,257,131,824,4481
4,433,278,160,871,4481
5,422,310,184,916,4481
6,421,334,216,971,4481
7,419,321,242,982,4481
8,425,352,245,1022,4481
9,397,382,252,1031,4481
10,391,393,272,1056,4481
11,379,402,286,1067,4481
1,500,200,50,750,4482
2,451,240,97,788,4482
3,430,271,124,825,4482
4,421,283,166,870,4482
5,395,311,188,894,4482
6,408,327,210,945,4482
7,397,336,244,977,4482
8,388,340,265,993,4482
9,395,357,255,1007,4482
10,407,398,255,1060,4482
11,402,396,279,1077,4482
1,500,200,50,750,4483
2,461,222,101,784,4483
3,410,267,144,821,4483
4,410,289,158,857,4483
5,428,299,185,912,4483
6,422,328,209,959,4483
7,404,351,222,977,4483
8,401,379,226,1006,4483
9,401,388,247,1036,4483
10,413,380,268,1061,4483
11,404,405,262,1071,4483
1,500,200,50,750,4484
2,460,242,93,795,4484
3,430,269,125,824,4484
4,445,285,162,892,4484
5,405,307,197,909,4484
6,400,343,209,952,4484
7,401,348,231,980,4484
8,399,360,244,1003,4484
9,408,378,247,1033,4484
10,410,399,246,1055,4484
11,427,380,258,1065,4484
1,500,200,50,750,4485
2,467,237,91,795,4485
3,407,285,125,817,4485
4,401,318,167,886,4485
5,373,333,194,900,4485
6,390,341,217,948,4485
7,393,355,225,973,4485
8,412,378,225,1015,4485
9,396,404,237,1037,4485
10,393,417,248,1058,4485
11,390,428,265,1083,4485
1,500,200,50,750,4486
2,459,224,103,786,4486
3,433,262,129,824,4486
4,417,293,163,873,4486
5,397,327,209,933,4486
6,391,348,225,964,4486
7,388,359,228,975,4486
8,399,375,234,1008,4486
9,410,400,230,1040,4486
10,404,380,267,1051,4486
11,410,415,270,1095,4486
1,500,200,50,750,4487
2,438,255,96,789,4487
3,422,285,124,831,4487
4,393,330,137,860,4487
5,386,340,175,901,4487
6,407,353,205,965,4487
7,387,365,233,985,4487
8,373,374,235,982,4487
9,385,376,251,1012,4487
10,417,380,269,1066,4487
11,390,401,277,1068,4487
1,500,200,50,750,4488
2,456,252,83,791,4488
3,408,307,110,825,4488
4,398,324,154,876,4488
5,412,324,191,927,4488
6,404,346,217,967,4488
7,376,353,245,974,4488
8,376,364,248,988,4488
9,375,403,264,1042,4488
10,392,393,269,1054,4488
11,402,409,283,1094,4488
1,500,200,50,750,4489
2,456,242,98,796,4489
3,422,265,140,827,4489
4,410,292,172,874,4489
5,412,315,198,925,4489
6,414,325,211,950,4489
7,411,332,232,975,4489
8,391,362,239,992,4489
9,403,375,273,1051,4489
10,399,395,266,1060,4489
11,400,407,287,1094,4489
1,500,200,50,750,4490
2,470,227,100,797,4490
3,465,246,117,828,4490
4,426,281,159,866,4490
5,392,338,176,906,4490
6,384,362,208,954,4490
7,411,355,231,997,4490
8,400,342,257,999,4490
9,424,354,249,1027,4490
10,431,382,266,1079,4490
11,428,371,288,1087,4490
1,500,200,50,750,4491
2,471,220,96,787,4491
3,420,262,142,824,4491
4,402,303,156,861,4491
5,408,312,193,913,4491
6,404,339,225,968,4491
7,396,335,252,983,4491
8,400,368,227,995,4491
9,390,411,230,1031,4491
10,392,414,252,1058,4491
11,370,441,255,1066,4491
1,500,200,50,750,4492
2,467,229,106,802,4492
3,440,259,129,828,4492
4,433,287,154,874,4492
5,423,301,175,899,4492
6,417,337,193,947,4492
7,417,339,216,972,4492
8,400,360,231,991,4492
9,403,401,236,1040,4492
10,409,408,242,1059,4492
11,421,390,260,1071,4492
1,500,200,50,750,4493
2,457,234,97,788,4493
3,438,248,138,824,4493
4,426,274,154,854,4493
5,428,318,163,909,4493
6,435,329,194,958,4493
7,408,355,213,976,4493
8,423,368,231,1022,4493
9,369,367,269,1005,4493
10,394,393,278,1065,4493
11,394,406,282,1082,4493
1,500,200,50,750,4494
2,455,238,101,794,4494
3,432,278,132,842,4494
4,407,278,176,861,4494
5,401,305,198,904,4494
6,391,323,217,931,4494
7,392,344,247,983,4494
8,380,359,265,1004,4494
9,370,392,263,1025,4494
10,377,409,253,1039,4494
11,380,416,272,1068,4494
1,500,200,50,750,4495
2,469,199,100,768,4495
3,459,234,146,839,4495
4,423,283,174,880,4495
5,421,314,189,924,4495
6,406,319,227,952,4495
7,394,320,253,967,4495
8,399,351,267,1017,4495
9,394,372,273,1039,4495
10,388,386,281,1055,4495
11,376,419,302,1097,4495
1,500,200,50,750,4496
2,469,240,94,803,4496
3,430,256,137,823,4496
4,409,279,162,850,4496
5,406,322,191,919,4496
6,395,345,213,953,4496
7,393,334,244,971,4496
8,401,373,245,1019,4496
9,375,385,270,1030,4496
10,391,401,281,1073,4496
11,395,413,287,1095,4496
1,500,200,50,750,4497
2,473,233,101,807,4497
3,440,249,143,832,4497
4,423,278,179,880,4497
5,408,309,186,903,4497
6,395,347,199,941,4497
7,391,360,215,966,4497
8,395,386,242,1023,4497
9,388,386,264,1038,4497
10,371,386,292,1049,4497
11,377,419,294,1090,4497
1,500,200,50,750,4498
2,459,226,102,787,4498
3,433,255,137,825,4498
4,408,289,167,864,4498
5,412,312,168,892,4498
6,412,329,211,952,4498
7,400,335,239,974,4498
8,411,375,241,1027,4498
9,379,393,255,1027,4498
10,398,398,269,1065,4498
11,398,400,279,1077,4498
1,500,200,50,750,4499
2,462,237,97,796,4499
3,414,271,141,826,4499
4,417,300,160,877,4499
5,411,319,179,909,4499
6,418,350,211,979,4499
7,381,361,225,967,4499
8,369,397,239,1005,4499
9,379,399,260,1038,4499
10,387,431,256,1074,4499
11,380,428,286,1094,4499
1,500,200,50,750,4500
2,468,224,100,792,4500
3,429,264,129,822,4500
4,395,293,167,855,4500
5,394,306,203,903,4500
6,406,343,213,962,4500
7,396,363,229,988,4500
8,396,360,260,1016,4500
9,380,386,259,1025,4500
10,404,389,260,1053,4500
11,432,392,266,1090,4500
1,500,200,50,750,4501
2,447,226,115,788,4501
3,412,251,157,820,4501
4,408,287,170,865,4501
5,409,307,193,909,4501
6,417,312,227,956,4501
7,385,345,238,968,4501
8,391,392,245,1028,4501
9,366,409,262,1037,4501
10,380,389,284,1053,4501
11,381,423,276,1080,4501
1,500,200,50,750,4502
2,478,228,90,796,4502
3,459,248,121,828,4502
4,418,284,158,860,4502
5,405,314,183,902,4502
6,427,340,201,968,4502
7,414,346,221,981,4502
8,400,346,249,995,4502
9,419,376,252,1047,4502
10,378,404,269,1051,4502
11,384,403,273,1060,4502
1,500,200,50,750,4503
2,453,213,110,776,4503
3,448,241,149,838,4503
4,421,279,158,858,4503
5,419,316,185,920,4503
6,413,340,208,961,4503
7,387,365,233,985,4503
8,376,381,252,1009,4503
9,390,383,269,1042,4503
10,369,395,275,1039,4503
11,393,427,265,1085,4503
1,500,200,50,750,4504
2,459,244,88,791,4504
3,446,260,123,829,4504
4,432,274,161,867,4504
5,415,320,190,925,4504
6,401,341,207,949,4504
7,404,355,223,982,4504
8,406,353,250,1009,4504
9,404,375,240,1019,4504
10,412,391,253,1056,4504
11,409,394,276,1079,4504
1,500,200,50,750,4505
2,458,240,91,789,4505
3,424,287,125,836,4505
4,398,318,150,866,4505
5,375,336,182,893,4505
6,375,350,226,951,4505
7,381,372,236,989,4505
8,379,371,243,993,4505
9,417,377,265,1059,4505
10,378,393,273,1044,4505
11,404,414,253,1071,4505
1,500,200,50,750,4506
2,459,242,94,795,4506
3,427,271,129,827,4506
4,412,298,155,865,4506
5,397,332,180,909,4506
6,372,356,209,937,4506
7,381,347,249,977,4506
8,393,346,264,1003,4506
9,401,377,250,1028,4506
10,402,395,252,1049,4506
11,423,370,301,1094,4506
1,500,200,50,750,4507
2,486,221,102,809,4507
3,426,250,144,820,4507
4,395,297,157,849,4507
5,408,338,184,930,4507
6,390,356,210,956,4507
7,387,372,223,982,4507
8,388,368,252,1008,4507
9,407,381,248,1036,4507
10,390,389,280,1059,4507
11,401,406,280,1087,4507
1,500,200,50,750,4508
2,452,248,94,794,4508
3,421,283,122,826,4508
4,403,293,165,861,4508
5,430,288,186,904,4508
6,423,336,210,969,4508
7,406,353,227,986,4508
8,405,381,225,1011,4508
9,387,402,236,1025,4508
10,399,413,249,1061,4508
11,416,421,266,1103,4508
1,500,200,50,750,4509
2,447,250,93,790,4509
3,421,267,130,818,4509
4,416,289,160,865,4509
5,423,303,189,915,4509
6,400,350,199,949,4509
7,398,369,220,987,4509
8,389,369,238,996,4509
9,381,386,262,1029,4509
10,381,401,267,1049,4509
11,388,424,272,1084,4509
1,500,200,50,750,4510
2,458,238,81,777,4510
3,409,289,126,824,4510
4,422,283,154,859,4510
5,411,296,198,905,4510
6,412,326,233,971,4510
7,396,342,243,981,4510
8,388,372,248,1008,4510
9,376,397,252,1025,4510
10,392,391,275,1058,4510
11,418,404,282,1104,4510
1,500,200,50,750,4511
2,449,233,95,777,4511
3,452,261,135,848,4511
4,395,265,197,857,4511
5,393,310,203,906,4511
6,393,329,239,961,4511
7,373,351,242,966,4511
8,366,364,268,998,4511
9,379,397,263,1039,4511
10,354,414,271,1039,4511
11,371,424,275,1070,4511
1,500,200,50,750,4512
2,443,235,98,776,4512
3,440,267,146,853,4512
4,413,278,164,855,4512
5,393,313,180,886,4512
6,429,329,208,966,4512
7,422,324,246,992,4512
8,425,357,242,1024,4512
9,404,374,250,1028,4512
10,417,389,261,1067,4512
11,410,369,303,1082,4512
1,500,200,50,750,4513
2,444,226,109,779,4513
3,432,255,155,842,4513
4,395,298,179,872,4513
5,385,314,225,924,4513
6,401,330,227,958,4513
7,403,355,225,983,4513
8,384,366,251,1001,4513
9,400,378,256,1034,4513
10,404,410,256,1070,4513
11,397,415,269,1081,4513
1,500,200,50,750,4514
2,473,233,85,791,4514
3,436,271,121,828,4514
4,409,308,158,875,4514
5,388,333,194,915,4514
6,388,358,210,956,4514
7,392,384,219,995,4514
8,391,379,238,1008,4514
9,378,376,249,1003,4514
10,414,376,270,1060,4514
11,418,384,290,1092,4514
1,500,200,50,750,4515
2,455,252,89,796,4515
3,421,274,132,827,4515
4,415,271,175,861,4515
5,407,313,188,908,4515
6,399,351,196,946,4515
7,382,367,215,964,4515
8,409,369,231,1009,4515
9,413,380,245,1038,4515
10,413,380,258,1051,4515
11,416,404,267,1087,4515
1,500,200,50,750,4516
2,462,236,89,787,4516
3,433,243,136,812,4516
4,413,290,163,866,4516
5,398,315,193,906,4516
6,405,341,209,955,4516
7,395,345,238,978,4516
8,381,359,244,984,4516
9,408,386,256,1050,4516
10,398,388,282,1068,4516
11,399,410,285,1094,4516
1,500,200,50,750,4517
2,461,228,99,788,4517
3,432,268,117,817,4517
4,404,299,157,860,4517
5,411,316,186,913,4517
6,416,343,219,978,4517
7,397,356,225,978,4517
8,392,360,247,999,4517
9,401,367,264,1032,4517
10,408,369,283,1060,4517
11,423,384,277,1084,4517
1,500,200,50,750,4518
2,457,231,97,785,4518
3,451,251,142,844,4518
4,405,295,169,869,4518
5,406,316,201,923,4518
6,404,355,210,969,4518
7,390,356,233,979,4518
8,400,353,248,1001,4518
9,412,371,253,1036,4518
10,410,360,276,1046,4518
11,402,407,273,1082,4518
1,500,200,50,750,4519
2,478,212,101,791,4519
3,421,244,144,809,4519
4,409,287,181,877,4519
5,388,325,210,923,4519
6,373,334,262,969,4519
7,392,337,265,994,4519
8,393,363,266,1022,4519
9,372,374,271,1017,4519
10,406,383,286,1075,4519
11,397,404,285,1086,4519
1,500,200,50,750,4520
2,458,226,102,786,4520
3,444,263,127,834,4520
4,438,274,163,875,4520
5,457,287,176,920,4520
6,456,298,209,963,4520
7,426,325,224,975,4520
8,436,342,228,1006,4520
9,418,354,255,1027,4520
10,407,393,249,1049,4520
11,424,407,259,1090,4520
1,500,200,50,750,4521
2,461,230,98,789,4521
3,447,243,150,840,4521
4,409,292,174,875,4521
5,388,332,175,895,4521
6,405,344,215,964,4521
7,392,359,228,979,4521
8,364,385,252,1001,4521
9,371,403,274,1048,4521
10,367,392,290,1049,4521
11,403,419,264,1086,4521
1,500,200,50,750,4522
2,446,241,96,783,4522
3,410,268,140,818,4522
4,387,295,178,860,4522
5,377,322,202,901,4522
6,380,359,211,950,4522
7,385,374,218,977,4522
8,401,386,232,1019,4522
9,396,384,242,1022,4522
10,409,384,269,1062,4522
11,399,398,282,1079,4522
1,500,200,50,750,4523
2,443,247,85,775,4523
3,418,276,142,836,4523
4,387,305,170,862,4523
5,390,331,198,919,4523
6,393,366,201,960,4523
7,395,370,218,983,4523
8,391,397,225,1013,4523
9,396,389,263,1048,4523
10,394,392,275,1061,4523
11,392,417,264,1073,4523
1,500,200,50,750,4524
2,460,252,90,802,4524
3,408,277,150,835,4524
4,406,276,182,864,4524
5,391,312,198,901,4524
6,397,349,201,947,4524
7,401,339,253,993,4524
8,406,355,257,1018,4524
9,394,352,269,1015,4524
10,402,399,267,1068,4524
11,389,423,272,1084,4524
1,500,200,50,750,4525
2,472,224,83,779,4525
3,432,264,124,820,4525
4,427,293,158,878,4525
5,409,339,173,921,4525
6,406,359,199,964,4525
7,369,375,227,971,4525
8,379,388,240,1007,4525
9,373,382,272,1027,4525
10,367,416,273,1056,4525
11,385,414,289,1088,4525
1,500,200,50,750,4526
2,460,215,99,774,4526
3,443,268,123,834,4526
4,438,276,161,875,4526
5,438,297,168,903,4526
6,427,324,198,949,4526
7,412,352,215,979,4526
8,411,374,230,1015,4526
9,420,371,253,1044,4526
10,425,379,264,1068,4526
11,408,414,261,1083,4526
1,500,200,50,750,4527
2,457,236,98,791,4527
3,435,272,133,840,4527
4,388,310,159,857,4527
5,418,306,187,911,4527
6,440,325,213,978,4527
7,430,340,230,1000,4527
8,397,363,241,1001,4527
9,413,390,238,1041,4527
10,409,390,244,1043,4527
11,416,413,246,1075,4527
1,500,200,50,750,4528
2,448,234,99,781,4528
3,429,278,128,835,4528
4,409,316,153,878,4528
5,404,326,179,909,4528
6,399,321,230,950,4528
7,411,346,225,982,4528
8,416,349,249,1014,4528
9,418,357,253,1028,4528
10,436,375,244,1055,4528
11,424,383,265,1072,4528
1,500,200,50,750,4529
2,472,207,102,781,4529
3,436,252,135,823,4529
4,423,290,161,874,4529
5,396,337,181,914,4529
6,423,346,190,959,4529
7,411,349,219,979,4529
8,424,349,224,997,4529
9,427,379,239,1045,4529
10,430,373,255,1058,4529
11,431,406,252,1089,4529
1,500,200,50,750,4530
2,453,234,101,788,4530
3,430,262,134,826,4530
4,423,282,163,868,4530
5,406,339,184,929,4530
6,398,343,213,954,4530
7,385,364,237,986,4530
8,384,380,246,1010,4530
9,392,381,252,1025,4530
10,412,414,245,1071,4530
11,398,418,255,1071,4530
1,500,200,50,750,4531
2,461,226,113,800,4531
3,447,254,138,839,4531
4,416,280,165,861,4531
5,399,311,209,919,4531
6,402,342,222,966,4531
7,370,384,223,977,4531
8,359,385,246,990,4531
9,383,382,260,1025,4531
10,395,397,268,1060,4531
11,402,390,291,1083,4531
1,500,200,50,750,4532
2,451,243,82,776,4532
3,414,264,137,815,4532
4,414,279,168,861,4532
5,411,320,191,922,4532
6,416,338,215,969,4532
7,405,341,231,977,4532
8,393,359,239,991,4532
9,397,385,256,1038,4532
10,382,385,290,1057,4532
11,387,399,286,1072,4532
1,500,200,50,750,4533
2,472,232,94,798,4533
3,416,267,132,815,4533
4,420,297,170,887,4533
5,415,296,184,895,4533
6,426,320,221,967,4533
7,412,331,229,972,4533
8,420,350,239,1009,4533
9,420,385,233,1038,4533
10,431,397,238,1066,4533
11,417,410,252,1079,4533
1,500,200,50,750,4534
2,474,213,99,786,4534
3,450,249,135,834,4534
4,430,256,193,879,4534
5,405,284,209,898,4534
6,424,295,239,958,4534
7,437,334,226,997,4534
8,403,346,254,1003,4534
9,407,357,251,1015,4534
10,439,393,242,1074,4534
11,430,403,253,1086,4534
1,500,200,50,750,4535
2,478,233,82,793,4535
3,436,253,136,825,4535
4,444,278,159,881,4535
5,408,336,168,912,4535
6,405,337,205,947,4535
7,393,346,242,981,4535
8,382,358,247,987,4535
9,401,369,255,1025,4535
10,393,409,249,1051,4535
11,402,428,252,1082,4535
1,500,200,50,750,4536
2,469,216,98,783,4536
3,446,245,127,818,4536
4,434,280,156,870,4536
5,429,305,179,913,4536
6,413,327,211,951,4536
7,427,332,236,995,4536
8,411,351,237,999,4536
9,409,372,260,1041,4536
10,413,369,284,1066,4536
11,402,376,284,1062,4536
1,500,200,50,750,4537
2,453,235,90,778,4537
3,422,263,126,811,4537
4,409,305,159,873,4537
5,385,339,190,914,4537
6,387,351,224,962,4537
7,374,371,226,971,4537
8,383,383,236,1002,4537
9,390,387,251,1028,4537
10,404,390,268,1062,4537
11,395,419,271,1085,4537
1,500,200,50,750,4538
2,459,219,116,794,4538
3,399,257,165,821,4538
4,399,264,200,863,4538
5,398,285,215,898,4538
6,409,307,244,960,4538
7,406,336,242,984,4538
8,394,361,234,989,4538
9,398,366,265,1029,4538
10,398,389,269,1056,4538
11,406,402,278,1086,4538
1,500,200,50,750,4539
2,477,236,92,805,4539
3,427,281,123,831,4539
4,420,284,167,871,4539
5,413,297,193,903,4539
6,405,315,221,941,4539
7,403,359,241,1003,4539
8,410,349,252,1011,4539
9,388,370,258,1016,4539
10,399,380,265,1044,4539
11,410,405,267,1082,4539
1,500,200,50,750,4540
2,444,242,100,786,4540
3,425,261,138,824,4540
4,423,282,166,871,4540
5,416,313,190,919,4540
6,417,335,210,962,4540
7,410,350,228,988,4540
8,407,364,238,1009,4540
9,395,382,251,1028,4540
10,420,381,269,1070,4540
11,419,409,270,1098,4540
1,500,200,50,750,4541
2,468,229,94,791,4541
3,446,243,135,824,4541
4,437,268,165,870,4541
5,427,300,178,905,4541
6,418,317,227,962,4541
7,401,340,237,978,4541
8,404,360,246,1010,4541
9,415,375,250,1040,4541
10,413,384,267,1064,4541
11,414,403,264,1081,4541
1,500,200,50,750,4542
2,464,240,99,803,4542
3,419,271,135,825,4542
4,411,275,167,853,4542
5,422,292,209,923,4542
6,407,310,252,969,4542
7,390,334,256,980,4542
8,391,362,259,1012,4542
9,380,385,264,1029,4542
10,395,410,256,1061,4542
11,380,403,278,1061,4542
1,500,200,50,750,4543
2,479,215,87,781,4543
3,451,242,137,830,4543
4,435,258,163,856,4543
5,434,288,191,913,4543
6,433,310,226,969,4543
7,391,355,232,978,4543
8,397,371,229,997,4543
9,390,393,252,1035,4543
10,383,424,250,1057,4543
11,395,415,267,1077,4543
1,500,200,50,750,4544
2,488,212,105,805,4544
3,468,226,137,831,4544
4,432,279,155,866,4544
5,402,307,194,903,4544
6,429,354,193,976,4544
7,393,370,224,987,4544
8,393,391,232,1016,4544
9,370,414,257,1041,4544
10,381,419,272,1072,4544
11,383,407,288,1078,4544
1,500,200,50,750,4545
2,451,239,105,795,4545
3,412,266,147,825,4545
4,398,278,187,863,4545
5,397,307,217,921,4545
6,405,328,229,962,4545
7,390,333,243,966,4545
8,388,353,266,1007,4545
9,391,383,252,1026,4545
10,414,368,269,1051,4545
11,399,397,275,1071,4545
1,500,200,50,750,4546
2,454,233,98,785,4546
3,408,266,144,818,4546
4,404,286,156,846,4546
5,404,313,194,911,4546
6,414,341,220,975,4546
7,372,346,249,967,4546
8,372,366,263,1001,4546
9,385,384,256,1025,4546
10,421,383,277,1081,4546
11,395,414,283,1092,4546
1,500,200,50,750,4547
2,441,243,101,785,4547
3,402,267,135,804,4547
4,416,284,167,867,4547
5,417,305,180,902,4547
6,437,320,211,968,4547
7,416,349,218,983,4547
8,404,351,241,996,4547
9,400,348,259,1007,4547
10,413,377,255,1045,4547
11,414,402,281,1097,4547
1,500,200,50,750,4548
2,464,236,103,803,4548
3,433,259,138,830,4548
4,426,269,177,872,4548
5,425,303,181,909,4548
6,421,353,198,972,4548
7,406,348,228,982,4548
8,391,381,238,1010,4548
9,392,399,231,1022,4548
10,413,381,267,1061,4548
11,410,389,275,1074,4548
1,500,200,50,750,4549
2,449,233,109,791,4549
3,420,238,160,818,4549
4,421,277,182,880,4549
5,411,298,213,922,4549
6,420,309,224,953,4549
7,406,320,232,958,4549
8,435,365,228,1028,4549
9,427,361,242,1030,4549
10,423,390,241,1054,4549
11,437,400,254,1091,4549
1,500,200,50,750,4550
2,453,254,86,793,4550
3,432,277,118,827,4550
4,415,287,155,857,4550
5,415,312,181,908,4550
6,410,351,200,961,4550
7,382,362,217,961,4550
8,387,372,246,1005,4550
9,377,393,253,1023,4550
10,377,407,264,1048,4550
11,365,432,294,1091,4550
1,500,200,50,750,4551
2,453,229,107,789,4551
3,430,250,131,811,4551
4,433,285,165,883,4551
5,414,311,183,908,4551
6,398,352,195,945,4551
7,395,378,221,994,4551
8,380,369,262,1011,4551
9,385,372,291,1048,4551
10,374,392,285,1051,4551
11,381,421,280,1082,4551
1,500,200,50,750,4552
2,446,238,102,786,4552
3,411,273,150,834,4552
4,415,298,169,882,4552
5,407,311,199,917,4552
6,397,323,211,931,4552
7,404,321,258,983,4552
8,382,368,249,999,4552
9,384,382,268,1034,4552
10,386,382,290,1058,4552
11,387,392,282,1061,4552
1,500,200,50,750,4553
2,460,239,93,792,4553
3,443,241,140,824,4553
4,425,277,169,871,4553
5,423,293,199,915,4553
6,427,332,209,968,4553
7,406,336,227,969,4553
8,397,356,256,1009,4553
9,386,378,264,1028,4553
10,400,403,261,1064,4553
11,371,412,288,1071,4553
1,500,200,50,750,4554
2,485,222,94,801,4554
3,450,247,127,824,4554
4,442,295,149,886,4554
5,400,308,202,910,4554
6,389,324,221,934,4554
7,386,325,241,952,4554
8,400,356,252,1008,4554
9,421,390,227,1038,4554
10,410,400,250,1060,4554
11,404,415,260,1079,4554
1,500,200,50,750,4555
2,445,244,100,789,4555
3,432,254,134,820,4555
4,429,275,173,877,4555
5,410,329,174,913,4555
6,414,349,211,974,4555
7,383,350,246,979,4555
8,388,372,244,1004,4555
9,404,374,256,1034,4555
10,396,386,274,1056,4555
11,396,403,290,1089,4555
1,500,200,50,750,4556
2,471,227,93,791,4556
3,440,262,117,819,4556
4,407,295,157,859,4556
5,401,307,186,894,4556
6,392,356,222,970,4556
7,381,361,240,982,4556
8,389,380,242,1011,4556
9,384,390,258,1032,4556
10,402,400,242,1044,4556
11,428,413,252,1093,4556
1,500,200,50,750,4557
2,447,259,91,797,4557
3,420,282,129,831,4557
4,418,291,168,877,4557
5,410,324,183,917,4557
6,383,350,216,949,4557
7,386,344,251,981,4557
8,398,376,254,1028,4557
9,371,405,269,1045,4557
10,359,403,283,1045,4557
11,402,421,275,1098,4557
1,500,200,50,750,4558
2,460,224,100,784,4558
3,432,267,131,830,4558
4,393,283,169,845,4558
5,422,306,190,918,4558
6,401,357,200,958,4558
7,395,359,226,980,4558
8,410,353,248,1011,4558
9,394,370,258,1022,4558
10,394,401,254,1049,4558
11,405,420,265,1090,4558
1,500,200,50,750,4559
2,468,229,85,782,4559
3,428,246,128,802,4559
4,443,289,163,895,4559
5,402,281,223,906,4559
6,417,322,224,963,4559
7,412,328,236,976,4559
8,402,346,253,1001,4559
9,381,360,263,1004,4559
10,387,392,273,1052,4559
11,405,417,269,1091,4559
1,500,200,50,750,4560
2,453,230,99,782,4560
3,404,269,145,818,4560
4,395,312,169,876,4560
5,380,330,191,901,4560
6,401,350,200,951,4560
7,397,382,227,1006,4560
8,393,359,255,1007,4560
9,406,364,254,1024,4560
10,402,385,262,1049,4560
11,420,398,279,1097,4560
1,500,200,50,750,4561
2,457,204,111,772,4561
3,446,251,142,839,4561
4,433,294,148,875,4561
5,412,304,186,902,4561
6,423,330,208,961,4561
7,415,357,212,984,4561
8,402,369,218,989,4561
9,378,426,226,1030,4561
10,383,440,253,1076,4561
11,384,413,277,1074,4561
1,500,200,50,750,4562
2,455,241,96,792,4562
3,418,273,132,823,4562
4,389,295,182,866,4562
5,385,307,208,900,4562
6,376,366,221,963,4562
7,364,372,232,968,4562
8,384,380,235,999,4562
9,382,398,254,1034,4562
10,383,406,278,1067,4562
11,378,422,285,1085,4562
1,500,200,50,750,4563
2,450,252,99,801,4563
3,418,271,136,825,4563
4,404,294,156,854,4563
5,388,319,187,894,4563
6,407,356,187,950,4563
7,390,398,202,990,4563
8,387,395,232,1014,4563
9,368,406,235,1009,4563
10,380,426,255,1061,4563
11,375,424,282,1081,4563
1,500,200,50,750,4564
2,442,250,88,780,4564
3,438,268,134,840,4564
4,418,268,175,861,4564
5,422,308,186,916,4564
6,420,354,186,960,4564
7,435,369,182,986,4564
8,413,382,205,1000,4564
9,413,391,238,1042,4564
10,408,382,258,1048,4564
11,396,411,273,1080,4564
1,500,200,50,750,4565
2,433,242,103,778,4565
3,426,253,136,815,4565
4,414,291,162,867,4565
5,393,327,177,897,4565
6,388,342,219,949,4565
7,392,356,242,990,4565
8,395,380,238,1013,4565
9,396,379,249,1024,4565
10,394,401,267,1062,4565
11,405,423,265,1093,4565
1,500,200,50,750,4566
2,452,233,103,788,4566
3,418,272,135,825,4566
4,406,306,160,872,4566
5,405,333,176,914,4566
6,397,331,212,940,4566
7,409,358,220,987,4566
8,380,399,215,994,4566
9,409,394,237,1040,4566
10,400,409,243,1052,4566
11,385,430,242,1057,4566
1,500,200,50,750,4567
2,448,240,93,781,4567
3,425,271,126,822,4567
4,395,313,154,862,4567
5,395,336,170,901,4567
6,372,367,212,951,4567
7,372,381,238,991,4567
8,362,393,253,1008,4567
9,347,407,278,1032,4567
10,362,397,293,1052,4567
11,367,409,302,1078,4567
1,500,200,50,750,4568
2,456,218,110,784,4568
3,428,242,153,823,4568
4,429,274,168,871,4568
5,404,321,197,922,4568
6,394,339,226,959,4568
7,379,350,239,968,4568
8,393,360,240,993,4568
9,352,402,247,1001,4568
10,381,416,260,1057,4568
11,371,418,283,1072,4568
1,500,200,50,750,4569
2,457,222,103,782,4569
3,452,240,135,827,4569
4,418,269,176,863,4569
5,411,316,187,914,4569
6,417,331,213,961,4569
7,415,354,220,989,4569
8,409,370,237,1016,4569
9,390,375,275,1040,4569
10,381,399,270,1050,4569
11,391,409,274,1074,4569
1,500,200,50,750,4570
2,470,229,97,796,4570
3,455,243,138,836,4570
4,423,274,170,867,4570
5,421,312,189,922,4570
6,398,338,214,950,4570
7,422,331,212,965,4570
8,400,379,223,1002,4570
9,423,389,220,1032,4570
10,418,405,235,1058,4570
11,394,417,266,1077,4570
1,500,200,50,750,4571
2,459,229,102,790,4571
3,418,250,163,831,4571
4,429,283,166,878,4571
5,416,331,176,923,4571
6,398,360,184,942,4571
7,389,363,207,959,4571
8,397,371,240,1008,4571
9,411,379,257,1047,4571
10,404,393,266,1063,4571
11,391,406,269,1066,4571
1,500,200,50,750,4572
2,471,230,91,792,4572
3,435,255,123,813,4572
4,430,278,147,855,4572
5,416,307,179,902,4572
6,396,337,210,943,4572
7,398,354,241,993,4572
8,388,356,256,1000,4572
9,401,376,271,1048,4572
10,399,343,300,1042,4572
11,399,376,307,1082,4572
1,500,200,50,750,4573
2,441,239,100,780,4573
3,430,258,139,827,4573
4,416,276,165,857,4573
5,392,324,192,908,4573
6,389,332,216,937,4573
7,405,345,232,982,4573
8,399,368,228,995,4573
9,420,368,244,1032,4573
10,421,395,255,1071,4573
11,405,407,275,1087,4573
1,500,200,50,750,4574
2,459,223,109,791,4574
3,445,240,145,830,4574
4,422,270,170,862,4574
5,393,328,178,899,4574
6,438,326,212,976,4574
7,410,343,230,983,4574
8,401,356,250,1007,4574
9,415,361,245,1021,4574
10,420,397,252,1069,4574
11,403,398,273,1074,4574
1,500,200,50,750,4575
2,459,242,97,798,4575
3,430,255,143,828,4575
4,438,264,169,871,4575
5,417,316,168,901,4575
6,430,339,182,951,4575
7,406,352,207,965,4575
8,428,362,227,1017,4575
9,405,383,236,1024,4575
10,415,400,241,1056,4575
11,426,410,245,1081,4575
1,500,200,50,750,4576
2,474,223,112,809,4576
3,426,260,147,833,4576
4,393,290,167,850,4576
5,397,314,198,909,4576
6,371,356,210,937,4576
7,396,355,225,976,4576
8,367,387,239,993,4576
9,367,400,268,1035,4576
10,367,403,279,1049,4576
11,367,420,292,1079,4576
1,500,200,50,750,4577
2,461,230,91,782,4577
3,443,263,129,835,4577
4,417,278,164,859,4577
5,413,319,179,911,4577
6,428,328,200,956,4577
7,412,338,227,977,4577
8,395,363,247,1005,4577
9,391,371,267,1029,4577
10,415,373,281,1069,4577
11,407,377,287,1071,4577
1,500,200,50,750,4578
2,442,242,91,775,4578
3,405,266,142,813,4578
4,404,273,182,859,4578
5,375,331,205,911,4578
6,373,372,221,966,4578
7,364,379,232,975,4578
8,374,395,243,1012,4578
9,390,399,253,1042,4578
10,396,419,245,1060,4578
11,396,415,268,1079,4578
1,500,200,50,750,4579
2,433,239,113,785,4579
3,420,270,149,839,4579
4,396,305,172,873,4579
5,396,336,188,920,4579
6,381,341,233,955,4579
7,368,366,239,973,4579
8,360,389,251,1000,4579
9,389,367,278,1034,4579
10,389,397,272,1058,4579
11,402,415,279,1096,4579
1,500,200,50,750,4580
2,461,238,97,796,4580
3,423,261,141,825,4580
4,415,286,165,866,4580
5,391,319,202,912,4580
6,369,343,229,941,4580
7,376,359,245,980,4580
8,378,379,253,1010,4580
9,373,408,253,1034,4580
10,386,398,281,1065,4580
11,388,413,274,1075,4580
1,500,200,50,750,4581
2,460,218,92,770,4581
3,449,245,128,822,4581
4,431,267,172,870,4581
5,413,296,199,908,4581
6,395,356,203,954,4581
7,385,386,225,996,4581
8,398,380,225,1003,4581
9,396,384,242,1022,4581
10,385,408,262,1055,4581
11,384,437,256,1077,4581
1,500,200,50,750,4582
2,469,240,88,797,4582
3,446,264,127,837,4582
4,413,291,166,870,4582
5,414,332,171,917,4582
6,392,333,223,948,4582
7,392,343,236,971,4582
8,395,373,235,1003,4582
9,413,371,248,1032,4582
10,405,388,263,1056,4582
11,414,414,268,1096,4582
1,500,200,50,750,4583
2,479,220,91,790,4583
3,446,235,140,821,4583
4,421,262,174,857,4583
5,416,297,195,908,4583
6,414,332,205,951,4583
7,408,351,227,986,4583
8,388,377,237,1002,4583
9,414,361,247,1022,4583
10,421,398,228,1047,4583
11,447,387,256,1090,4583
1,500,200,50,750,4584
2,465,228,89,782,4584
3,432,273,124,829,4584
4,401,295,163,859,4584
5,416,324,179,919,4584
6,414,341,215,970,4584
7,399,361,238,998,4584
8,387,364,259,1010,4584
9,374,380,281,1035,4584
10,382,375,284,1041,4584
11,412,397,298,1107,4584
1,500,200,50,750,4585
2,453,231,99,783,4585
3,422,251,141,814,4585
4,424,300,156,880,4585
5,426,301,183,910,4585
6,428,331,209,968,4585
7,429,334,218,981,4585
8,410,355,229,994,4585
9,396,381,252,1029,4585
10,382,406,278,1066,4585
11,397,407,281,1085,4585
1,500,200,50,750,4586
2,463,225,96,784,4586
3,433,265,130,828,4586
4,437,288,164,889,4586
5,410,300,188,898,4586
6,405,318,211,934,4586
7,410,338,245,993,4586
8,417,358,238,1013,4586
9,414,400,231,1045,4586
10,410,409,246,1065,4586
11,394,423,259,1076,4586
1,500,200,50,750,4587
2,446,257,79,782,4587
3,427,279,120,826,4587
4,403,306,150,859,4587
5,417,326,164,907,4587
6,418,353,180,951,4587
7,405,368,198,971,4587
8,411,372,230,1013,4587
9,402,374,252,1028,4587
10,400,386,279,1065,4587
11,379,413,281,1073,4587
1,500,200,50,750,4588
2,465,237,88,790,4588
3,448,252,123,823,4588
4,455,295,138,888,4588
5,445,304,166,915,4588
6,452,307,204,963,4588
7,436,324,227,987,4588
8,436,329,251,1016,4588
9,418,370,237,1025,4588
10,414,375,252,1041,4588
11,438,409,234,1081,4588
1,500,200,50,750,4589
2,463,223,102,788,4589
3,441,249,145,835,4589
4,409,287,170,866,4589
5,409,311,182,902,4589
6,410,347,191,948,4589
7,405,348,223,976,4589
8,406,354,237,997,4589
9,384,355,278,1017,4589
10,388,379,278,1045,4589
11,401,396,280,1077,4589
1,500,200,50,750,4590
2,452,241,96,789,4590
3,431,257,146,834,4590
4,425,282,172,879,4590
5,403,299,210,912,4590
6,412,318,215,945,4590
7,404,343,226,973,4590
8,404,376,222,1002,4590
9,409,383,243,1035,4590
10,403,391,270,1064,4590
11,395,407,277,1079,4590
1,500,200,50,750,4591
2,477,219,95,791,4591
3,439,253,130,822,4591
4,423,281,157,861,4591
5,402,318,184,904,4591
6,426,334,215,975,4591
7,396,362,226,984,4591
8,378,361,253,992,4591
9,381,410,251,1042,4591
10,375,390,290,1055,4591
11,373,410,288,1071,4591
1,500,200,50,750,4592
2,461,222,104,787,4592
3,436,243,148,827,4592
4,426,278,164,868,4592
5,422,294,183,899,4592
6,425,344,194,963,4592
7,397,340,229,966,4592
8,408,363,251,1022,4592
9,412,370,251,1033,4592
10,421,382,256,1059,4592
11,425,404,262,1091,4592
1,500,200,50,750,4593
2,454,221,109,784,4593
3,435,270,122,827,4593
4,430,281,145,856,4593
5,418,307,179,904,4593
6,437,329,205,971,4593
7,415,343,223,981,4593
8,405,377,231,1013,4593
9,412,375,246,1033,4593
10,425,422,223,1070,4593
11,395,444,247,1086,4593
1,500,200,50,750,4594
2,464,236,99,799,4594
3,441,254,138,833,4594
4,420,291,159,870,4594
5,404,321,184,909,4594
6,407,330,214,951,4594
7,411,350,229,990,4594
8,400,359,247,1006,4594
9,408,377,255,1040,4594
10,401,405,265,1071,4594
11,394,398,288,1080,4594
1,500,200,50,750,4595
2,453,228,94,775,4595
3,423,259,151,833,4595
4,404,274,182,860,4595
5,390,313,204,907,4595
6,390,347,207,944,4595
7,393,385,215,993,4595
8,401,362,243,1006,4595
9,392,384,244,1020,4595
10,393,392,270,1055,4595
11,397,422,277,1096,4595
1,500,200,50,750,4596
2,451,227,94,772,4596
3,432,270,129,831,4596
4,414,277,171,862,4596
5,398,301,212,911,4596
6,411,328,228,967,4596
7,399,357,225,981,4596
8,392,366,255,1013,4596
9,389,394,248,1031,4596
10,391,406,261,1058,4596
11,386,398,292,1076,4596
1,500,200,50,750,4597
2,468,227,97,792,4597
3,453,247,133,833,4597
4,419,262,175,856,4597
5,415,302,197,914,4597
6,410,342,195,947,4597
7,379,379,210,968,4597
8,396,410,214,1020,4597
9,381,373,269,1023,4597
10,377,400,273,1050,4597
11,401,402,265,1068,4597
1,500,200,50,750,4598
2,445,238,95,778,4598
3,431,261,138,830,4598
4,415,276,169,860,4598
5,399,314,200,913,4598
6,384,316,245,945,4598
7,396,344,248,988,4598
8,394,363,255,1012,4598
9,399,360,270,1029,4598
10,392,395,279,1066,4598
11,389,396,279,1064,4598
1,500,200,50,750,4599
2,450,232,95,777,4599
3,433,269,124,826,4599
4,418,308,156,882,4599
5,397,313,192,902,4599
6,407,336,222,965,4599
7,399,358,230,987,4599
8,389,391,230,1010,4599
9,382,416,247,1045,4599
10,390,412,258,1060,4599
11,391,404,278,1073,4599
1,500,200,50,750,4600
2,452,246,92,790,4600
3,421,274,139,834,4600
4,414,278,170,862,4600
5,422,291,201,914,4600
6,390,325,229,944,4600
7,388,360,227,975,4600
8,399,365,228,992,4600
9,404,366,270,1040,4600
10,382,422,269,1073,4600
11,364,427,272,1063,4600
1,500,200,50,750,4601
2,436,251,90,777,4601
3,411,280,133,824,4601
4,398,305,155,858,4601
5,383,331,190,904,4601
6,401,353,206,960,4601
7,387,363,231,981,4601
8,383,395,228,1006,4601
9,398,423,230,1051,4601
10,414,405,254,1073,4601
11,369,422,273,1064,4601
1,500,200,50,750,4602
2,459,238,98,795,4602
3,425,271,141,837,4602
4,401,291,166,858,4602
5,403,315,192,910,4602
6,433,335,202,970,4602
7,411,359,208,978,4602
8,408,381,219,1008,4602
9,400,375,265,1040,4602
10,398,395,275,1068,4602
11,411,424,270,1105,4602
1,500,200,50,750,4603
2,454,225,108,787,4603
3,438,263,136,837,4603
4,397,291,165,853,4603
5,389,327,188,904,4603
6,388,346,220,954,4603
7,377,355,248,980,4603
8,375,370,263,1008,4603
9,359,395,271,1025,4603
10,385,420,266,1071,4603
11,385,429,268,1082,4603
1,500,200,50,750,4604
2,452,240,91,783,4604
3,427,278,115,820,4604
4,423,295,149,867,4604
5,405,328,175,908,4604
6,409,346,205,960,4604
7,416,348,203,967,4604
8,401,371,230,1002,4604
9,408,381,240,1029,4604
10,413,394,253,1060,4604
11,395,396,289,1080,4604
1,500,200,50,750,4605
2,454,230,104,788,4605
3,423,254,149,826,4605
4,412,279,174,865,4605
5,424,294,200,918,4605
6,423,325,205,953,4605
7,409,323,219,951,4605
8,411,364,247,1022,4605
9,385,385,267,1037,4605
10,398,387,289,1074,4605
11,390,421,272,1083,4605
1,500,200,50,750,4606
2,446,245,91,782,4606
3,426,266,140,832,4606
4,396,291,187,874,4606
5,377,336,198,911,4606
6,386,328,227,941,4606
7,396,346,238,980,4606
8,396,361,247,1004,4606
9,415,378,254,1047,4606
10,420,380,267,1067,4606
11,397,392,285,1074,4606
1,500,200,50,750,4607
2,456,244,86,786,4607
3,427,269,122,818,4607
4,416,290,162,868,4607
5,394,322,188,904,4607
6,395,343,233,971,4607
7,383,350,248,981,4607
8,388,359,257,1004,4607
9,404,349,275,1028,4607
10,407,386,278,1071,4607
11,401,399,269,1069,4607
1,500,200,50,750,4608
2,446,221,109,776,4608
3,415,259,137,811,4608
4,409,298,164,871,4608
5,415,311,190,916,4608
6,410,332,202,944,4608
7,410,338,237,985,4608
8,390,358,250,998,4608
9,396,358,266,1020,4608
10,410,383,274,1067,4608
11,396,409,289,1094,4608
1,500,200,50,750,4609
2,466,228,109,803,4609
3,420,265,142,827,4609
4,394,299,161,854,4609
5,389,335,173,897,4609
6,405,360,198,963,4609
7,374,378,217,969,4609
8,389,373,237,999,4609
9,390,377,265,1032,4609
10,393,369,283,1045,4609
11,395,386,284,1065,4609
1,500,200,50,750,4610
2,458,247,87,792,4610
3,403,285,142,830,4610
4,376,325,165,866,4610
5,382,341,198,921,4610
6,376,348,222,946,4610
7,394,361,232,987,4610
8,397,378,251,1026,4610
9,405,393,245,1043,4610
10,392,381,283,1056,4610
11,380,419,279,1078,4610
1,500,200,50,750,4611
2,468,205,122,795,4611
3,435,235,157,827,4611
4,405,266,182,853,4611
5,419,301,182,902,4611
6,406,334,207,947,4611
7,398,344,240,982,4611
8,405,364,253,1022,4611
9,378,389,257,1024,4611
10,397,403,268,1068,4611
11,403,391,288,1082,4611
1,500,200,50,750,4612
2,447,221,110,778,4612
3,422,249,154,825,4612
4,416,288,167,871,4612
5,419,315,177,911,4612
6,410,343,208,961,4612
7,403,353,212,968,4612
8,428,392,211,1031,4612
9,406,394,225,1025,4612
10,410,396,267,1073,4612
11,396,400,282,1078,4612
1,500,200,50,750,4613
2,469,226,105,800,4613
3,420,263,141,824,4613
4,416,288,177,881,4613
5,396,323,193,912,4613
6,411,338,209,958,4613
7,414,333,224,971,4613
8,402,378,231,1011,4613
9,397,371,272,1040,4613
10,397,387,261,1045,4613
11,415,399,272,1086,4613
1,500,200,50,750,4614
2,444,242,105,791,4614
3,426,269,140,835,4614
4,413,290,163,866,4614
5,396,320,191,907,4614
6,402,359,207,968,4614
7,379,367,236,982,4614
8,379,399,236,1014,4614
9,373,386,255,1014,4614
10,386,408,266,1060,4614
11,362,428,284,1074,4614
1,500,200,50,750,4615
2,439,245,98,782,4615
3,411,274,146,831,4615
4,389,299,174,862,4615
5,386,301,198,885,4615
6,419,323,204,946,4615
7,425,348,225,998,4615
8,403,368,242,1013,4615
9,391,380,259,1030,4615
10,393,385,288,1066,4615
11,416,385,304,1105,4615
1,500,200,50,750,4616
2,458,214,100,772,4616
3,435,264,124,823,4616
4,411,290,163,864,4616
5,409,317,188,914,4616
6,403,326,227,956,4616
7,413,333,247,993,4616
8,405,346,259,1010,4616
9,411,358,257,1026,4616
10,432,381,273,1086,4616
11,412,405,270,1087,4616
1,500,200,50,750,4617
2,447,233,98,778,4617
3,428,271,119,818,4617
4,410,300,161,871,4617
5,391,315,195,901,4617
6,405,331,196,932,4617
7,419,346,233,998,4617
8,400,362,233,995,4617
9,422,374,266,1062,4617
10,418,397,253,1068,4617
11,401,401,265,1067,4617
1,500,200,50,750,4618
2,457,224,108,789,4618
3,422,251,148,821,4618
4,401,275,181,857,4618
5,402,296,198,896,4618
6,433,309,225,967,4618
7,405,326,230,961,4618
8,410,347,239,996,4618
9,400,378,257,1035,4618
10,391,391,271,1053,4618
11,415,397,270,1082,4618
1,500,200,50,750,4619
2,453,245,87,785,4619
3,432,265,128,825,4619
4,428,302,165,895,4619
5,411,310,192,913,4619
6,415,324,215,954,4619
7,430,348,218,996,4619
8,420,355,237,1012,4619
9,399,369,269,1037,4619
10,403,391,273,1067,4619
11,365,402,297,1064,4619
1,500,200,50,750,4620
2,473,223,94,790,4620
3,415,267,142,824,4620
4,381,321,164,866,4620
5,381,333,184,898,4620
6,394,374,192,960,4620
7,385,386,210,981,4620
8,376,409,210,995,4620
9,394,398,244,1036,4620
10,379,421,257,1057,4620
11,368,444,262,1074,4620
1,500,200,50,750,4621
2,466,216,98,780,4621
3,423,251,132,806,4621
4,435,271,174,880,4621
5,409,307,186,902,4621
6,408,353,207,968,4621
7,392,374,214,980,4621
8,396,347,253,996,4621
9,390,365,266,1021,4621
10,395,360,293,1048,4621
11,409,404,282,1095,4621
1,500,200,50,750,4622
2,482,219,105,806,4622
3,444,244,141,829,4622
4,436,287,168,891,4622
5,408,318,182,908,4622
6,399,340,194,933,4622
7,404,358,224,986,4622
8,403,389,225,1017,4622
9,402,399,243,1044,4622
10,404,415,244,1063,4622
11,413,416,251,1080,4622
1,500,200,50,750,4623
2,470,224,86,780,4623
3,448,253,128,829,4623
4,423,305,141,869,4623
5,408,316,180,904,4623
6,418,329,218,965,4623
7,401,362,210,973,4623
8,396,374,221,991,4623
9,400,381,245,1026,4623
10,426,396,247,1069,4623
11,396,409,270,1075,4623
1,500,200,50,750,4624
2,453,250,91,794,4624
3,437,258,142,837,4624
4,405,272,177,854,4624
5,403,316,188,907,4624
6,400,338,209,947,4624
7,402,345,241,988,4624
8,400,359,250,1009,4624
9,392,384,244,1020,4624
10,400,397,272,1069,4624
11,380,401,281,1062,4624
1,500,200,50,750,4625
2,454,216,106,776,4625
3,425,253,144,822,4625
4,401,288,177,866,4625
5,414,321,193,928,4625
6,412,326,211,949,4625
7,399,362,224,985,4625
8,418,361,229,1008,4625
9,406,360,262,1028,4625
10,408,400,249,1057,4625
11,427,401,258,1086,4625
1,500,200,50,750,4626
2,467,222,106,795,4626
3,421,259,142,822,4626
4,384,320,164,868,4626
5,373,346,196,915,4626
6,399,348,216,963,4626
7,383,385,217,985,4626
8,382,383,239,1004,4626
9,395,394,252,1041,4626
10,400,381,267,1048,4626
11,401,420,260,1081,4626
1,500,200,50,750,4627
2,451,220,106,777,4627
3,434,254,138,826,4627
4,406,298,157,861,4627
5,404,314,193,911,4627
6,400,320,225,945,4627
7,385,357,238,980,4627
8,397,336,270,1003,4627
9,383,367,265,1015,4627
10,375,408,267,1050,4627
11,387,418,266,1071,4627
1,500,200,50,750,4628
2,456,229,103,788,4628
3,423,277,141,841,4628
4,402,297,165,864,4628
5,394,333,194,921,4628
6,408,362,201,971,4628
7,390,359,216,965,4628
8,405,365,239,1009,4628
9,392,375,257,1024,4628
10,404,368,271,1043,4628
11,391,393,286,1070,4628
1,500,200,50,750,4629
2,464,229,99,792,4629
3,433,259,127,819,4629
4,435,281,153,869,4629
5,421,292,187,900,4629
6,420,324,211,955,4629
7,433,350,225,1008,4629
8,411,346,236,993,4629
9,429,341,264,1034,4629
10,416,376,259,1051,4629
11,430,401,253,1084,4629
1,500,200,50,750,4630
2,479,232,85,796,4630
3,443,258,119,820,4630
4,452,290,140,882,4630
5,431,308,191,930,4630
6,434,316,202,952,4630
7,422,356,226,1004,4630
8,415,344,240,999,4630
9,400,392,239,1031,4630
10,386,422,254,1062,4630
11,411,416,267,1094,4630
1,500,200,50,750,4631
2,464,215,105,784,4631
3,413,255,150,818,4631
4,409,292,164,865,4631
5,380,342,173,895,4631
6,396,347,200,943,4631
7,397,359,212,968,4631
8,412,381,233,1026,4631
9,411,381,239,1031,4631
10,415,371,273,1059,4631
11,416,396,269,1081,4631
1,500,200,50,750,4632
2,469,239,87,795,4632
3,437,261,143,841,4632
4,397,299,176,872,4632
5,379,315,202,896,4632
6,387,356,207,950,4632
7,395,352,234,981,4632
8,385,371,253,1009,4632
9,388,386,257,1031,4632
10,381,411,264,1056,4632
11,381,409,294,1084,4632
1,500,200,50,750,4633
2,467,222,103,792,4633
3,421,294,130,845,4633
4,398,308,154,860,4633
5,398,329,180,907,4633
6,427,318,215,960,4633
7,422,323,244,989,4633
8,411,348,252,1011,4633
9,407,347,266,1020,4633
10,401,367,276,1044,4633
11,428,372,287,1087,4633
1,500,200,50,750,4634
2,454,231,100,785,4634
3,440,267,125,832,4634
4,422,285,152,859,4634
5,407,323,178,908,4634
6,412,338,216,966,4634
7,412,330,244,986,4634
8,416,342,258,1016,4634
9,405,352,276,1033,4634
10,421,388,251,1060,4634
11,417,396,262,1075,4634
1,500,200,50,750,4635
2,473,227,96,796,4635
3,427,258,138,823,4635
4,420,286,173,879,4635
5,385,333,188,906,4635
6,403,342,220,965,4635
7,379,350,243,972,4635
8,385,382,257,1024,4635
9,385,402,255,1042,4635
10,385,417,266,1068,4635
11,383,435,268,1086,4635
1,500,200,50,750,4636
2,467,232,87,786,4636
3,443,243,134,820,4636
4,438,277,158,873,4636
5,415,310,192,917,4636
6,408,317,224,949,4636
7,392,328,254,974,4636
8,418,341,253,1012,4636
9,428,350,241,1019,4636
10,432,359,266,1057,4636
11,440,366,267,1073,4636
1,500,200,50,750,4637
2,457,231,108,796,4637
3,422,257,140,819,4637
4,410,279,178,867,4637
5,410,305,199,914,4637
6,416,316,215,947,4637
7,405,349,233,987,4637
8,407,375,233,1015,4637
9,380,389,255,1024,4637
10,402,394,266,1062,4637
11,428,385,283,1096,4637
1,500,200,50,750,4638
2,475,225,87,787,4638
3,451,255,108,814,4638
4,455,295,137,887,4638
5,413,320,188,921,4638
6,412,327,224,963,4638
7,394,347,225,966,4638
8,404,361,241,1006,4638
9,419,362,249,1030,4638
10,404,380,274,1058,4638
11,386,411,275,1072,4638
1,500,200,50,750,4639
2,451,226,107,784,4639
3,433,251,152,836,4639
4,416,260,185,861,4639
5,412,296,205,913,4639
6,394,337,197,928,4639
7,400,348,228,976,4639
8,403,354,252,1009,4639
9,397,378,259,1034,4639
10,408,394,269,1071,4639
11,367,425,285,1077,4639
1,500,200,50,750,4640
2,453,231,108,792,4640
3,437,271,130,838,4640
4,406,280,169,855,4640
5,428,304,187,919,4640
6,430,316,212,958,4640
7,413,337,230,980,4640
8,399,359,245,1003,4640
9,380,385,259,1024,4640
10,399,395,265,1059,4640
11,393,412,275,1080,4640
1,500,200,50,750,4641
2,443,248,93,784,4641
3,422,269,147,838,4641
4,384,289,190,863,4641
5,391,330,195,916,4641
6,400,351,199,950,4641
7,414,362,224,1000,4641
8,393,368,245,1006,4641
9,380,385,255,1020,4641
10,414,395,260,1069,4641
11,383,407,285,1075,4641
1,500,200,50,750,4642
2,469,234,78,781,4642
3,449,276,115,840,4642
4,416,308,149,873,4642
5,383,319,191,893,4642
6,391,347,219,957,4642
7,393,361,232,986,4642
8,398,358,257,1013,4642
9,381,388,261,1030,4642
10,381,413,275,1069,4642
11,377,423,283,1083,4642
1,500,200,50,750,4643
2,461,236,97,794,4643
3,436,265,122,823,4643
4,418,292,160,870,4643
5,422,317,171,910,4643
6,419,338,192,949,4643
7,403,359,225,987,4643
8,407,362,241,1010,4643
9,414,374,241,1029,4643
10,426,389,241,1056,4643
11,412,407,238,1057,4643
1,500,200,50,750,4644
2,460,230,97,787,4644
3,436,248,139,823,4644
4,426,278,167,871,4644
5,408,304,190,902,4644
6,419,324,224,967,4644
7,407,345,221,973,4644
8,420,360,235,1015,4644
9,411,381,243,1035,4644
10,418,395,243,1056,4644
11,410,414,265,1089,4644
1,500,200,50,750,4645
2,451,245,97,793,4645
3,413,271,133,817,4645
4,414,297,166,877,4645
5,411,312,192,915,4645
6,426,347,210,983,4645
7,404,343,232,979,4645
8,396,359,249,1004,4645
9,399,374,251,1024,4645
10,405,386,269,1060,4645
11,423,412,260,1095,4645
1,500,200,50,750,4646
2,452,230,97,779,4646
3,439,255,120,814,4646
4,438,293,141,872,4646
5,437,296,185,918,4646
6,421,307,214,942,4646
7,410,319,246,975,4646
8,420,332,250,1002,4646
9,435,346,242,1023,4646
10,435,383,238,1056,4646
11,409,384,280,1073,4646
1,500,200,50,750,4647
2,458,233,106,797,4647
3,424,256,143,823,4647
4,398,276,183,857,4647
5,399,321,211,931,4647
6,388,345,221,954,4647
7,403,345,229,977,4647
8,394,374,235,1003,4647
9,412,361,258,1031,4647
10,403,389,258,1050,4647
11,412,384,279,1075,4647
1,500,200,50,750,4648
2,445,233,90,768,4648
3,444,279,115,838,4648
4,425,282,159,866,4648
5,419,323,186,928,4648
6,406,334,214,954,4648
7,407,319,257,983,4648
8,389,334,275,998,4648
9,411,374,267,1052,4648
10,421,365,269,1055,4648
11,422,379,287,1088,4648
1,500,200,50,750,4649
2,459,246,93,798,4649
3,435,237,142,814,4649
4,429,277,178,884,4649
5,404,317,199,920,4649
6,414,341,220,975,4649
7,407,360,221,988,4649
8,415,378,224,1017,4649
9,402,377,256,1035,4649
10,402,383,268,1053,4649
11,397,419,258,1074,4649
1,500,200,50,750,4650
2,461,238,90,789,4650
3,416,265,141,822,4650
4,410,283,177,870,4650
5,392,328,200,920,4650
6,388,342,235,965,4650
7,388,334,251,973,4650
8,393,362,242,997,4650
9,383,381,248,1012,4650
10,406,409,255,1070,4650
11,378,413,281,1072,4650
1,500,200,50,750,4651
2,461,218,99,778,4651
3,438,264,134,836,4651
4,402,303,156,861,4651
5,386,326,190,902,4651
6,419,350,215,984,4651
7,401,339,232,972,4651
8,400,365,242,1007,4651
9,415,369,260,1044,4651
10,395,396,256,1047,4651
11,393,407,279,1079,4651
1,500,200,50,750,4652
2,454,228,107,789,4652
3,420,243,160,823,4652
4,406,294,177,877,4652
5,416,296,206,918,4652
6,412,319,216,947,4652
7,389,353,222,964,4652
8,408,365,252,1025,4652
9,382,377,273,1032,4652
10,387,417,265,1069,4652
11,408,393,277,1078,4652
1,500,200,50,750,4653
2,470,216,106,792,4653
3,433,254,144,831,4653
4,405,290,169,864,4653
5,416,317,210,943,4653
6,390,328,226,944,4653
7,396,343,245,984,4653
8,377,369,271,1017,4653
9,379,389,268,1036,4653
10,388,384,284,1056,4653
11,394,434,264,1092,4653
1,500,200,50,750,4654
2,452,261,87,800,4654
3,413,292,128,833,4654
4,403,301,162,866,4654
5,408,305,194,907,4654
6,417,340,193,950,4654
7,406,353,222,981,4654
8,410,347,246,1003,4654
9,415,376,245,1036,4654
10,415,391,258,1064,4654
11,414,400,260,1074,4654
1,500,200,50,750,4655
2,464,225,101,790,4655
3,435,266,136,837,4655
4,399,291,172,862,4655
5,376,314,205,895,4655
6,398,319,230,947,4655
7,416,331,243,990,4655
8,398,339,271,1008,4655
9,425,331,278,1034,4655
10,410,379,273,1062,4655
11,406,395,281,1082,4655
1,500,200,50,750,4656
2,458,226,93,777,4656
3,457,253,129,839,4656
4,439,292,148,879,4656
5,428,317,181,926,4656
6,426,317,208,951,4656
7,394,369,209,972,4656
8,391,388,230,1009,4656
9,399,374,246,1019,4656
10,404,398,239,1041,4656
11,402,402,273,1077,4656
1,500,200,50,750,4657
2,454,232,100,786,4657
3,426,254,125,805,4657
4,440,277,154,871,4657
5,429,302,178,909,4657
6,434,332,203,969,4657
7,406,351,227,984,4657
8,406,342,244,992,4657
9,409,372,256,1037,4657
10,419,372,277,1068,4657
11,419,383,278,1080,4657
1,500,200,50,750,4658
2,456,241,96,793,4658
3,444,256,126,826,4658
4,420,287,164,871,4658
5,397,332,183,912,4658
6,404,358,214,976,4658
7,377,364,241,982,4658
8,359,393,235,987,4658
9,387,422,234,1043,4658
10,368,397,280,1045,4658
11,373,397,313,1083,4658
1,500,200,50,750,4659
2,457,245,94,796,4659
3,432,283,119,834,4659
4,432,311,145,888,4659
5,420,319,171,910,4659
6,406,359,195,960,4659
7,388,377,219,984,4659
8,371,409,235,1015,4659
9,362,416,259,1037,4659
10,365,427,279,1071,4659
11,379,406,297,1082,4659
1,500,200,50,750,4660
2,463,248,80,791,4660
3,423,275,121,819,4660
4,425,290,164,879,4660
5,415,343,166,924,4660
6,377,368,197,942,4660
7,392,383,215,990,4660
8,389,380,239,1008,4660
9,371,413,242,1026,4660
10,384,425,252,1061,4660
11,387,400,281,1068,4660
1,500,200,50,750,4661
2,461,236,95,792,4661
3,421,264,142,827,4661
4,395,294,172,861,4661
5,385,308,207,900,4661
6,412,345,215,972,4661
7,397,336,249,982,4661
8,383,359,251,993,4661
9,394,383,251,1028,4661
10,400,413,253,1066,4661
11,392,412,279,1083,4661
1,500,200,50,750,4662
2,477,234,82,793,4662
3,443,271,112,826,4662
4,421,290,151,862,4662
5,406,319,181,906,4662
6,442,312,213,967,4662
7,415,330,246,991,4662
8,399,364,253,1016,4662
9,402,356,258,1016,4662
10,436,361,256,1053,4662
11,434,380,264,1078,4662
1,500,200,50,750,4663
2,474,222,113,809,4663
3,422,255,145,822,4663
4,406,275,174,855,4663
5,424,292,188,904,4663
6,431,330,192,953,4663
7,414,362,198,974,4663
8,412,358,203,973,4663
9,440,372,221,1033,4663
10,425,393,228,1046,4663
11,459,386,241,1086,4663
1,500,200,50,750,4664
2,447,242,95,784,4664
3,417,280,127,824,4664
4,387,307,164,858,4664
5,403,329,176,908,4664
6,390,358,206,954,4664
7,380,370,219,969,4664
8,388,371,253,1012,4664
9,420,365,261,1046,4664
10,413,385,264,1062,4664
11,398,406,282,1086,4664
1,500,200,50,750,4665
2,463,224,101,788,4665
3,429,246,143,818,4665
4,427,279,164,870,4665
5,422,308,185,915,4665
6,430,337,186,953,4665
7,413,337,221,971,4665
8,399,354,230,983,4665
9,407,385,237,1029,4665
10,392,414,251,1057,4665
11,392,406,285,1083,4665
1,500,200,50,750,4666
2,490,217,96,803,4666
3,460,243,127,830,4666
4,436,291,150,877,4666
5,435,295,189,919,4666
6,431,330,213,974,4666
7,411,369,201,981,4666
8,398,369,246,1013,4666
9,384,405,248,1037,4666
10,387,407,262,1056,4666
11,406,430,249,1085,4666
1,500,200,50,750,4667
2,451,226,100,777,4667
3,442,252,148,842,4667
4,410,282,170,862,4667
5,389,302,206,897,4667
6,410,345,222,977,4667
7,384,356,229,969,4667
8,397,372,249,1018,4667
9,385,409,249,1043,4667
10,362,419,264,1045,4667
11,381,462,258,1101,4667
1,500,200,50,750,4668
2,454,236,106,796,4668
3,415,270,136,821,4668
4,419,280,162,861,4668
5,402,314,173,889,4668
6,397,344,202,943,4668
7,410,347,210,967,4668
8,427,347,229,1003,4668
9,424,366,238,1028,4668
10,415,377,266,1058,4668
11,383,401,270,1054,4668
1,500,200,50,750,4669
2,455,237,100,792,4669
3,440,243,144,827,4669
4,419,281,176,876,4669
5,409,301,200,910,4669
6,407,341,206,954,4669
7,390,369,217,976,4669
8,401,378,240,1019,4669
9,398,385,255,1038,4669
10,399,402,248,1049,4669
11,420,401,273,1094,4669
1,500,200,50,750,4670
2,453,252,91,796,4670
3,428,278,116,822,4670
4,408,316,146,870,4670
5,416,313,195,924,4670
6,425,346,203,974,4670
7,409,356,220,985,4670
8,402,388,231,1021,4670
9,372,396,258,1026,4670
10,374,408,275,1057,4670
11,377,413,273,1063,4670
1,500,200,50,750,4671
2,448,236,101,785,4671
3,421,286,135,842,4671
4,404,301,178,883,4671
5,365,339,197,901,4671
6,379,352,217,948,4671
7,413,368,218,999,4671
8,412,339,251,1002,4671
9,411,362,265,1038,4671
10,412,389,246,1047,4671
11,437,396,266,1099,4671
1,500,200,50,750,4672
2,465,231,93,789,4672
3,429,272,128,829,4672
4,396,320,149,865,4672
5,408,331,185,924,4672
6,400,331,228,959,4672
7,397,344,241,982,4672
8,398,372,235,1005,4672
9,392,361,276,1029,4672
10,385,377,291,1053,4672
11,394,411,299,1104,4672
1,500,200,50,750,4673
2,477,229,95,801,4673
3,434,270,125,829,4673
4,402,301,159,862,4673
5,398,327,189,914,4673
6,409,351,201,961,4673
7,402,357,219,978,4673
8,420,362,238,1020,4673
9,412,376,237,1025,4673
10,411,386,255,1052,4673
11,409,399,271,1079,4673
1,500,200,50,750,4674
2,447,231,108,786,4674
3,408,274,150,832,4674
4,392,305,167,864,4674
5,381,313,203,897,4674
6,379,344,221,944,4674
7,374,338,271,983,4674
8,396,339,275,1010,4674
9,396,356,282,1034,4674
10,399,390,271,1060,4674
11,399,398,280,1077,4674
1,500,200,50,750,4675
2,453,229,104,786,4675
3,432,241,151,824,4675
4,433,289,155,877,4675
5,432,327,169,928,4675
6,429,342,202,973,4675
7,406,361,222,989,4675
8,391,362,241,994,4675
9,393,390,243,1026,4675
10,389,391,278,1058,4675
11,396,414,276,1086,4675
1,500,200,50,750,4676
2,452,237,103,792,4676
3,417,266,147,830,4676
4,421,292,147,860,4676
5,413,296,179,888,4676
6,441,342,194,977,4676
7,408,353,228,989,4676
8,402,383,237,1022,4676
9,388,383,256,1027,4676
10,407,399,262,1068,4676
11,403,399,299,1101,4676
1,500,200,50,750,4677
2,454,238,94,786,4677
3,436,260,125,821,4677
4,414,264,182,860,4677
5,401,289,219,909,4677
6,414,323,233,970,4677
7,388,355,240,983,4677
8,395,378,243,1016,4677
9,413,380,241,1034,4677
10,418,387,243,1048,4677
11,412,391,251,1054,4677
1,500,200,50,750,4678
2,453,228,111,792,4678
3,422,248,141,811,4678
4,434,281,164,879,4678
5,393,326,196,915,4678
6,401,335,221,957,4678
7,388,361,227,976,4678
8,372,363,264,999,4678
9,368,380,262,1010,4678
10,390,387,274,1051,4678
11,401,408,296,1105,4678
1,500,200,50,750,4679
2,469,220,94,783,4679
3,431,269,126,826,4679
4,411,301,160,872,4679
5,405,321,181,907,4679
6,426,339,195,960,4679
7,415,347,216,978,4679
8,419,376,217,1012,4679
9,394,391,232,1017,4679
10,388,406,250,1044,4679
11,393,426,257,1076,4679
1,500,200,50,750,4680
2,458,230,95,783,4680
3,437,270,124,831,4680
4,407,301,147,855,4680
5,400,319,183,902,4680
6,386,330,215,931,4680
7,380,369,226,975,4680
8,403,355,243,1001,4680
9,404,353,258,1015,4680
10,377,386,270,1033,4680
11,396,401,284,1081,4680
1,500,200,50,750,4681
2,448,252,99,799,4681
3,409,301,118,828,4681
4,395,310,164,869,4681
5,390,310,201,901,4681
6,389,328,230,947,4681
7,390,346,236,972,4681
8,399,365,246,1010,4681
9,399,389,257,1045,4681
10,402,405,240,1047,4681
11,415,408,255,1078,4681
1,500,200,50,750,4682
2,460,214,109,783,4682
3,440,255,145,840,4682
4,413,277,165,855,4682
5,421,322,184,927,4682
6,428,324,220,972,4682
7,409,343,239,991,4682
8,380,371,242,993,4682
9,375,408,248,1031,4682
10,396,427,271,1094,4682
11,369,416,293,1078,4682
1,500,200,50,750,4683
2,457,230,105,792,4683
3,437,253,148,838,4683
4,419,292,171,882,4683
5,399,315,196,910,4683
6,398,354,225,977,4683
7,376,351,259,986,4683
8,364,393,237,994,4683
9,402,390,268,1060,4683
10,373,401,284,1058,4683
11,382,399,306,1087,4683
1,500,200,50,750,4684
2,454,215,105,774,4684
3,438,257,127,822,4684
4,439,286,152,877,4684
5,414,322,168,904,4684
6,428,348,189,965,4684
7,424,363,207,994,4684
8,422,383,203,1008,4684
9,435,397,219,1051,4684
10,420,396,230,1046,4684
11,412,430,231,1073,4684
1,500,200,50,750,4685
2,465,243,80,788,4685
3,429,264,132,825,4685
4,403,284,160,847,4685
5,426,306,179,911,4685
6,428,329,200,957,4685
7,401,353,223,977,4685
8,395,338,263,996,4685
9,419,378,254,1051,4685
10,401,380,277,1058,4685
11,411,375,288,1074,4685
1,500,200,50,750,4686
2,426,248,110,784,4686
3,418,267,131,816,4686
4,403,280,163,846,4686
5,390,318,195,903,4686
6,389,359,208,956,4686
7,376,380,208,964,4686
8,372,393,234,999,4686
9,396,381,263,1040,4686
10,390,402,266,1058,4686
11,384,405,292,1081,4686
1,500,200,50,750,4687
2,456,224,99,779,4687
3,442,263,126,831,4687
4,406,306,158,870,4687
5,392,320,193,905,4687
6,405,362,203,970,4687
7,394,364,229,987,4687
8,400,390,213,1003,4687
9,388,404,239,1031,4687
10,408,413,259,1080,4687
11,401,419,266,1086,4687
1,500,200,50,750,4688
2,468,235,95,798,4688
3,433,261,125,819,4688
4,418,296,156,870,4688
5,409,302,193,904,4688
6,431,328,201,960,4688
7,409,353,219,981,4688
8,396,382,241,1019,4688
9,380,404,257,1041,4688
10,396,427,241,1064,4688
11,379,431,276,1086,4688
1,500,200,50,750,4689
2,475,220,94,789,4689
3,442,247,143,832,4689
4,411,287,160,858,4689
5,412,308,183,903,4689
6,433,350,179,962,4689
7,416,353,210,979,4689
8,418,354,241,1013,4689
9,423,360,259,1042,4689
10,389,413,255,1057,4689
11,412,406,273,1091,4689
1,500,200,50,750,4690
2,460,212,104,776,4690
3,436,253,146,835,4690
4,400,285,168,853,4690
5,373,326,188,887,4690
6,408,357,214,979,4690
7,383,355,236,974,4690
8,391,380,233,1004,4690
9,390,378,257,1025,4690
10,393,381,291,1065,4690
11,401,406,282,1089,4690
1,500,200,50,750,4691
2,440,238,110,788,4691
3,425,270,139,834,4691
4,409,289,179,877,4691
5,400,318,197,915,4691
6,403,314,228,945,4691
7,404,331,238,973,4691
8,405,349,259,1013,4691
9,395,365,274,1034,4691
10,390,383,270,1043,4691
11,409,424,270,1103,4691
1,500,200,50,750,4692
2,475,236,91,802,4692
3,441,242,133,816,4692
4,424,281,161,866,4692
5,416,315,198,929,4692
6,405,326,214,945,4692
7,391,364,230,985,4692
8,371,400,232,1003,4692
9,374,431,233,1038,4692
10,366,429,251,1046,4692
11,382,410,294,1086,4692
1,500,200,50,750,4693
2,442,227,105,774,4693
3,411,256,149,816,4693
4,393,282,180,855,4693
5,404,314,181,899,4693
6,414,356,200,970,4693
7,391,363,235,989,4693
8,390,372,237,999,4693
9,391,384,260,1035,4693
10,396,415,249,1060,4693
11,378,423,283,1084,4693
1,500,200,50,750,4694
2,478,218,90,786,4694
3,451,242,134,827,4694
4,420,280,163,863,4694
5,419,295,185,899,4694
6,422,325,218,965,4694
7,418,324,233,975,4694
8,416,360,224,1000,4694
9,417,390,231,1038,4694
10,410,410,245,1065,4694
11,403,440,253,1096,4694
1,500,200,50,750,4695
2,452,237,91,780,4695
3,440,282,117,839,4695
4,404,291,160,855,4695
5,425,320,178,923,4695
6,420,332,202,954,4695
7,407,351,239,997,4695
8,397,346,269,1012,4695
9,409,363,263,1035,4695
10,394,369,286,1049,4695
11,402,390,274,1066,4695
1,500,200,50,750,4696
2,476,238,84,798,4696
3,428,271,127,826,4696
4,425,275,164,864,4696
5,431,303,176,910,4696
6,429,316,198,943,4696
7,420,352,215,987,4696
8,402,383,223,1008,4696
9,380,400,251,1031,4696
10,376,408,267,1051,4696
11,356,434,287,1077,4696
1,500,200,50,750,4697
2,444,250,97,791,4697
3,434,242,146,822,4697
4,419,289,163,871,4697
5,426,313,184,923,4697
6,392,322,225,939,4697
7,401,325,253,979,4697
8,388,371,244,1003,4697
9,381,407,249,1037,4697
10,385,392,269,1046,4697
11,391,397,283,1071,4697
1,500,200,50,750,4698
2,480,217,91,788,4698
3,441,241,131,813,4698
4,459,265,162,886,4698
5,421,296,201,918,4698
6,415,331,216,962,4698
7,400,340,253,993,4698
8,383,343,271,997,4698
9,378,368,287,1033,4698
10,364,400,288,1052,4698
11,369,399,296,1064,4698
1,500,200,50,750,4699
2,461,221,100,782,4699
3,437,256,135,828,4699
4,416,268,177,861,4699
5,441,285,204,930,4699
6,434,320,194,948,4699
7,413,341,233,987,4699
8,422,369,235,1026,4699
9,410,378,242,1030,4699
10,420,388,252,1060,4699
11,405,389,289,1083,4699
1,500,200,50,750,4700
2,470,219,104,793,4700
3,435,259,118,812,4700
4,420,286,168,874,4700
5,406,310,187,903,4700
6,393,353,210,956,4700
7,408,351,219,978,4700
8,404,365,221,990,4700
9,390,393,244,1027,4700
10,386,405,268,1059,4700
11,375,433,270,1078,4700
1,500,200,50,750,4701
2,459,233,93,785,4701
3,436,253,135,824,4701
4,436,277,161,874,4701
5,405,306,199,910,4701
6,409,332,220,961,4701
7,396,350,230,976,4701
8,396,359,247,1002,4701
9,400,384,235,1019,4701
10,408,414,226,1048,4701
11,418,417,249,1084,4701
1,500,200,50,750,4702
2,470,244,93,807,4702
3,432,251,150,833,4702
4,397,277,183,857,4702
5,404,324,191,919,4702
6,403,348,208,959,4702
7,397,354,239,990,4702
8,393,379,254,1026,4702
9,382,370,280,1032,4702
10,369,388,300,1057,4702
11,383,406,293,1082,4702
1,500,200,50,750,4703
2,456,240,94,790,4703
3,419,273,150,842,4703
4,406,293,173,872,4703
5,404,335,185,924,4703
6,402,352,213,967,4703
7,400,349,226,975,4703
8,386,374,242,1002,4703
9,386,385,269,1040,4703
10,386,402,273,1061,4703
11,382,398,294,1074,4703
1,500,200,50,750,4704
2,434,251,96,781,4704
3,417,290,118,825,4704
4,421,281,159,861,4704
5,435,323,182,940,4704
6,411,338,203,952,4704
7,391,355,231,977,4704
8,393,355,267,1015,4704
9,386,381,260,1027,4704
10,387,387,276,1050,4704
11,386,401,291,1078,4704
1,500,200,50,750,4705
2,457,243,88,788,4705
3,431,270,128,829,4705
4,429,277,160,866,4705
5,410,317,178,905,4705
6,409,333,213,955,4705
7,413,328,248,989,4705
8,380,346,275,1001,4705
9,374,385,267,1026,4705
10,386,406,264,1056,4705
11,384,396,296,1076,4705
1,500,200,50,750,4706
2,450,236,98,784,4706
3,415,258,148,821,4706
4,419,277,179,875,4706
5,397,298,212,907,4706
6,401,340,225,966,4706
7,389,355,234,978,4706
8,394,367,251,1012,4706
9,381,382,271,1034,4706
10,398,400,251,1049,4706
11,412,415,266,1093,4706
1,500,200,50,750,4707
2,457,230,97,784,4707
3,441,246,131,818,4707
4,439,278,148,865,4707
5,429,290,187,906,4707
6,453,322,197,972,4707
7,445,345,199,989,4707
8,436,342,219,997,4707
9,411,351,250,1012,4707
10,428,379,247,1054,4707
11,438,398,254,1090,4707
1,500,200,50,750,4708
2,481,231,94,806,4708
3,424,245,152,821,4708
4,445,260,175,880,4708
5,421,286,206,913,4708
6,419,329,212,960,4708
7,410,361,218,989,4708
8,428,367,230,1025,4708
9,397,386,249,1032,4708
10,396,402,242,1040,4708
11,403,406,260,1069,4708
1,500,200,50,750,4709
2,469,242,90,801,4709
3,447,270,133,850,4709
4,430,287,155,872,4709
5,418,320,191,929,4709
6,403,346,226,975,4709
7,403,359,226,988,4709
8,432,373,217,1022,4709
9,406,406,218,1030,4709
10,406,416,233,1055,4709
11,410,417,263,1090,4709
1,500,200,50,750,4710
2,452,217,106,775,4710
3,439,245,148,832,4710
4,418,288,174,880,4710
5,428,284,203,915,4710
6,427,320,209,956,4710
7,429,329,226,984,4710
8,420,354,240,1014,4710
9,389,391,247,1027,4710
10,417,404,250,1071,4710
11,400,408,254,1062,4710
1,500,200,50,750,4711
2,460,232,103,795,4711
3,428,259,132,819,4711
4,438,283,156,877,4711
5,398,306,178,882,4711
6,404,351,210,965,4711
7,403,365,208,976,4711
8,409,369,223,1001,4711
9,400,404,229,1033,4711
10,395,424,247,1066,4711
11,373,430,274,1077,4711
1,500,200,50,750,4712
2,448,226,106,780,4712
3,421,258,132,811,4712
4,415,310,148,873,4712
5,419,320,176,915,4712
6,419,322,214,955,4712
7,390,354,236,980,4712
8,398,387,230,1015,4712
9,395,382,251,1028,4712
10,390,412,249,1051,4712
11,387,401,283,1071,4712
1,500,200,50,750,4713
2,456,219,104,779,4713
3,429,247,152,828,4713
4,402,271,179,852,4713
5,419,299,200,918,4713
6,422,314,226,962,4713
7,396,353,231,980,4713
8,377,365,261,1003,4713
9,372,393,259,1024,4713
10,380,424,241,1045,4713
11,374,423,292,1089,4713
1,500,200,50,750,4714
2,467,225,96,788,4714
3,424,252,145,821,4714
4,392,275,177,844,4714
5,397,293,210,900,4714
6,408,330,221,959,4714
7,402,332,239,973,4714
8,385,359,252,996,4714
9,387,375,259,1021,4714
10,396,403,253,1052,4714
11,417,412,275,1104,4714
1,500,200,50,750,4715
2,462,235,89,786,4715
3,443,266,129,838,4715
4,421,290,150,861,4715
5,418,303,182,903,4715
6,442,342,205,989,4715
7,400,351,226,977,4715
8,389,354,245,988,4715
9,384,371,286,1041,4715
10,387,373,297,1057,4715
11,413,399,281,1093,4715
1,500,200,50,750,4716
2,452,232,98,782,4716
3,442,263,117,822,4716
4,439,276,145,860,4716
5,439,312,170,921,4716
6,422,332,195,949,4716
7,385,367,234,986,4716
8,400,380,245,1025,4716
9,373,395,266,1034,4716
10,389,393,288,1070,4716
11,393,413,285,1091,4716
1,500,200,50,750,4717
2,465,240,89,794,4717
3,421,257,147,825,4717
4,387,299,189,875,4717
5,387,323,203,913,4717
6,389,346,233,968,4717
7,376,345,246,967,4717
8,386,372,239,997,4717
9,393,368,271,1032,4717
10,397,381,291,1069,4717
11,399,403,291,1093,4717
1,500,200,50,750,4718
2,461,233,94,788,4718
3,423,269,135,827,4718
4,391,279,180,850,4718
5,396,328,192,916,4718
6,393,348,215,956,4718
7,366,403,220,989,4718
8,355,410,236,1001,4718
9,372,433,252,1057,4718
10,375,408,270,1053,4718
11,403,427,270,1100,4718
1,500,200,50,750,4719
2,457,225,104,786,4719
3,431,269,135,835,4719
4,397,299,158,854,4719
5,403,320,189,912,4719
6,384,352,215,951,4719
7,369,372,230,971,4719
8,365,361,270,996,4719
9,372,378,283,1033,4719
10,393,378,281,1052,4719
11,409,390,282,1081,4719
1,500,200,50,750,4720
2,451,242,103,796,4720
3,421,259,151,831,4720
4,402,298,169,869,4720
5,410,336,184,930,4720
6,440,337,205,982,4720
7,420,337,226,983,4720
8,431,353,234,1018,4720
9,403,373,248,1024,4720
10,407,372,261,1040,4720
11,410,391,298,1099,4720
1,500,200,50,750,4721
2,460,227,89,776,4721
3,434,278,123,835,4721
4,408,292,161,861,4721
5,401,320,204,925,4721
6,396,353,218,967,4721
7,371,365,241,977,4721
8,389,381,237,1007,4721
9,402,383,254,1039,4721
10,375,403,270,1048,4721
11,383,432,257,1072,4721
1,500,200,50,750,4722
2,453,238,89,780,4722
3,441,257,142,840,4722
4,438,288,165,891,4722
5,420,314,179,913,4722
6,412,330,205,947,4722
7,419,334,226,979,4722
8,427,352,217,996,4722
9,429,370,232,1031,4722
10,419,411,234,1064,4722
11,406,421,258,1085,4722
1,500,200,50,750,4723
2,465,220,92,777,4723
3,428,268,132,828,4723
4,407,301,165,873,4723
5,377,325,198,900,4723
6,381,378,202,961,4723
7,358,389,232,979,4723
8,367,393,249,1009,4723
9,383,384,261,1028,4723
10,390,398,272,1060,4723
11,401,400,284,1085,4723
1,500,200,50,750,4724
2,453,245,98,796,4724
3,425,267,132,824,4724
4,409,294,165,868,4724
5,384,337,186,907,4724
6,379,342,229,950,4724
7,395,350,231,976,4724
8,402,372,232,1006,4724
9,409,365,267,1041,4724
10,409,379,274,1062,4724
11,412,406,274,1092,4724
1,500,200,50,750,4725
2,470,214,104,788,4725
3,454,238,142,834,4725
4,441,266,166,873,4725
5,424,296,179,899,4725
6,426,320,206,952,4725
7,416,351,232,999,4725
8,401,366,244,1011,4725
9,386,382,243,1011,4725
10,411,392,269,1072,4725
11,405,394,297,1096,4725
1,500,200,50,750,4726
2,441,241,108,790,4726
3,434,250,144,828,4726
4,404,294,171,869,4726
5,402,313,199,914,4726
6,418,321,218,957,4726
7,415,329,224,968,4726
8,412,357,246,1015,4726
9,406,367,266,1039,4726
10,399,385,277,1061,4726
11,399,384,303,1086,4726
1,500,200,50,750,4727
2,463,234,95,792,4727
3,428,280,134,842,4727
4,418,277,178,873,4727
5,440,283,194,917,4727
6,433,321,213,967,4727
7,419,354,214,987,4727
8,398,362,239,999,4727
9,417,375,233,1025,4727
10,432,377,247,1056,4727
11,411,412,283,1106,4727
1,500,200,50,750,4728
2,450,237,113,800,4728
3,425,269,141,835,4728
4,418,295,161,874,4728
5,416,324,173,913,4728
6,427,331,212,970,4728
7,416,354,213,983,4728
8,411,354,241,1006,4728
9,404,378,240,1022,4728
10,404,399,257,1060,4728
11,398,402,284,1084,4728
1,500,200,50,750,4729
2,489,213,103,805,4729
3,446,238,146,830,4729
4,427,287,161,875,4729
5,427,321,175,923,4729
6,417,346,198,961,4729
7,388,371,202,961,4729
8,394,387,219,1000,4729
9,407,387,240,1034,4729
10,403,410,254,1067,4729
11,380,421,292,1093,4729
1,500,200,50,750,4730
2,433,231,117,781,4730
3,415,272,143,830,4730
4,399,284,180,863,4730
5,394,323,192,909,4730
6,394,333,222,949,4730
7,391,350,250,991,4730
8,393,366,261,1020,4730
9,373,379,274,1026,4730
10,390,384,281,1055,4730
11,375,412,301,1088,4730
1,500,200,50,750,4731
2,464,243,90,797,4731
3,444,272,114,830,4731
4,437,283,145,865,4731
5,437,316,177,930,4731
6,420,334,199,953,4731
7,427,331,227,985,4731
8,408,359,244,1011,4731
9,403,364,275,1042,4731
10,400,384,281,1065,4731
11,394,405,281,1080,4731
1,500,200,50,750,4732
2,487,220,90,797,4732
3,477,231,127,835,4732
4,446,274,154,874,4732
5,447,280,184,911,4732
6,448,300,205,953,4732
7,448,330,215,993,4732
8,432,329,242,1003,4732
9,421,345,262,1028,4732
10,420,360,274,1054,4732
11,413,388,272,1073,4732
1,500,200,50,750,4733
2,452,230,109,791,4733
3,437,229,150,816,4733
4,409,251,183,843,4733
5,392,301,212,905,4733
6,388,336,226,950,4733
7,396,351,240,987,4733
8,399,354,257,1010,4733
9,362,368,277,1007,4733
10,381,377,286,1044,4733
11,414,365,294,1073,4733
1,500,200,50,750,4734
2,455,236,97,788,4734
3,443,246,148,837,4734
4,415,287,177,879,4734
5,413,320,178,911,4734
6,407,318,221,946,4734
7,402,347,222,971,4734
8,401,334,265,1000,4734
9,405,355,271,1031,4734
10,405,377,268,1050,4734
11,390,416,278,1084,4734
1,500,200,50,750,4735
2,450,231,105,786,4735
3,421,275,130,826,4735
4,406,273,172,851,4735
5,400,290,197,887,4735
6,419,332,216,967,4735
7,410,336,236,982,4735
8,394,374,231,999,4735
9,392,375,249,1016,4735
10,387,371,276,1034,4735
11,414,383,285,1082,4735
1,500,200,50,750,4736
2,464,212,105,781,4736
3,449,249,137,835,4736
4,410,294,164,868,4736
5,408,310,188,906,4736
6,415,360,191,966,4736
7,412,360,220,992,4736
8,387,378,251,1016,4736
9,363,390,263,1016,4736
10,379,388,283,1050,4736
11,377,404,290,1071,4736
1,500,200,50,750,4737
2,437,229,114,780,4737
3,411,268,152,831,4737
4,403,307,177,887,4737
5,390,316,207,913,4737
6,398,327,238,963,4737
7,388,351,239,978,4737
8,372,370,265,1007,4737
9,384,376,270,1030,4737
10,397,388,274,1059,4737
11,382,414,277,1073,4737
1,500,200,50,750,4738
2,469,234,82,785,4738
3,462,245,119,826,4738
4,441,270,135,846,4738
5,456,275,175,906,4738
6,464,300,190,954,4738
7,425,338,213,976,4738
8,427,356,224,1007,4738
9,427,368,224,1019,4738
10,422,395,238,1055,4738
11,407,402,263,1072,4738
1,500,200,50,750,4739
2,455,234,95,784,4739
3,435,272,123,830,4739
4,415,273,166,854,4739
5,403,315,182,900,4739
6,410,351,190,951,4739
7,397,377,201,975,4739
8,396,374,236,1006,4739
9,385,372,267,1024,4739
10,401,382,269,1052,4739
11,406,385,286,1077,4739
1,500,200,50,750,4740
2,438,244,101,783,4740
3,391,280,141,812,4740
4,407,301,165,873,4740
5,392,329,180,901,4740
6,413,331,223,967,4740
7,396,348,224,968,4740
8,391,386,241,1018,4740
9,419,362,244,1025,4740
10,417,369,259,1045,4740
11,405,410,259,1074,4740
1,500,200,50,750,4741
2,447,235,102,784,4741
3,434,266,133,833,4741
4,403,295,170,868,4741
5,396,313,194,903,4741
6,393,345,216,954,4741
7,398,360,233,991,4741
8,374,351,269,994,4741
9,409,365,275,1049,4741
10,385,389,280,1054,4741
11,388,385,313,1086,4741
1,500,200,50,750,4742
2,450,243,97,790,4742
3,413,275,134,822,4742
4,378,323,171,872,4742
5,369,326,199,894,4742
6,380,356,229,965,4742
7,339,385,246,970,4742
8,367,387,244,998,4742
9,361,386,251,998,4742
10,371,411,267,1049,4742
11,416,415,258,1089,4742
1,500,200,50,750,4743
2,465,233,89,787,4743
3,439,251,136,826,4743
4,405,289,185,879,4743
5,405,312,194,911,4743
6,439,320,200,959,4743
7,415,363,208,986,4743
8,408,360,227,995,4743
9,409,378,234,1021,4743
10,380,431,235,1046,4743
11,390,410,271,1071,4743
1,500,200,50,750,4744
2,444,236,108,788,4744
3,420,253,145,818,4744
4,406,277,169,852,4744
5,394,312,193,899,4744
6,405,356,212,973,4744
7,396,346,234,976,4744
8,388,377,246,1011,4744
9,380,405,245,1030,4744
10,373,415,270,1058,4744
11,366,448,265,1079,4744
1,500,200,50,750,4745
2,453,219,107,779,4745
3,416,268,137,821,4745
4,379,303,182,864,4745
5,404,329,202,935,4745
6,385,349,214,948,4745
7,377,372,234,983,4745
8,361,399,242,1002,4745
9,349,386,277,1012,4745
10,356,405,292,1053,4745
11,373,415,287,1075,4745
1,500,200,50,750,4746
2,455,244,94,793,4746
3,422,254,145,821,4746
4,413,272,168,853,4746
5,441,281,190,912,4746
6,418,303,212,933,4746
7,424,344,227,995,4746
8,399,357,247,1003,4746
9,411,380,241,1032,4746
10,421,397,237,1055,4746
11,421,406,277,1104,4746
1,500,200,50,750,4747
2,461,242,89,792,4747
3,453,262,125,840,4747
4,436,276,162,874,4747
5,410,318,178,906,4747
6,416,350,203,969,4747
7,412,339,225,976,4747
8,411,359,230,1000,4747
9,401,368,259,1028,4747
10,396,367,270,1033,4747
11,421,395,267,1083,4747
1,500,200,50,750,4748
2,446,243,95,784,4748
3,434,265,130,829,4748
4,416,275,174,865,4748
5,401,293,217,911,4748
6,404,308,236,948,4748
7,400,338,246,984,4748
8,393,361,244,998,4748
9,395,386,256,1037,4748
10,389,409,261,1059,4748
11,402,434,250,1086,4748
1,500,200,50,750,4749
2,462,231,92,785,4749
3,443,253,128,824,4749
4,420,288,153,861,4749
5,432,321,166,919,4749
6,421,339,188,948,4749
7,413,355,220,988,4749
8,380,365,255,1000,4749
9,371,395,262,1028,4749
10,387,403,266,1056,4749
11,378,417,294,1089,4749
1,500,200,50,750,4750
2,452,221,103,776,4750
3,438,256,131,825,4750
4,414,279,168,861,4750
5,398,313,196,907,4750
6,434,322,213,969,4750
7,422,341,213,976,4750
8,410,349,233,992,4750
9,379,385,248,1012,4750
10,390,399,252,1041,4750
11,402,418,270,1090,4750
1,500,200,50,750,4751
2,452,237,93,782,4751
3,456,262,119,837,4751
4,441,299,150,890,4751
5,426,302,186,914,4751
6,424,334,214,972,4751
7,392,335,244,971,4751
8,384,370,241,995,4751
9,385,403,250,1038,4751
10,392,402,269,1063,4751
11,388,408,294,1090,4751
1,500,200,50,750,4752
2,461,242,87,790,4752
3,427,267,138,832,4752
4,388,293,168,849,4752
5,399,314,200,913,4752
6,391,372,203,966,4752
7,369,394,215,978,4752
8,360,381,247,988,4752
9,378,412,257,1047,4752
10,364,414,276,1054,4752
11,364,425,294,1083,4752
1,500,200,50,750,4753
2,453,227,101,781,4753
3,436,255,138,829,4753
4,405,280,175,860,4753
5,392,339,181,912,4753
6,379,348,227,954,4753
7,385,351,246,982,4753
8,385,356,261,1002,4753
9,398,356,262,1016,4753
10,406,393,262,1061,4753
11,403,405,262,1070,4753
1,500,200,50,750,4754
2,451,234,90,775,4754
3,412,282,121,815,4754
4,410,307,143,860,4754
5,399,338,185,922,4754
6,417,349,216,982,4754
7,401,336,247,984,4754
8,403,361,263,1027,4754
9,381,379,269,1029,4754
10,412,388,253,1053,4754
11,421,403,250,1074,4754
1,500,200,50,750,4755
2,439,230,113,782,4755
3,410,270,150,830,4755
4,396,301,174,871,4755
5,387,330,193,910,4755
6,393,339,230,962,4755
7,386,331,247,964,4755
8,394,333,271,998,4755
9,404,356,260,1020,4755
10,395,390,258,1043,4755
11,419,399,268,1086,4755
1,500,200,50,750,4756
2,457,233,107,797,4756
3,431,274,128,833,4756
4,415,310,141,866,4756
5,399,333,175,907,4756
6,397,352,203,952,4756
7,387,372,232,991,4756
8,385,364,252,1001,4756
9,379,396,261,1036,4756
10,373,419,275,1067,4756
11,371,445,257,1073,4756
1,500,200,50,750,4757
2,470,245,77,792,4757
3,425,279,126,830,4757
4,397,298,158,853,4757
5,435,320,169,924,4757
6,430,329,189,948,4757
7,411,352,210,973,4757
8,442,361,225,1028,4757
9,437,370,230,1037,4757
10,432,383,241,1056,4757
11,443,396,251,1090,4757
1,500,200,50,750,4758
2,465,230,92,787,4758
3,444,247,139,830,4758
4,413,268,173,854,4758
5,426,301,196,923,4758
6,420,336,210,966,4758
7,415,359,209,983,4758
8,415,360,237,1012,4758
9,399,384,243,1026,4758
10,400,395,259,1054,4758
11,388,403,287,1078,4758
1,500,200,50,750,4759
2,453,239,89,781,4759
3,414,259,136,809,4759
4,428,286,162,876,4759
5,397,316,191,904,4759
6,390,344,222,956,4759
7,388,364,234,986,4759
8,376,367,250,993,4759
9,381,398,245,1024,4759
10,375,409,264,1048,4759
11,355,445,281,1081,4759
1,500,200,50,750,4760
2,475,228,97,800,4760
3,445,240,136,821,4760
4,431,288,145,864,4760
5,427,311,183,921,4760
6,426,326,203,955,4760
7,420,332,235,987,4760
8,391,365,242,998,4760
9,397,390,242,1029,4760
10,382,396,260,1038,4760
11,392,412,265,1069,4760
1,500,200,50,750,4761
2,454,238,102,794,4761
3,414,254,147,815,4761
4,400,287,173,860,4761
5,405,314,192,911,4761
6,398,348,209,955,4761
7,394,365,224,983,4761
8,392,371,249,1012,4761
9,380,399,262,1041,4761
10,385,408,262,1055,4761
11,398,402,272,1072,4761
1,500,200,50,750,4762
2,455,221,118,794,4762
3,425,258,145,828,4762
4,424,275,167,866,4762
5,413,300,197,910,4762
6,416,333,221,970,4762
7,412,350,227,989,4762
8,404,348,259,1011,4762
9,401,364,257,1022,4762
10,405,403,256,1064,4762
11,392,409,270,1071,4762
1,500,200,50,750,4763
2,460,234,87,781,4763
3,455,263,118,836,4763
4,427,300,152,879,4763
5,420,324,186,930,4763
6,412,339,203,954,4763
7,390,354,245,989,4763
8,369,373,264,1006,4763
9,376,373,273,1022,4763
10,397,382,284,1063,4763
11,376,431,273,1080,4763
1,500,200,50,750,4764
2,473,223,93,789,4764
3,431,256,135,822,4764
4,427,277,163,867,4764
5,424,292,198,914,4764
6,406,318,223,947,4764
7,407,344,212,963,4764
8,408,367,237,1012,4764
9,393,370,270,1033,4764
10,399,400,284,1083,4764
11,376,416,290,1082,4764
1,500,200,50,750,4765
2,460,221,107,788,4765
3,448,261,126,835,4765
4,415,294,163,872,4765
5,425,303,189,917,4765
6,404,327,208,939,4765
7,422,344,217,983,4765
8,422,349,228,999,4765
9,435,357,238,1030,4765
10,417,362,266,1045,4765
11,408,404,254,1066,4765
1,500,200,50,750,4766
2,443,236,109,788,4766
3,414,267,142,823,4766
4,417,266,169,852,4766
5,397,296,201,894,4766
6,411,307,232,950,4766
7,418,333,244,995,4766
8,416,354,246,1016,4766
9,406,364,258,1028,4766
10,406,390,258,1054,4766
11,392,424,264,1080,4766
1,500,200,50,750,4767
2,447,222,112,781,4767
3,420,259,153,832,4767
4,423,266,181,870,4767
5,422,299,175,896,4767
6,429,334,208,971,4767
7,408,341,234,983,4767
8,413,383,230,1026,4767
9,424,366,260,1050,4767
10,389,389,278,1056,4767
11,413,402,278,1093,4767
1,500,200,50,750,4768
2,464,227,95,786,4768
3,441,250,132,823,4768
4,406,288,166,860,4768
5,417,320,182,919,4768
6,405,351,200,956,4768
7,380,370,215,965,4768
8,384,387,229,1000,4768
9,400,385,246,1031,4768
10,399,388,273,1060,4768
11,403,425,250,1078,4768
1,500,200,50,750,4769
2,453,238,99,790,4769
3,428,268,135,831,4769
4,402,299,166,867,4769
5,395,315,197,907,4769
6,415,335,219,969,4769
7,405,351,222,978,4769
8,424,356,236,1016,4769
9,420,392,221,1033,4769
10,397,403,244,1044,4769
11,394,421,282,1097,4769
1,500,200,50,750,4770
2,454,240,96,790,4770
3,436,267,124,827,4770
4,416,289,160,865,4770
5,392,329,183,904,4770
6,422,339,207,968,4770
7,370,354,230,954,4770
8,399,363,242,1004,4770
9,380,364,273,1017,4770
10,391,395,266,1052,4770
11,413,410,264,1087,4770
1,500,200,50,750,4771
2,458,223,106,787,4771
3,432,253,141,826,4771
4,417,275,180,872,4771
5,399,309,212,920,4771
6,406,316,238,960,4771
7,423,330,243,996,4771
8,409,341,247,997,4771
9,403,383,249,1035,4771
10,403,391,269,1063,4771
11,398,397,277,1072,4771
1,500,200,50,750,4772
2,473,219,91,783,4772
3,449,263,106,818,4772
4,443,285,124,852,4772
5,441,327,152,920,4772
6,407,341,190,938,4772
7,410,345,225,980,4772
8,391,373,229,993,4772
9,413,389,241,1043,4772
10,391,416,251,1058,4772
11,380,433,267,1080,4772
1,500,200,50,750,4773
2,448,250,101,799,4773
3,420,274,143,837,4773
4,396,304,172,872,4773
5,402,310,200,912,4773
6,412,320,236,968,4773
7,394,357,229,980,4773
8,375,374,247,996,4773
9,395,396,264,1055,4773
10,372,416,261,1049,4773
11,391,430,269,1090,4773
1,500,200,50,750,4774
2,447,245,89,781,4774
3,419,269,143,831,4774
4,388,308,176,872,4774
5,384,341,179,904,4774
6,386,345,216,947,4774
7,390,376,209,975,4774
8,397,400,222,1019,4774
9,370,377,263,1010,4774
10,363,386,292,1041,4774
11,373,419,280,1072,4774
1,500,200,50,750,4775
2,465,222,103,790,4775
3,440,268,135,843,4775
4,396,294,171,861,4775
5,388,326,194,908,4775
6,412,356,204,972,4775
7,400,374,211,985,4775
8,388,379,234,1001,4775
9,386,394,235,1015,4775
10,393,397,250,1040,4775
11,417,421,262,1100,4775
1,500,200,50,750,4776
2,462,225,94,781,4776
3,427,244,141,812,4776
4,410,273,165,848,4776
5,415,304,189,908,4776
6,396,359,194,949,4776
7,387,365,237,989,4776
8,371,373,266,1010,4776
9,392,371,278,1041,4776
10,396,392,287,1075,4776
11,371,429,280,1080,4776
1,500,200,50,750,4777
2,450,229,102,781,4777
3,437,271,144,852,4777
4,406,290,168,864,4777
5,403,303,193,899,4777
6,399,355,217,971,4777
7,393,351,241,985,4777
8,388,379,252,1019,4777
9,380,391,259,1030,4777
10,381,405,264,1050,4777
11,435,394,258,1087,4777
1,500,200,50,750,4778
2,471,228,104,803,4778
3,438,241,153,832,4778
4,422,272,176,870,4778
5,436,304,192,932,4778
6,413,353,204,970,4778
7,409,342,235,986,4778
8,385,349,262,996,4778
9,395,376,268,1039,4778
10,384,403,272,1059,4778
11,407,407,277,1091,4778
1,500,200,50,750,4779
2,439,237,108,784,4779
3,409,284,137,830,4779
4,379,300,171,850,4779
5,399,317,182,898,4779
6,434,328,198,960,4779
7,426,343,218,987,4779
8,407,364,234,1005,4779
9,401,364,259,1024,4779
10,425,380,265,1070,4779
11,391,425,264,1080,4779
1,500,200,50,750,4780
2,463,214,111,788,4780
3,455,245,141,841,4780
4,446,266,160,872,4780
5,427,315,181,923,4780
6,430,319,206,955,4780
7,408,346,222,976,4780
8,381,376,237,994,4780
9,362,390,260,1012,4780
10,388,420,260,1068,4780
11,376,419,288,1083,4780
1,500,200,50,750,4781
2,447,227,100,774,4781
3,421,266,142,829,4781
4,400,307,174,881,4781
5,392,304,211,907,4781
6,396,332,240,968,4781
7,379,344,252,975,4781
8,388,343,290,1021,4781
9,379,369,287,1035,4781
10,395,387,283,1065,4781
11,400,410,287,1097,4781
1,500,200,50,750,4782
2,453,233,96,782,4782
3,409,263,135,807,4782
4,405,298,163,866,4782
5,385,346,188,919,4782
6,417,345,207,969,4782
7,406,358,224,988,4782
8,390,361,243,994,4782
9,363,413,253,1029,4782
10,379,398,294,1071,4782
11,394,397,304,1095,4782
1,500,200,50,750,4783
2,455,242,92,789,4783
3,433,265,138,836,4783
4,406,301,158,865,4783
5,408,335,175,918,4783
6,400,343,201,944,4783
7,397,368,236,1001,4783
8,372,381,246,999,4783
9,388,399,246,1033,4783
10,402,384,266,1052,4783
11,401,393,279,1073,4783
1,500,200,50,750,4784
2,459,244,96,799,4784
3,426,276,125,827,4784
4,420,287,158,865,4784
5,408,307,190,905,4784
6,427,318,203,948,4784
7,431,330,239,1000,4784
8,422,344,241,1007,4784
9,426,364,252,1042,4784
10,411,364,273,1048,4784
11,409,412,253,1074,4784
1,500,200,50,750,4785
2,467,235,100,802,4785
3,437,246,142,825,4785
4,409,293,161,863,4785
5,394,310,187,891,4785
6,415,339,214,968,4785
7,371,355,234,960,4785
8,389,368,244,1001,4785
9,414,397,245,1056,4785
10,385,420,256,1061,4785
11,393,408,292,1093,4785
1,500,200,50,750,4786
2,463,235,107,805,4786
3,411,260,151,822,4786
4,415,279,178,872,4786
5,420,305,190,915,4786
6,394,331,214,939,4786
7,414,360,212,986,4786
8,403,386,238,1027,4786
9,393,386,251,1030,4786
10,368,405,270,1043,4786
11,396,396,292,1084,4786
1,500,200,50,750,4787
2,460,234,102,796,4787
3,452,274,126,852,4787
4,407,304,162,873,4787
5,399,345,180,924,4787
6,380,361,219,960,4787
7,367,361,248,976,4787
8,362,379,257,998,4787
9,370,383,261,1014,4787
10,367,399,274,1040,4787
11,393,427,268,1088,4787
1,500,200,50,750,4788
2,458,234,95,787,4788
3,444,264,119,827,4788
4,431,306,140,877,4788
5,422,317,179,918,4788
6,425,323,202,950,4788
7,407,355,222,984,4788
8,413,382,212,1007,4788
9,392,407,224,1023,4788
10,393,392,271,1056,4788
11,395,387,300,1082,4788
1,500,200,50,750,4789
2,448,256,96,800,4789
3,425,262,139,826,4789
4,416,291,157,864,4789
5,410,305,186,901,4789
6,420,347,198,965,4789
7,397,367,222,986,4789
8,387,373,248,1008,4789
9,379,383,266,1028,4789
10,387,388,289,1064,4789
11,395,390,294,1079,4789
1,500,200,50,750,4790
2,460,233,97,790,4790
3,436,249,133,818,4790
4,418,299,157,874,4790
5,398,299,200,897,4790
6,398,331,224,953,4790
7,388,356,240,984,4790
8,377,381,234,992,4790
9,368,396,266,1030,4790
10,378,392,275,1045,4790
11,381,431,270,1082,4790
1,500,200,50,750,4791
2,463,228,99,790,4791
3,428,254,150,832,4791
4,375,294,182,851,4791
5,383,320,190,893,4791
6,422,339,210,971,4791
7,410,346,236,992,4791
8,392,376,243,1011,4791
9,408,404,228,1040,4791
10,420,393,244,1057,4791
11,421,400,249,1070,4791
1,500,200,50,750,4792
2,460,219,112,791,4792
3,433,251,145,829,4792
4,416,285,157,858,4792
5,409,318,175,902,4792
6,391,360,198,949,4792
7,376,379,220,975,4792
8,389,382,223,994,4792
9,408,384,257,1049,4792
10,378,413,260,1051,4792
11,389,402,282,1073,4792
1,500,200,50,750,4793
2,481,229,87,797,4793
3,465,227,123,815,4793
4,445,271,157,873,4793
5,440,304,181,925,4793
6,436,326,206,968,4793
7,410,350,233,993,4793
8,399,366,240,1005,4793
9,401,373,253,1027,4793
10,398,395,268,1061,4793
11,384,400,296,1080,4793
1,500,200,50,750,4794
2,449,226,103,778,4794
3,422,264,143,829,4794
4,410,299,176,885,4794
5,393,335,193,921,4794
6,395,358,219,972,4794
7,370,370,234,974,4794
8,390,389,231,1010,4794
9,401,375,265,1041,4794
10,390,390,290,1070,4794
11,396,378,297,1071,4794
1,500,200,50,750,4795
2,432,232,113,777,4795
3,424,263,138,825,4795
4,386,294,174,854,4795
5,372,325,208,905,4795
6,371,341,224,936,4795
7,374,363,255,992,4795
8,379,372,247,998,4795
9,397,398,230,1025,4795
10,394,411,244,1049,4795
11,419,404,278,1101,4795
1,500,200,50,750,4796
2,452,224,108,784,4796
3,406,273,146,825,4796
4,401,305,162,868,4796
5,390,328,188,906,4796
6,409,341,204,954,4796
7,394,352,243,989,4796
8,386,363,262,1011,4796
9,389,355,288,1032,4796
10,415,377,278,1070,4796
11,400,386,282,1068,4796
1,500,200,50,750,4797
2,466,230,89,785,4797
3,448,267,119,834,4797
4,421,296,138,855,4797
5,433,319,165,917,4797
6,403,353,204,960,4797
7,396,364,228,988,4797
8,397,340,254,991,4797
9,403,350,274,1027,4797
10,415,367,281,1063,4797
11,411,421,255,1087,4797
1,500,200,50,750,4798
2,433,245,101,779,4798
3,425,272,145,842,4798
4,383,310,178,871,4798
5,400,336,192,928,4798
6,378,370,218,966,4798
7,367,365,238,970,4798
8,356,392,265,1013,4798
9,384,376,287,1047,4798
10,369,383,305,1057,4798
11,386,418,303,1107,4798
1,500,200,50,750,4799
2,439,250,96,785,4799
3,416,259,142,817,4799
4,418,289,176,883,4799
5,409,301,201,911,4799
6,398,338,209,945,4799
7,373,367,219,959,4799
8,388,372,242,1002,4799
9,403,409,236,1048,4799
10,413,397,268,1078,4799
11,391,395,286,1072,4799
1,500,200,50,750,4800
2,469,238,98,805,4800
3,423,257,139,819,4800
4,435,274,160,869,4800
5,428,318,179,925,4800
6,411,333,200,944,4800
7,409,364,195,968,4800
8,427,348,235,1010,4800
9,404,390,241,1035,4800
10,412,396,244,1052,4800
11,426,411,260,1097,4800
1,500,200,50,750,4801
2,461,227,103,791,4801
3,423,269,143,835,4801
4,381,309,167,857,4801
5,384,339,189,912,4801
6,391,341,219,951,4801
7,390,369,211,970,4801
8,422,353,229,1004,4801
9,438,359,246,1043,4801
10,412,377,265,1054,4801
11,433,395,285,1113,4801
1,500,200,50,750,4802
2,452,232,102,786,4802
3,424,273,133,830,4802
4,422,281,173,876,4802
5,391,304,213,908,4802
6,411,319,226,956,4802
7,385,367,234,986,4802
8,396,370,239,1005,4802
9,388,387,241,1016,4802
10,382,419,254,1055,4802
11,394,446,251,1091,4802
1,500,200,50,750,4803
2,439,228,100,767,4803
3,420,262,145,827,4803
4,397,298,174,869,4803
5,371,344,181,896,4803
6,385,353,210,948,4803
7,383,367,237,987,4803
8,397,394,231,1022,4803
9,390,389,250,1029,4803
10,387,415,248,1050,4803
11,394,426,265,1085,4803
1,500,200,50,750,4804
2,473,223,92,788,4804
3,435,268,112,815,4804
4,423,290,151,864,4804
5,416,318,178,912,4804
6,397,322,208,927,4804
7,402,337,233,972,4804
8,410,360,229,999,4804
9,415,392,234,1041,4804
10,392,398,261,1051,4804
11,399,415,271,1085,4804
1,500,200,50,750,4805
2,477,216,109,802,4805
3,418,270,148,836,4805
4,402,288,177,867,4805
5,393,302,199,894,4805
6,411,331,209,951,4805
7,400,352,234,986,4805
8,395,364,243,1002,4805
9,395,383,243,1021,4805
10,408,389,268,1065,4805
11,417,395,286,1098,4805
1,500,200,50,750,4806
2,444,249,106,799,4806
3,415,272,134,821,4806
4,406,286,174,866,4806
5,386,339,193,918,4806
6,399,378,206,983,4806
7,391,393,207,991,4806
8,370,395,240,1005,4806
9,381,384,267,1032,4806
10,386,391,271,1048,4806
11,391,409,279,1079,4806
1,500,200,50,750,4807
2,463,233,91,787,4807
3,417,273,141,831,4807
4,394,308,171,873,4807
5,394,312,201,907,4807
6,394,327,222,943,4807
7,402,344,242,988,4807
8,401,354,253,1008,4807
9,393,388,241,1022,4807
10,416,387,256,1059,4807
11,427,375,297,1099,4807
1,500,200,50,750,4808
2,447,243,91,781,4808
3,421,283,125,829,4808
4,407,302,159,868,4808
5,400,338,180,918,4808
6,415,356,196,967,4808
7,386,369,217,972,4808
8,395,388,241,1024,4808
9,358,392,276,1026,4808
10,372,392,282,1046,4808
11,388,405,293,1086,4808
1,500,200,50,750,4809
2,481,223,104,808,4809
3,452,249,130,831,4809
4,441,267,160,868,4809
5,422,298,187,907,4809
6,434,326,207,967,4809
7,422,341,228,991,4809
8,397,373,243,1013,4809
9,382,383,265,1030,4809
10,391,394,264,1049,4809
11,404,411,272,1087,4809
1,500,200,50,750,4810
2,455,240,107,802,4810
3,416,267,153,836,4810
4,417,298,173,888,4810
5,413,303,195,911,4810
6,429,308,248,985,4810
7,402,318,261,981,4810
8,386,348,263,997,4810
9,388,380,262,1030,4810
10,381,390,280,1051,4810
11,394,392,308,1094,4810
1,500,200,50,750,4811
2,453,252,101,806,4811
3,420,283,129,832,4811
4,398,301,169,868,4811
5,387,323,195,905,4811
6,387,361,205,953,4811
7,368,365,243,976,4811
8,366,389,246,1001,4811
9,362,405,256,1023,4811
10,387,428,255,1070,4811
11,397,434,260,1091,4811
1,500,200,50,750,4812
2,454,240,81,775,4812
3,445,259,113,817,4812
4,428,296,139,863,4812
5,428,300,201,929,4812
6,402,317,226,945,4812
7,370,381,227,978,4812
8,386,377,251,1014,4812
9,381,389,265,1035,4812
10,394,400,269,1063,4812
11,430,400,281,1111,4812
1,500,200,50,750,4813
2,455,220,112,787,4813
3,443,264,128,835,4813
4,434,287,142,863,4813
5,411,327,152,890,4813
6,408,346,196,950,4813
7,417,358,203,978,4813
8,407,339,264,1010,4813
9,390,341,295,1026,4813
10,394,381,282,1057,4813
11,389,405,277,1071,4813
1,500,200,50,750,4814
2,446,252,90,788,4814
3,422,300,114,836,4814
4,404,325,149,878,4814
5,414,324,180,918,4814
6,406,349,198,953,4814
7,403,354,209,966,4814
8,407,362,212,981,4814
9,424,372,232,1028,4814
10,408,397,254,1059,4814
11,407,437,245,1089,4814
1,500,200,50,750,4815
2,480,209,97,786,4815
3,440,248,126,814,4815
4,435,290,143,868,4815
5,434,323,175,932,4815
6,399,389,191,979,4815
7,387,391,206,984,4815
8,412,374,221,1007,4815
9,398,381,252,1031,4815
10,414,396,254,1064,4815
11,399,422,262,1083,4815
1,500,200,50,750,4816
2,455,232,101,788,4816
3,417,274,137,828,4816
4,416,292,158,866,4816
5,417,312,179,908,4816
6,401,337,199,937,4816
7,409,350,224,983,4816
8,411,367,239,1017,4816
9,408,372,242,1022,4816
10,400,409,249,1058,4816
11,415,398,283,1096,4816
1,500,200,50,750,4817
2,457,231,101,789,4817
3,441,250,141,832,4817
4,404,297,175,876,4817
5,392,325,194,911,4817
6,407,335,210,952,4817
7,411,342,238,991,4817
8,391,359,249,999,4817
9,402,355,270,1027,4817
10,406,374,263,1043,4817
11,414,387,269,1070,4817
1,500,200,50,750,4818
2,452,241,99,792,4818
3,416,268,149,833,4818
4,399,295,177,871,4818
5,398,293,216,907,4818
6,402,318,240,960,4818
7,383,354,237,974,4818
8,407,355,236,998,4818
9,407,392,241,1040,4818
10,400,400,254,1054,4818
11,410,409,271,1090,4818
1,500,200,50,750,4819
2,470,236,83,789,4819
3,456,253,126,835,4819
4,414,272,170,856,4819
5,403,322,204,929,4819
6,386,353,222,961,4819
7,387,364,233,984,4819
8,387,372,249,1008,4819
9,376,373,281,1030,4819
10,390,391,286,1067,4819
11,379,396,319,1094,4819
1,500,200,50,750,4820
2,476,226,105,807,4820
3,443,260,128,831,4820
4,412,283,162,857,4820
5,404,309,183,896,4820
6,405,353,198,956,4820
7,391,371,217,979,4820
8,401,377,232,1010,4820
9,365,386,272,1023,4820
10,418,400,260,1078,4820
11,393,419,272,1084,4820
1,500,200,50,750,4821
2,434,253,107,794,4821
3,407,272,144,823,4821
4,392,291,153,836,4821
5,406,316,179,901,4821
6,396,358,193,947,4821
7,390,366,216,972,4821
8,401,383,228,1012,4821
9,394,365,275,1034,4821
10,387,393,286,1066,4821
11,391,411,279,1081,4821
1,500,200,50,750,4822
2,451,226,98,775,4822
3,449,261,142,852,4822
4,416,275,171,862,4822
5,437,303,180,920,4822
6,428,339,198,965,4822
7,419,352,216,987,4822
8,387,366,250,1003,4822
9,406,390,240,1036,4822
10,405,386,267,1058,4822
11,401,418,266,1085,4822
1,500,200,50,750,4823
2,445,241,100,786,4823
3,426,263,146,835,4823
4,413,287,172,872,4823
5,406,302,193,901,4823
6,418,338,206,962,4823
7,400,359,222,981,4823
8,398,370,235,1003,4823
9,393,376,265,1034,4823
10,375,399,278,1052,4823
11,384,432,270,1086,4823
1,500,200,50,750,4824
2,457,227,105,789,4824
3,440,258,150,848,4824
4,403,298,169,870,4824
5,399,322,187,908,4824
6,385,339,233,957,4824
7,373,376,238,987,4824
8,388,373,251,1012,4824
9,381,391,262,1034,4824
10,386,412,262,1060,4824
11,387,391,295,1073,4824
1,500,200,50,750,4825
2,476,218,100,794,4825
3,424,255,134,813,4825
4,403,303,176,882,4825
5,393,331,194,918,4825
6,390,359,216,965,4825
7,368,373,228,969,4825
8,381,373,251,1005,4825
9,364,362,278,1004,4825
10,375,393,275,1043,4825
11,390,400,288,1078,4825
1,500,200,50,750,4826
2,449,248,94,791,4826
3,420,257,141,818,4826
4,419,294,169,882,4826
5,385,309,205,899,4826
6,400,350,212,962,4826
7,394,366,234,994,4826
8,372,385,244,1001,4826
9,382,394,263,1039,4826
10,379,417,267,1063,4826
11,378,435,277,1090,4826
1,500,200,50,750,4827
2,448,229,98,775,4827
3,435,265,135,835,4827
4,419,293,149,861,4827
5,387,323,190,900,4827
6,410,341,200,951,4827
7,418,335,223,976,4827
8,419,357,238,1014,4827
9,433,359,258,1050,4827
10,421,374,260,1055,4827
11,408,384,280,1072,4827
1,500,200,50,750,4828
2,455,242,94,791,4828
3,420,268,141,829,4828
4,419,286,160,865,4828
5,412,302,193,907,4828
6,412,349,209,970,4828
7,401,357,223,981,4828
8,394,369,243,1006,4828
9,417,367,241,1025,4828
10,428,386,249,1063,4828
11,418,429,233,1080,4828
1,500,200,50,750,4829
2,454,221,99,774,4829
3,430,271,133,834,4829
4,403,308,166,877,4829
5,385,325,205,915,4829
6,415,340,212,967,4829
7,381,364,235,980,4829
8,366,385,258,1009,4829
9,369,382,292,1043,4829
10,372,409,295,1076,4829
11,354,428,292,1074,4829
1,500,200,50,750,4830
2,459,237,100,796,4830
3,429,276,118,823,4830
4,432,296,160,888,4830
5,421,307,182,910,4830
6,431,348,208,987,4830
7,393,349,231,973,4830
8,384,352,254,990,4830
9,406,376,249,1031,4830
10,383,414,261,1058,4830
11,407,439,265,1111,4830
1,500,200,50,750,4831
2,429,244,100,773,4831
3,418,277,146,841,4831
4,380,298,177,855,4831
5,397,300,207,904,4831
6,415,324,236,975,4831
7,403,349,240,992,4831
8,386,362,244,992,4831
9,402,391,249,1042,4831
10,415,400,244,1059,4831
11,401,415,262,1078,4831
1,500,200,50,750,4832
2,450,233,97,780,4832
3,420,284,137,841,4832
4,401,294,165,860,4832
5,384,341,182,907,4832
6,371,354,225,950,4832
7,374,356,250,980,4832
8,397,370,246,1013,4832
9,384,378,259,1021,4832
10,402,400,266,1068,4832
11,404,386,288,1078,4832
1,500,200,50,750,4833
2,456,243,103,802,4833
3,431,269,141,841,4833
4,399,290,182,871,4833
5,423,299,195,917,4833
6,419,315,212,946,4833
7,440,326,234,1000,4833
8,422,351,238,1011,4833
9,419,377,227,1023,4833
10,421,368,256,1045,4833
11,427,391,276,1094,4833
1,500,200,50,750,4834
2,459,231,99,789,4834
3,443,248,136,827,4834
4,433,260,168,861,4834
5,433,307,190,930,4834
6,418,321,209,948,4834
7,407,346,227,980,4834
8,409,364,242,1015,4834
9,395,378,257,1030,4834
10,406,408,260,1074,4834
11,400,411,275,1086,4834
1,500,200,50,750,4835
2,467,226,101,794,4835
3,450,258,126,834,4835
4,435,279,160,874,4835
5,424,298,190,912,4835
6,434,339,187,960,4835
7,421,347,211,979,4835
8,419,351,224,994,4835
9,438,366,226,1030,4835
10,420,388,250,1058,4835
11,425,386,275,1086,4835
1,500,200,50,750,4836
2,465,237,91,793,4836
3,431,260,136,827,4836
4,417,271,172,860,4836
5,439,294,188,921,4836
6,446,323,196,965,4836
7,426,347,219,992,4836
8,383,385,227,995,4836
9,413,377,260,1050,4836
10,385,384,282,1051,4836
11,382,385,282,1049,4836
1,500,200,50,750,4837
2,455,233,82,770,4837
3,458,254,109,821,4837
4,438,287,145,870,4837
5,415,314,172,901,4837
6,413,330,200,943,4837
7,408,356,228,992,4837
8,390,355,250,995,4837
9,402,369,254,1025,4837
10,411,384,278,1073,4837
11,405,384,303,1092,4837
1,500,200,50,750,4838
2,440,243,105,788,4838
3,415,276,138,829,4838
4,405,303,183,891,4838
5,393,314,198,905,4838
6,392,311,236,939,4838
7,368,353,255,976,4838
8,391,364,252,1007,4838
9,401,376,270,1047,4838
10,393,385,278,1056,4838
11,386,420,290,1096,4838
1,500,200,50,750,4839
2,470,220,104,794,4839
3,431,243,143,817,4839
4,407,281,172,860,4839
5,417,302,201,920,4839
6,408,328,212,948,4839
7,411,351,224,986,4839
8,420,353,233,1006,4839
9,397,373,264,1034,4839
10,376,421,266,1063,4839
11,385,413,293,1091,4839
1,500,200,50,750,4840
2,467,225,94,786,4840
3,428,256,142,826,4840
4,425,262,165,852,4840
5,428,287,188,903,4840
6,411,323,206,940,4840
7,406,343,224,973,4840
8,407,350,260,1017,4840
9,396,374,255,1025,4840
10,405,383,267,1055,4840
11,407,392,276,1075,4840
1,500,200,50,750,4841
2,464,220,106,790,4841
3,421,255,141,817,4841
4,425,272,177,874,4841
5,388,320,191,899,4841
6,392,351,191,934,4841
7,403,356,216,975,4841
8,384,370,229,983,4841
9,394,417,217,1028,4841
10,415,390,254,1059,4841
11,409,404,265,1078,4841
1,500,200,50,750,4842
2,455,240,95,790,4842
3,440,271,124,835,4842
4,407,319,157,883,4842
5,391,347,183,921,4842
6,384,352,226,962,4842
7,379,366,238,983,4842
8,386,380,254,1020,4842
9,380,389,264,1033,4842
10,396,387,280,1063,4842
11,389,413,284,1086,4842
1,500,200,50,750,4843
2,447,249,92,788,4843
3,424,262,137,823,4843
4,410,297,153,860,4843
5,415,306,195,916,4843
6,397,370,190,957,4843
7,382,400,197,979,4843
8,405,387,213,1005,4843
9,379,397,244,1020,4843
10,406,391,265,1062,4843
11,402,395,262,1059,4843
1,500,200,50,750,4844
2,450,235,89,774,4844
3,434,259,149,842,4844
4,404,299,164,867,4844
5,389,343,180,912,4844
6,409,344,212,965,4844
7,402,357,223,982,4844
8,377,380,245,1002,4844
9,371,397,261,1029,4844
10,367,415,283,1065,4844
11,377,415,284,1076,4844
1,500,200,50,750,4845
2,481,225,93,799,4845
3,447,235,138,820,4845
4,429,271,161,861,4845
5,432,310,178,920,4845
6,412,337,212,961,4845
7,388,366,221,975,4845
8,387,358,245,990,4845
9,392,380,257,1029,4845
10,379,370,286,1035,4845
11,380,377,299,1056,4845
1,500,200,50,750,4846
2,469,236,89,794,4846
3,436,260,140,836,4846
4,396,290,175,861,4846
5,399,318,187,904,4846
6,423,313,219,955,4846
7,403,352,228,983,4846
8,379,378,240,997,4846
9,374,401,245,1020,4846
10,404,402,262,1068,4846
11,414,405,264,1083,4846
1,500,200,50,750,4847
2,471,218,95,784,4847
3,431,247,132,810,4847
4,433,286,156,875,4847
5,417,303,182,902,4847
6,419,308,206,933,4847
7,419,335,217,971,4847
8,408,367,245,1020,4847
9,418,351,259,1028,4847
10,399,369,285,1053,4847
11,405,395,273,1073,4847
1,500,200,50,750,4848
2,431,235,108,774,4848
3,447,248,149,844,4848
4,431,262,166,859,4848
5,441,305,180,926,4848
6,416,339,209,964,4848
7,409,331,243,983,4848
8,397,365,250,1012,4848
9,397,376,256,1029,4848
10,401,387,267,1055,4848
11,396,381,301,1078,4848
1,500,200,50,750,4849
2,462,225,111,798,4849
3,439,240,151,830,4849
4,423,270,167,860,4849
5,414,289,204,907,4849
6,404,319,223,946,4849
7,399,360,228,987,4849
8,386,364,252,1002,4849
9,391,396,239,1026,4849
10,378,408,248,1034,4849
11,389,436,265,1090,4849
1,500,200,50,750,4850
2,469,211,96,776,4850
3,436,247,136,819,4850
4,423,271,177,871,4850
5,413,298,193,904,4850
6,419,321,214,954,4850
7,406,343,225,974,4850
8,392,361,259,1012,4850
9,410,379,249,1038,4850
10,388,403,249,1040,4850
11,381,427,281,1089,4850
1,500,200,50,750,4851
2,483,216,102,801,4851
3,442,260,140,842,4851
4,408,287,172,867,4851
5,413,303,210,926,4851
6,421,310,221,952,4851
7,401,330,253,984,4851
8,386,356,264,1006,4851
9,410,351,286,1047,4851
10,402,380,284,1066,4851
11,383,405,284,1072,4851
1,500,200,50,750,4852
2,447,229,106,782,4852
3,429,271,127,827,4852
4,415,310,157,882,4852
5,404,308,199,911,4852
6,404,346,210,960,4852
7,396,363,218,977,4852
8,392,381,224,997,4852
9,416,399,240,1055,4852
10,395,384,268,1047,4852
11,403,403,273,1079,4852
1,500,200,50,750,4853
2,446,257,89,792,4853
3,413,263,144,820,4853
4,415,281,173,869,4853
5,403,292,212,907,4853
6,429,347,213,989,4853
7,403,358,215,976,4853
8,415,356,234,1005,4853
9,426,375,241,1042,4853
10,410,397,248,1055,4853
11,398,395,287,1080,4853
1,500,200,50,750,4854
2,444,251,85,780,4854
3,426,268,134,828,4854
4,419,292,170,881,4854
5,397,302,205,904,4854
6,397,349,214,960,4854
7,382,369,235,986,4854
8,365,389,243,997,4854
9,394,392,255,1041,4854
10,383,413,261,1057,4854
11,392,412,280,1084,4854
1,500,200,50,750,4855
2,457,230,103,790,4855
3,436,260,136,832,4855
4,422,300,158,880,4855
5,415,318,182,915,4855
6,416,344,204,964,4855
7,387,357,242,986,4855
8,377,383,246,1006,4855
9,379,384,268,1031,4855
10,390,407,276,1073,4855
11,392,409,282,1083,4855
1,500,200,50,750,4856
2,443,243,99,785,4856
3,405,287,138,830,4856
4,402,296,160,858,4856
5,407,321,187,915,4856
6,394,336,218,948,4856
7,367,385,224,976,4856
8,379,400,231,1010,4856
9,372,399,247,1018,4856
10,373,407,272,1052,4856
11,390,421,282,1093,4856
1,500,200,50,750,4857
2,455,248,82,785,4857
3,431,285,123,839,4857
4,443,294,152,889,4857
5,421,325,174,920,4857
6,416,337,205,958,4857
7,389,347,229,965,4857
8,385,366,247,998,4857
9,400,368,267,1035,4857
10,401,382,277,1060,4857
11,394,389,284,1067,4857
1,500,200,50,750,4858
2,456,247,82,785,4858
3,415,277,129,821,4858
4,403,308,154,865,4858
5,425,317,194,936,4858
6,430,307,217,954,4858
7,396,322,237,955,4858
8,438,333,243,1014,4858
9,421,347,271,1039,4858
10,393,390,267,1050,4858
11,400,396,273,1069,4858
1,500,200,50,750,4859
2,448,254,83,785,4859
3,410,288,123,821,4859
4,383,311,164,858,4859
5,401,313,195,909,4859
6,414,339,213,966,4859
7,396,372,208,976,4859
8,405,379,207,991,4859
9,409,380,229,1018,4859
10,436,380,239,1055,4859
11,429,423,237,1089,4859
1,500,200,50,750,4860
2,448,241,96,785,4860
3,430,256,138,824,4860
4,411,283,174,868,4860
5,390,326,197,913,4860
6,399,329,218,946,4860
7,412,347,227,986,4860
8,411,353,247,1011,4860
9,378,393,250,1021,4860
10,378,398,264,1040,4860
11,399,403,281,1083,4860
1,500,200,50,750,4861
2,478,222,93,793,4861
3,435,258,127,820,4861
4,417,267,172,856,4861
5,418,306,192,916,4861
6,407,327,215,949,4861
7,388,345,236,969,4861
8,386,365,254,1005,4861
9,394,379,257,1030,4861
10,401,390,276,1067,4861
11,393,397,292,1082,4861
1,500,200,50,750,4862
2,449,234,106,789,4862
3,414,267,141,822,4862
4,401,291,184,876,4862
5,387,325,205,917,4862
6,396,336,232,964,4862
7,394,349,245,988,4862
8,404,367,258,1029,4862
9,370,396,260,1026,4862
10,370,399,282,1051,4862
11,382,449,265,1096,4862
1,500,200,50,750,4863
2,449,223,115,787,4863
3,418,252,142,812,4863
4,425,275,163,863,4863
5,417,294,188,899,4863
6,407,345,206,958,4863
7,397,371,203,971,4863
8,382,406,219,1007,4863
9,378,402,266,1046,4863
10,370,423,255,1048,4863
11,381,409,291,1081,4863
1,500,200,50,750,4864
2,464,241,87,792,4864
3,424,265,134,823,4864
4,417,302,163,882,4864
5,394,307,196,897,4864
6,412,341,212,965,4864
7,399,355,235,989,4864
8,400,355,253,1008,4864
9,394,358,269,1021,4864
10,393,386,273,1052,4864
11,386,415,273,1074,4864
1,500,200,50,750,4865
2,466,241,89,796,4865
3,434,274,126,834,4865
4,423,283,165,871,4865
5,428,304,183,915,4865
6,422,336,209,967,4865
7,427,337,231,995,4865
8,396,344,258,998,4865
9,401,380,248,1029,4865
10,406,398,251,1055,4865
11,416,407,268,1091,4865
1,500,200,50,750,4866
2,440,234,99,773,4866
3,409,264,141,814,4866
4,390,310,158,858,4866
5,390,317,198,905,4866
6,411,334,218,963,4866
7,414,330,231,975,4866
8,412,371,228,1011,4866
9,392,385,247,1024,4866
10,408,411,251,1070,4866
11,396,401,274,1071,4866
1,500,200,50,750,4867
2,454,243,87,784,4867
3,438,257,139,834,4867
4,428,277,170,875,4867
5,416,276,201,893,4867
6,410,322,216,948,4867
7,409,347,227,983,4867
8,401,374,230,1005,4867
9,409,395,235,1039,4867
10,407,404,236,1047,4867
11,430,398,251,1079,4867
1,500,200,50,750,4868
2,434,237,107,778,4868
3,430,258,136,824,4868
4,426,271,156,853,4868
5,409,338,182,929,4868
6,390,349,212,951,4868
7,377,368,217,962,4868
8,399,365,250,1014,4868
9,397,363,265,1025,4868
10,419,375,260,1054,4868
11,424,405,258,1087,4868
1,500,200,50,750,4869
2,464,230,93,787,4869
3,420,252,149,821,4869
4,410,287,183,880,4869
5,407,316,196,919,4869
6,405,343,211,959,4869
7,410,361,215,986,4869
8,411,388,229,1028,4869
9,381,400,252,1033,4869
10,387,407,256,1050,4869
11,392,421,263,1076,4869
1,500,200,50,750,4870
2,445,235,102,782,4870
3,427,266,138,831,4870
4,406,290,176,872,4870
5,387,331,186,904,4870
6,389,360,203,952,4870
7,384,384,204,972,4870
8,363,379,254,996,4870
9,375,393,273,1041,4870
10,371,419,279,1069,4870
11,383,404,295,1082,4870
1,500,200,50,750,4871
2,434,237,102,773,4871
3,446,251,141,838,4871
4,430,300,164,894,4871
5,400,326,187,913,4871
6,386,349,203,938,4871
7,413,325,254,992,4871
8,422,342,240,1004,4871
9,443,365,231,1039,4871
10,429,377,255,1061,4871
11,408,418,258,1084,4871
1,500,200,50,750,4872
2,446,241,104,791,4872
3,417,262,139,818,4872
4,407,291,171,869,4872
5,401,304,184,889,4872
6,390,337,207,934,4872
7,396,345,237,978,4872
8,386,360,255,1001,4872
9,388,387,252,1027,4872
10,397,400,259,1056,4872
11,403,411,273,1087,4872
1,500,200,50,750,4873
2,466,238,90,794,4873
3,433,250,130,813,4873
4,434,286,161,881,4873
5,428,307,181,916,4873
6,437,337,206,980,4873
7,405,332,234,971,4873
8,393,367,235,995,4873
9,404,377,255,1036,4873
10,417,384,256,1057,4873
11,402,403,282,1087,4873
1,500,200,50,750,4874
2,460,216,99,775,4874
3,451,253,131,835,4874
4,437,271,162,870,4874
5,427,289,182,898,4874
6,438,304,203,945,4874
7,412,338,226,976,4874
8,424,353,224,1001,4874
9,434,383,228,1045,4874
10,410,415,242,1067,4874
11,414,415,267,1096,4874
1,500,200,50,750,4875
2,454,213,117,784,4875
3,425,235,150,810,4875
4,432,282,174,888,4875
5,426,295,189,910,4875
6,460,315,202,977,4875
7,428,354,202,984,4875
8,415,361,231,1007,4875
9,409,368,254,1031,4875
10,419,390,256,1065,4875
11,405,408,276,1089,4875
1,500,200,50,750,4876
2,462,221,106,789,4876
3,433,250,139,822,4876
4,412,277,179,868,4876
5,414,314,196,924,4876
6,410,331,209,950,4876
7,401,346,236,983,4876
8,389,352,259,1000,4876
9,387,360,279,1026,4876
10,369,389,286,1044,4876
11,380,411,301,1092,4876
1,500,200,50,750,4877
2,456,230,110,796,4877
3,407,259,157,823,4877
4,392,272,198,862,4877
5,389,314,216,919,4877
6,400,347,225,972,4877
7,386,345,234,965,4877
8,369,381,240,990,4877
9,365,379,272,1016,4877
10,382,390,283,1055,4877
11,396,408,291,1095,4877
1,500,200,50,750,4878
2,475,219,88,782,4878
3,458,252,128,838,4878
4,423,280,162,865,4878
5,422,299,192,913,4878
6,411,329,219,959,4878
7,406,364,225,995,4878
8,404,375,236,1015,4878
9,394,389,243,1026,4878
10,401,413,256,1070,4878
11,375,432,272,1079,4878
1,500,200,50,750,4879
2,443,227,108,778,4879
3,416,264,141,821,4879
4,385,295,185,865,4879
5,395,326,207,928,4879
6,413,319,217,949,4879
7,404,378,219,1001,4879
8,395,395,222,1012,4879
9,394,390,249,1033,4879
10,399,380,274,1053,4879
11,392,412,270,1074,4879
1,500,200,50,750,4880
2,462,224,111,797,4880
3,436,254,133,823,4880
4,418,292,158,868,4880
5,416,310,193,919,4880
6,403,329,213,945,4880
7,392,352,233,977,4880
8,379,380,256,1015,4880
9,389,386,262,1037,4880
10,364,383,280,1027,4880
11,393,413,273,1079,4880
1,500,200,50,750,4881
2,455,236,96,787,4881
3,426,270,130,826,4881
4,422,298,155,875,4881
5,410,307,184,901,4881
6,409,337,212,958,4881
7,407,376,200,983,4881
8,408,403,209,1020,4881
9,388,401,250,1039,4881
10,386,410,265,1061,4881
11,380,425,264,1069,4881
1,500,200,50,750,4882
2,457,235,102,794,4882
3,434,268,128,830,4882
4,401,286,165,852,4882
5,414,301,195,910,4882
6,419,344,209,972,4882
7,398,355,221,974,4882
8,404,374,227,1005,4882
9,411,391,249,1051,4882
10,392,393,264,1049,4882
11,382,413,287,1082,4882
1,500,200,50,750,4883
2,455,234,109,798,4883
3,424,267,136,827,4883
4,413,304,156,873,4883
5,391,330,203,924,4883
6,413,356,196,965,4883
7,393,352,222,967,4883
8,381,372,244,997,4883
9,380,388,250,1018,4883
10,378,390,280,1048,4883
11,394,397,279,1070,4883
1,500,200,50,750,4884
2,464,242,87,793,4884
3,401,287,146,834,4884
4,395,300,184,879,4884
5,377,310,210,897,4884
6,402,332,214,948,4884
7,384,354,235,973,4884
8,374,384,244,1002,4884
9,370,402,268,1040,4884
10,384,410,272,1066,4884
11,406,412,263,1081,4884
1,500,200,50,750,4885
2,459,239,84,782,4885
3,418,270,129,817,4885
4,392,310,158,860,4885
5,398,345,192,935,4885
6,387,369,206,962,4885
7,388,354,248,990,4885
8,355,384,268,1007,4885
9,350,385,281,1016,4885
10,390,406,294,1090,4885
11,372,427,284,1083,4885
1,500,200,50,750,4886
2,476,223,89,788,4886
3,441,269,128,838,4886
4,414,296,160,870,4886
5,419,315,190,924,4886
6,399,316,219,934,4886
7,396,365,212,973,4886
8,398,389,227,1014,4886
9,382,385,246,1013,4886
10,392,375,276,1043,4886
11,390,414,280,1084,4886
1,500,200,50,750,4887
2,469,232,102,803,4887
3,440,240,143,823,4887
4,426,271,168,865,4887
5,419,319,185,923,4887
6,392,339,227,958,4887
7,391,353,241,985,4887
8,395,368,247,1010,4887
9,398,371,257,1026,4887
10,401,407,278,1086,4887
11,384,425,278,1087,4887
1,500,200,50,750,4888
2,468,236,95,799,4888
3,433,269,131,833,4888
4,431,280,161,872,4888
5,431,301,191,923,4888
6,416,333,214,963,4888
7,408,335,240,983,4888
8,403,362,241,1006,4888
9,410,381,235,1026,4888
10,424,401,243,1068,4888
11,407,418,267,1092,4888
1,500,200,50,750,4889
2,457,237,94,788,4889
3,428,261,129,818,4889
4,396,299,155,850,4889
5,417,306,179,902,4889
6,408,334,211,953,4889
7,404,347,233,984,4889
8,385,351,262,998,4889
9,398,368,264,1030,4889
10,402,411,266,1079,4889
11,379,428,269,1076,4889
1,500,200,50,750,4890
2,479,220,93,792,4890
3,453,251,129,833,4890
4,430,273,173,876,4890
5,402,301,198,901,4890
6,425,342,197,964,4890
7,421,329,240,990,4890
8,422,357,245,1024,4890
9,413,357,247,1017,4890
10,405,384,267,1056,4890
11,400,395,277,1072,4890
1,500,200,50,750,4891
2,443,231,97,771,4891
3,444,257,129,830,4891
4,410,295,169,874,4891
5,405,316,192,913,4891
6,410,329,228,967,4891
7,436,312,251,999,4891
8,416,346,245,1007,4891
9,398,382,262,1042,4891
10,414,393,259,1066,4891
11,393,412,278,1083,4891
1,500,200,50,750,4892
2,455,227,108,790,4892
3,425,257,153,835,4892
4,405,286,169,860,4892
5,414,291,199,904,4892
6,432,343,191,966,4892
7,405,359,208,972,4892
8,404,377,224,1005,4892
9,402,387,251,1040,4892
10,390,397,264,1051,4892
11,380,411,269,1060,4892
1,500,200,50,750,4893
2,452,237,91,780,4893
3,428,258,131,817,4893
4,417,285,153,855,4893
5,425,312,177,914,4893
6,434,331,203,968,4893
7,422,348,210,980,4893
8,417,336,241,994,4893
9,422,365,253,1040,4893
10,421,365,271,1057,4893
11,413,406,254,1073,4893
1,500,200,50,750,4894
2,440,242,109,791,4894
3,415,276,141,832,4894
4,401,302,179,882,4894
5,412,313,202,927,4894
6,403,358,197,958,4894
7,396,344,223,963,4894
8,413,366,243,1022,4894
9,390,382,250,1022,4894
10,413,390,251,1054,4894
11,386,419,261,1066,4894
1,500,200,50,750,4895
2,484,210,92,786,4895
3,448,259,140,847,4895
4,415,280,176,871,4895
5,400,302,205,907,4895
6,386,340,210,936,4895
7,372,368,245,985,4895
8,367,376,256,999,4895
9,398,386,256,1040,4895
10,394,402,258,1054,4895
11,411,396,265,1072,4895
1,500,200,50,750,4896
2,465,227,99,791,4896
3,435,253,141,829,4896
4,413,298,163,874,4896
5,402,316,190,908,4896
6,411,336,214,961,4896
7,404,361,217,982,4896
8,379,371,260,1010,4896
9,384,394,248,1026,4896
10,397,411,251,1059,4896
11,408,414,264,1086,4896
1,500,200,50,750,4897
2,476,219,94,789,4897
3,426,241,150,817,4897
4,426,287,179,892,4897
5,404,329,185,918,4897
6,370,340,223,933,4897
7,405,344,238,987,4897
8,405,363,237,1005,4897
9,397,357,276,1030,4897
10,416,356,303,1075,4897
11,399,372,311,1082,4897
1,500,200,50,750,4898
2,452,223,101,776,4898
3,433,250,139,822,4898
4,432,262,166,860,4898
5,432,312,181,925,4898
6,419,321,209,949,4898
7,406,352,235,993,4898
8,399,389,227,1015,4898
9,375,380,257,1012,4898
10,377,400,270,1047,4898
11,412,399,273,1084,4898
1,500,200,50,750,4899
2,454,229,102,785,4899
3,419,281,125,825,4899
4,410,305,161,876,4899
5,375,329,179,883,4899
6,383,351,197,931,4899
7,381,357,233,971,4899
8,386,354,255,995,4899
9,390,390,259,1039,4899
10,367,387,285,1039,4899
11,346,404,329,1079,4899
1,500,200,50,750,4900
2,454,232,104,790,4900
3,412,253,158,823,4900
4,397,280,184,861,4900
5,382,324,199,905,4900
6,407,338,224,969,4900
7,401,364,220,985,4900
8,382,359,259,1000,4900
9,357,377,280,1014,4900
10,366,422,275,1063,4900
11,359,409,296,1064,4900
1,500,200,50,750,4901
2,457,221,106,784,4901
3,434,249,146,829,4901
4,418,243,204,865,4901
5,421,280,200,901,4901
6,412,317,213,942,4901
7,423,332,222,977,4901
8,424,354,233,1011,4901
9,421,355,251,1027,4901
10,439,373,259,1071,4901
11,399,402,278,1079,4901
1,500,200,50,750,4902
2,445,225,104,774,4902
3,427,263,142,832,4902
4,417,271,176,864,4902
5,426,297,184,907,4902
6,421,336,191,948,4902
7,402,348,229,979,4902
8,401,351,252,1004,4902
9,391,379,261,1031,4902
10,381,404,273,1058,4902
11,376,417,282,1075,4902
1,500,200,50,750,4903
2,456,237,99,792,4903
3,415,278,137,830,4903
4,387,304,165,856,4903
5,407,316,191,914,4903
6,402,343,208,953,4903
7,380,353,232,965,4903
8,385,376,241,1002,4903
9,396,387,253,1036,4903
10,387,414,264,1065,4903
11,388,427,266,1081,4903
1,500,200,50,750,4904
2,446,224,108,778,4904
3,450,249,142,841,4904
4,427,280,160,867,4904
5,402,313,192,907,4904
6,418,335,223,976,4904
7,389,361,222,972,4904
8,381,393,244,1018,4904
9,377,419,240,1036,4904
10,401,422,245,1068,4904
11,384,418,266,1068,4904
1,500,200,50,750,4905
2,451,240,89,780,4905
3,422,272,131,825,4905
4,398,312,158,868,4905
5,383,337,171,891,4905
6,381,381,189,951,4905
7,386,364,233,983,4905
8,387,361,255,1003,4905
9,370,368,276,1014,4905
10,380,405,270,1055,4905
11,379,425,283,1087,4905
1,500,200,50,750,4906
2,452,232,85,769,4906
3,426,255,143,824,4906
4,404,284,166,854,4906
5,394,312,202,908,4906
6,403,347,209,959,4906
7,383,359,240,982,4906
8,402,345,267,1014,4906
9,399,359,268,1026,4906
10,409,366,284,1059,4906
11,418,389,271,1078,4906
1,500,200,50,750,4907
2,465,237,98,800,4907
3,451,248,127,826,4907
4,429,276,153,858,4907
5,428,311,175,914,4907
6,428,329,191,948,4907
7,409,337,216,962,4907
8,406,349,243,998,4907
9,396,361,251,1008,4907
10,405,378,274,1057,4907
11,400,391,285,1076,4907
1,500,200,50,750,4908
2,457,228,101,786,4908
3,419,261,142,822,4908
4,417,287,175,879,4908
5,431,284,199,914,4908
6,419,330,216,965,4908
7,389,341,229,959,4908
8,405,358,250,1013,4908
9,401,376,262,1039,4908
10,393,388,276,1057,4908
11,368,377,293,1038,4908
1,500,200,50,750,4909
2,452,236,88,776,4909
3,444,269,133,846,4909
4,420,275,164,859,4909
5,429,299,184,912,4909
6,419,335,188,942,4909
7,426,360,206,992,4909
8,394,384,229,1007,4909
9,394,391,247,1032,4909
10,381,411,258,1050,4909
11,366,434,263,1063,4909
1,500,200,50,750,4910
2,448,234,104,786,4910
3,429,269,134,832,4910
4,408,294,149,851,4910
5,399,314,190,903,4910
6,399,359,213,971,4910
7,370,357,244,971,4910
8,365,373,287,1025,4910
9,363,392,276,1031,4910
10,392,386,294,1072,4910
11,382,392,313,1087,4910
1,500,200,50,750,4911
2,452,239,102,793,4911
3,435,265,123,823,4911
4,414,289,152,855,4911
5,420,302,185,907,4911
6,414,326,203,943,4911
7,394,355,228,977,4911
8,383,388,240,1011,4911
9,371,412,234,1017,4911
10,395,411,252,1058,4911
11,420,400,268,1088,4911
1,500,200,50,750,4912
2,451,220,99,770,4912
3,429,273,133,835,4912
4,418,298,167,883,4912
5,411,316,196,923,4912
6,407,327,211,945,4912
7,423,338,227,988,4912
8,404,371,226,1001,4912
9,402,380,246,1028,4912
10,414,390,261,1065,4912
11,404,398,265,1067,4912
1,500,200,50,750,4913
2,456,232,97,785,4913
3,407,287,142,836,4913
4,393,305,160,858,4913
5,393,316,196,905,4913
6,416,326,223,965,4913
7,402,330,256,988,4913
8,385,359,262,1006,4913
9,402,392,254,1048,4913
10,383,399,265,1047,4913
11,413,412,263,1088,4913
1,500,200,50,750,4914
2,462,234,106,802,4914
3,445,243,142,830,4914
4,446,271,158,875,4914
5,403,321,188,912,4914
6,414,355,207,976,4914
7,381,355,232,968,4914
8,394,368,238,1000,4914
9,399,372,252,1023,4914
10,420,386,250,1056,4914
11,415,407,263,1085,4914
1,500,200,50,750,4915
2,466,213,114,793,4915
3,450,236,119,805,4915
4,459,288,138,885,4915
5,423,273,209,905,4915
6,432,302,224,958,4915
7,416,325,242,983,4915
8,399,359,239,997,4915
9,405,364,257,1026,4915
10,403,380,270,1053,4915
11,402,397,285,1084,4915
1,500,200,50,750,4916
2,468,210,97,775,4916
3,456,247,135,838,4916
4,410,295,155,860,4916
5,427,308,175,910,4916
6,415,345,204,964,4916
7,398,359,223,980,4916
8,389,366,237,992,4916
9,396,379,258,1033,4916
10,398,382,285,1065,4916
11,384,409,289,1082,4916
1,500,200,50,750,4917
2,430,241,92,763,4917
3,411,279,148,838,4917
4,378,305,195,878,4917
5,366,330,199,895,4917
6,385,335,230,950,4917
7,368,374,238,980,4917
8,371,396,233,1000,4917
9,374,404,252,1030,4917
10,372,407,273,1052,4917
11,402,415,274,1091,4917
1,500,200,50,750,4918
2,481,218,97,796,4918
3,456,241,127,824,4918
4,431,282,146,859,4918
5,425,323,179,927,4918
6,397,345,208,950,4918
7,420,359,212,991,4918
8,403,363,241,1007,4918
9,388,362,265,1015,4918
10,403,386,273,1062,4918
11,396,415,275,1086,4918
1,500,200,50,750,4919
2,456,246,86,788,4919
3,409,266,140,815,4919
4,403,299,164,866,4919
5,394,316,182,892,4919
6,426,336,211,973,4919
7,404,344,230,978,4919
8,388,368,231,987,4919
9,392,402,244,1038,4919
10,399,421,257,1077,4919
11,390,408,290,1088,4919
1,500,200,50,750,4920
2,458,236,90,784,4920
3,425,263,126,814,4920
4,421,285,183,889,4920
5,396,298,203,897,4920
6,427,312,219,958,4920
7,408,344,231,983,4920
8,402,379,222,1003,4920
9,388,393,235,1016,4920
10,387,390,264,1041,4920
11,405,389,282,1076,4920
1,500,200,50,750,4921
2,472,233,98,803,4921
3,456,249,120,825,4921
4,437,291,135,863,4921
5,423,312,178,913,4921
6,429,347,202,978,4921
7,404,354,217,975,4921
8,413,367,236,1016,4921
9,400,374,256,1030,4921
10,402,379,276,1057,4921
11,399,412,269,1080,4921
1,500,200,50,750,4922
2,447,258,89,794,4922
3,436,250,138,824,4922
4,407,302,162,871,4922
5,424,313,178,915,4922
6,406,322,214,942,4922
7,421,339,229,989,4922
8,397,370,238,1005,4922
9,385,376,253,1014,4922
10,391,405,262,1058,4922
11,384,430,270,1084,4922
1,500,200,50,750,4923
2,430,230,111,771,4923
3,397,259,150,806,4923
4,388,296,171,855,4923
5,388,332,201,921,4923
6,392,369,207,968,4923
7,385,365,230,980,4923
8,408,385,236,1029,4923
9,394,385,255,1034,4923
10,386,378,285,1049,4923
11,386,402,302,1090,4923
1,500,200,50,750,4924
2,470,224,99,793,4924
3,429,256,145,830,4924
4,402,288,171,861,4924
5,392,312,206,910,4924
6,386,351,204,941,4924
7,381,367,238,986,4924
8,373,379,257,1009,4924
9,365,394,272,1031,4924
10,391,412,269,1072,4924
11,378,424,287,1089,4924
1,500,200,50,750,4925
2,463,223,95,781,4925
3,435,257,141,833,4925
4,405,293,166,864,4925
5,399,320,196,915,4925
6,401,341,213,955,4925
7,411,343,234,988,4925
8,410,373,240,1023,4925
9,386,383,273,1042,4925
10,400,402,265,1067,4925
11,389,403,290,1082,4925
1,500,200,50,750,4926
2,454,233,96,783,4926
3,437,244,137,818,4926
4,424,296,153,873,4926
5,403,336,173,912,4926
6,409,342,217,968,4926
7,389,355,233,977,4926
8,367,383,252,1002,4926
9,381,410,249,1040,4926
10,368,409,267,1044,4926
11,388,406,273,1067,4926
1,500,200,50,750,4927
2,443,222,108,773,4927
3,429,249,149,827,4927
4,409,268,195,872,4927
5,384,319,202,905,4927
6,400,339,214,953,4927
7,404,344,224,972,4927
8,422,362,222,1006,4927
9,419,377,239,1035,4927
10,413,391,248,1052,4927
11,423,383,270,1076,4927
1,500,200,50,750,4928
2,467,232,96,795,4928
3,443,255,132,830,4928
4,452,271,161,884,4928
5,427,305,174,906,4928
6,422,354,190,966,4928
7,389,369,220,978,4928
8,394,382,240,1016,4928
9,378,398,260,1036,4928
10,399,414,257,1070,4928
11,423,411,264,1098,4928
1,500,200,50,750,4929
2,458,248,85,791,4929
3,425,290,121,836,4929
4,419,334,120,873,4929
5,418,312,181,911,4929
6,433,328,209,970,4929
7,424,356,221,1001,4929
8,402,366,229,997,4929
9,425,366,240,1031,4929
10,418,383,259,1060,4929
11,433,393,261,1087,4929
1,500,200,50,750,4930
2,458,231,96,785,4930
3,435,252,141,828,4930
4,410,296,161,867,4930
5,417,312,194,923,4930
6,397,341,213,951,4930
7,389,364,230,983,4930
8,393,375,253,1021,4930
9,397,375,249,1021,4930
10,398,384,282,1064,4930
11,399,410,279,1088,4930
1,500,200,50,750,4931
2,441,233,100,774,4931
3,426,249,144,819,4931
4,413,286,169,868,4931
5,419,295,187,901,4931
6,422,318,228,968,4931
7,408,364,220,992,4931
8,394,365,249,1008,4931
9,369,399,251,1019,4931
10,390,401,264,1055,4931
11,392,435,256,1083,4931
1,500,200,50,750,4932
2,451,248,92,791,4932
3,407,280,139,826,4932
4,396,305,169,870,4932
5,392,341,177,910,4932
6,415,361,205,981,4932
7,371,379,232,982,4932
8,375,403,218,996,4932
9,403,405,246,1054,4932
10,379,414,260,1053,4932
11,376,408,286,1070,4932
1,500,200,50,750,4933
2,465,244,83,792,4933
3,453,259,130,842,4933
4,446,270,165,881,4933
5,430,302,181,913,4933
6,455,315,189,959,4933
7,437,327,213,977,4933
8,398,347,230,975,4933
9,419,377,246,1042,4933
10,434,363,262,1059,4933
11,435,376,273,1084,4933
1,500,200,50,750,4934
2,462,227,96,785,4934
3,427,270,135,832,4934
4,433,276,169,878,4934
5,421,300,179,900,4934
6,418,333,212,963,4934
7,392,329,246,967,4934
8,421,328,250,999,4934
9,409,356,264,1029,4934
10,420,389,259,1068,4934
11,419,404,268,1091,4934
1,500,200,50,750,4935
2,456,242,97,795,4935
3,443,238,141,822,4935
4,427,284,172,883,4935
5,421,293,192,906,4935
6,428,326,214,968,4935
7,420,349,210,979,4935
8,407,349,241,997,4935
9,412,365,255,1032,4935
10,416,369,278,1063,4935
11,420,382,274,1076,4935
1,500,200,50,750,4936
2,447,231,108,786,4936
3,431,274,136,841,4936
4,407,274,168,849,4936
5,407,292,183,882,4936
6,431,317,218,966,4936
7,393,343,236,972,4936
8,414,349,236,999,4936
9,416,352,257,1025,4936
10,405,382,260,1047,4936
11,412,393,283,1088,4936
1,500,200,50,750,4937
2,476,222,92,790,4937
3,444,250,132,826,4937
4,421,274,164,859,4937
5,402,323,194,919,4937
6,397,342,195,934,4937
7,415,382,213,1010,4937
8,394,388,221,1003,4937
9,409,396,240,1045,4937
10,406,393,257,1056,4937
11,418,410,265,1093,4937
1,500,200,50,750,4938
2,462,218,108,788,4938
3,432,259,144,835,4938
4,397,279,189,865,4938
5,396,321,208,925,4938
6,394,341,233,968,4938
7,387,355,226,968,4938
8,405,414,207,1026,4938
9,398,410,227,1035,4938
10,383,439,238,1060,4938
11,388,444,256,1088,4938
1,500,200,50,750,4939
2,444,263,90,797,4939
3,419,284,131,834,4939
4,395,318,160,873,4939
5,375,335,190,900,4939
6,407,355,213,975,4939
7,386,343,237,966,4939
8,368,360,270,998,4939
9,372,387,288,1047,4939
10,378,395,287,1060,4939
11,382,421,276,1079,4939
1,500,200,50,750,4940
2,445,240,106,791,4940
3,429,264,144,837,4940
4,408,280,179,867,4940
5,389,313,185,887,4940
6,453,336,203,992,4940
7,414,339,215,968,4940
8,430,364,214,1008,4940
9,413,375,237,1025,4940
10,407,411,242,1060,4940
11,392,403,268,1063,4940
1,500,200,50,750,4941
2,457,225,106,788,4941
3,428,241,163,832,4941
4,421,274,179,874,4941
5,408,311,181,900,4941
6,406,338,215,959,4941
7,411,348,235,994,4941
8,389,373,241,1003,4941
9,381,370,267,1018,4941
10,407,393,248,1048,4941
11,401,436,253,1090,4941
1,500,200,50,750,4942
2,457,238,99,794,4942
3,417,268,149,834,4942
4,381,302,182,865,4942
5,380,317,210,907,4942
6,384,337,216,937,4942
7,414,367,224,1005,4942
8,374,374,249,997,4942
9,380,375,271,1026,4942
10,403,369,282,1054,4942
11,396,396,284,1076,4942
1,500,200,50,750,4943
2,453,237,101,791,4943
3,414,269,128,811,4943
4,421,298,152,871,4943
5,412,317,179,908,4943
6,391,350,211,952,4943
7,394,352,233,979,4943
8,371,377,257,1005,4943
9,379,403,275,1057,4943
10,389,426,253,1068,4943
11,406,404,286,1096,4943
1,500,200,50,750,4944
2,468,222,98,788,4944
3,443,279,123,845,4944
4,403,308,163,874,4944
5,416,310,191,917,4944
6,406,354,210,970,4944
7,388,366,235,989,4944
8,378,390,228,996,4944
9,394,398,246,1038,4944
10,396,397,263,1056,4944
11,378,403,296,1077,4944
1,500,200,50,750,4945
2,432,256,93,781,4945
3,404,287,130,821,4945
4,398,297,173,868,4945
5,381,319,211,911,4945
6,396,351,219,966,4945
7,372,355,253,980,4945
8,371,388,251,1010,4945
9,364,394,269,1027,4945
10,389,401,259,1049,4945
11,399,406,283,1088,4945
1,500,200,50,750,4946
2,449,239,97,785,4946
3,438,249,138,825,4946
4,408,281,171,860,4946
5,416,305,179,900,4946
6,408,337,211,956,4946
7,392,365,237,994,4946
8,387,381,242,1010,4946
9,383,392,244,1019,4946
10,392,403,256,1051,4946
11,409,393,278,1080,4946
1,500,200,50,750,4947
2,454,243,93,790,4947
3,433,256,133,822,4947
4,406,286,168,860,4947
5,388,314,189,891,4947
6,412,332,219,963,4947
7,380,367,233,980,4947
8,387,363,242,992,4947
9,393,371,264,1028,4947
10,404,381,286,1071,4947
11,391,372,315,1078,4947
1,500,200,50,750,4948
2,456,247,93,796,4948
3,428,263,138,829,4948
4,412,283,172,867,4948
5,425,301,182,908,4948
6,440,326,198,964,4948
7,408,356,224,988,4948
8,370,363,257,990,4948
9,398,385,268,1051,4948
10,402,395,257,1054,4948
11,359,438,267,1064,4948
1,500,200,50,750,4949
2,471,218,95,784,4949
3,441,248,131,820,4949
4,422,298,161,881,4949
5,408,325,187,920,4949
6,391,330,221,942,4949
7,403,348,231,982,4949
8,402,343,258,1003,4949
9,430,355,242,1027,4949
10,437,377,255,1069,4949
11,441,359,280,1080,4949
1,500,200,50,750,4950
2,437,255,90,782,4950
3,420,259,143,822,4950
4,409,294,174,877,4950
5,423,300,201,924,4950
6,414,334,201,949,4950
7,412,346,211,969,4950
8,399,363,249,1011,4950
9,390,364,269,1023,4950
10,376,392,280,1048,4950
11,424,411,270,1105,4950
1,500,200,50,750,4951
2,457,239,95,791,4951
3,425,273,119,817,4951
4,434,298,144,876,4951
5,413,326,170,909,4951
6,424,336,189,949,4951
7,405,356,209,970,4951
8,412,350,235,997,4951
9,423,365,243,1031,4951
10,409,410,237,1056,4951
11,402,418,256,1076,4951
1,500,200,50,750,4952
2,455,241,92,788,4952
3,422,260,127,809,4952
4,428,285,167,880,4952
5,405,318,192,915,4952
6,407,339,209,955,4952
7,395,344,236,975,4952
8,380,365,263,1008,4952
9,384,383,264,1031,4952
10,383,380,268,1031,4952
11,431,399,260,1090,4952
1,500,200,50,750,4953
2,455,262,85,802,4953
3,427,278,117,822,4953
4,402,299,145,846,4953
5,430,312,188,930,4953
6,396,352,200,948,4953
7,385,358,241,984,4953
8,382,366,272,1020,4953
9,368,388,255,1011,4953
10,388,409,273,1070,4953
11,384,418,268,1070,4953
1,500,200,50,750,4954
2,455,229,94,778,4954
3,437,263,124,824,4954
4,422,305,154,881,4954
5,421,309,192,922,4954
6,430,320,206,956,4954
7,410,349,220,979,4954
8,416,369,219,1004,4954
9,406,381,241,1028,4954
10,412,395,245,1052,4954
11,417,372,280,1069,4954
1,500,200,50,750,4955
2,456,229,101,786,4955
3,421,250,145,816,4955
4,420,258,156,834,4955
5,438,301,171,910,4955
6,436,322,196,954,4955
7,409,355,208,972,4955
8,414,352,243,1009,4955
9,411,358,250,1019,4955
10,437,397,239,1073,4955
11,423,408,249,1080,4955
1,500,200,50,750,4956
2,472,214,99,785,4956
3,445,241,131,817,4956
4,423,285,158,866,4956
5,434,317,174,925,4956
6,427,341,179,947,4956
7,422,353,207,982,4956
8,415,369,218,1002,4956
9,398,392,235,1025,4956
10,411,403,249,1063,4956
11,420,409,264,1093,4956
1,500,200,50,750,4957
2,452,226,105,783,4957
3,416,245,145,806,4957
4,415,289,171,875,4957
5,403,310,202,915,4957
6,392,348,222,962,4957
7,394,366,224,984,4957
8,385,382,245,1012,4957
9,391,399,264,1054,4957
10,374,403,276,1053,4957
11,382,401,300,1083,4957
1,500,200,50,750,4958
2,466,230,92,788,4958
3,430,284,109,823,4958
4,398,316,143,857,4958
5,386,346,202,934,4958
6,394,358,212,964,4958
7,377,390,211,978,4958
8,378,395,242,1015,4958
9,367,414,257,1038,4958
10,383,410,287,1080,4958
11,384,396,288,1068,4958
1,500,200,50,750,4959
2,470,227,95,792,4959
3,454,240,136,830,4959
4,432,256,171,859,4959
5,440,296,183,919,4959
6,437,324,204,965,4959
7,410,351,217,978,4959
8,414,351,243,1008,4959
9,382,382,260,1024,4959
10,395,404,271,1070,4959
11,400,399,287,1086,4959
1,500,200,50,750,4960
2,478,233,91,802,4960
3,453,268,116,837,4960
4,444,298,144,886,4960
5,411,321,175,907,4960
6,404,356,196,956,4960
7,388,361,224,973,4960
8,389,387,229,1005,4960
9,374,438,225,1037,4960
10,373,448,237,1058,4960
11,409,423,246,1078,4960
1,500,200,50,750,4961
2,443,249,96,788,4961
3,407,290,128,825,4961
4,382,314,159,855,4961
5,379,342,189,910,4961
6,376,378,196,950,4961
7,384,376,225,985,4961
8,357,378,238,973,4961
9,393,397,248,1038,4961
10,386,408,254,1048,4961
11,402,404,288,1094,4961
1,500,200,50,750,4962
2,483,233,86,802,4962
3,460,249,119,828,4962
4,453,273,145,871,4962
5,435,300,176,911,4962
6,436,323,196,955,4962
7,394,354,215,963,4962
8,417,378,233,1028,4962
9,403,371,262,1036,4962
10,402,392,264,1058,4962
11,400,423,263,1086,4962
1,500,200,50,750,4963
2,438,248,95,781,4963
3,428,265,138,831,4963
4,380,294,168,842,4963
5,412,330,175,917,4963
6,389,361,223,973,4963
7,351,364,249,964,4963
8,350,386,275,1011,4963
9,352,384,302,1038,4963
10,374,386,306,1066,4963
11,377,417,296,1090,4963
1,500,200,50,750,4964
2,452,234,102,788,4964
3,429,252,141,822,4964
4,405,297,163,865,4964
5,418,301,191,910,4964
6,419,325,213,957,4964
7,419,339,226,984,4964
8,403,380,231,1014,4964
9,405,382,246,1033,4964
10,391,414,239,1044,4964
11,393,408,278,1079,4964
1,500,200,50,750,4965
2,466,215,108,789,4965
3,448,231,144,823,4965
4,422,244,190,856,4965
5,398,290,214,902,4965
6,406,319,229,954,4965
7,406,343,232,981,4965
8,392,376,253,1021,4965
9,400,376,252,1028,4965
10,395,393,259,1047,4965
11,395,413,268,1076,4965
1,500,200,50,750,4966
2,462,246,81,789,4966
3,416,273,123,812,4966
4,403,294,159,856,4966
5,412,310,183,905,4966
6,411,327,221,959,4966
7,420,329,234,983,4966
8,423,361,229,1013,4966
9,398,387,239,1024,4966
10,403,414,237,1054,4966
11,424,415,259,1098,4966
1,500,200,50,750,4967
2,450,235,103,788,4967
3,412,278,136,826,4967
4,387,292,175,854,4967
5,399,318,199,916,4967
6,408,341,208,957,4967
7,398,358,234,990,4967
8,395,373,246,1014,4967
9,395,381,257,1033,4967
10,375,412,262,1049,4967
11,405,430,250,1085,4967
1,500,200,50,750,4968
2,454,246,106,806,4968
3,420,251,152,823,4968
4,398,284,166,848,4968
5,401,319,192,912,4968
6,386,336,219,941,4968
7,409,343,240,992,4968
8,383,351,273,1007,4968
9,358,404,267,1029,4968
10,378,389,291,1058,4968
11,401,409,279,1089,4968
1,500,200,50,750,4969
2,459,225,93,777,4969
3,431,262,140,833,4969
4,408,287,172,867,4969
5,414,307,208,929,4969
6,386,341,226,953,4969
7,369,363,246,978,4969
8,370,384,262,1016,4969
9,396,385,263,1044,4969
10,384,386,289,1059,4969
11,386,410,303,1099,4969
1,500,200,50,750,4970
2,457,225,105,787,4970
3,420,258,137,815,4970
4,403,289,173,865,4970
5,413,321,182,916,4970
6,399,338,213,950,4970
7,407,344,230,981,4970
8,404,368,251,1023,4970
9,403,387,245,1035,4970
10,389,406,260,1055,4970
11,388,436,261,1085,4970
1,500,200,50,750,4971
2,446,235,101,782,4971
3,403,273,145,821,4971
4,395,294,174,863,4971
5,413,312,190,915,4971
6,403,320,222,945,4971
7,390,354,237,981,4971
8,395,366,263,1024,4971
9,386,382,247,1015,4971
10,404,387,256,1047,4971
11,421,388,265,1074,4971
1,500,200,50,750,4972
2,451,221,112,784,4972
3,415,279,136,830,4972
4,392,300,158,850,4972
5,405,322,186,913,4972
6,419,328,223,970,4972
7,406,351,231,988,4972
8,370,382,239,991,4972
9,384,387,259,1030,4972
10,371,400,278,1049,4972
11,373,424,263,1060,4972
1,500,200,50,750,4973
2,444,251,94,789,4973
3,433,267,127,827,4973
4,398,299,170,867,4973
5,393,305,198,896,4973
6,421,324,211,956,4973
7,403,354,208,965,4973
8,400,370,240,1010,4973
9,404,377,255,1036,4973
10,385,394,264,1043,4973
11,390,407,288,1085,4973
1,500,200,50,750,4974
2,445,245,99,789,4974
3,431,262,137,830,4974
4,408,294,166,868,4974
5,379,319,208,906,4974
6,392,358,207,957,4974
7,381,354,237,972,4974
8,392,369,242,1003,4974
9,384,374,259,1017,4974
10,389,395,273,1057,4974
11,390,393,297,1080,4974
1,500,200,50,750,4975
2,432,252,101,785,4975
3,394,301,143,838,4975
4,372,298,189,859,4975
5,378,311,226,915,4975
6,360,341,252,953,4975
7,385,371,235,991,4975
8,364,377,252,993,4975
9,381,381,267,1029,4975
10,369,407,267,1043,4975
11,416,416,276,1108,4975
1,500,200,50,750,4976
2,469,229,88,786,4976
3,440,255,133,828,4976
4,410,290,162,862,4976
5,393,325,182,900,4976
6,395,347,205,947,4976
7,394,344,247,985,4976
8,383,361,259,1003,4976
9,399,369,277,1045,4976
10,381,396,280,1057,4976
11,383,402,289,1074,4976
1,500,200,50,750,4977
2,440,229,104,773,4977
3,429,263,140,832,4977
4,421,286,163,870,4977
5,404,287,201,892,4977
6,424,343,213,980,4977
7,390,367,230,987,4977
8,390,377,252,1019,4977
9,389,387,259,1035,4977
10,404,399,252,1055,4977
11,386,420,261,1067,4977
1,500,200,50,750,4978
2,466,230,107,803,4978
3,425,241,164,830,4978
4,425,269,176,870,4978
5,439,295,179,913,4978
6,442,311,194,947,4978
7,427,332,204,963,4978
8,414,357,235,1006,4978
9,412,385,239,1036,4978
10,401,389,242,1032,4978
11,419,410,232,1061,4978
1,500,200,50,750,4979
2,452,229,106,787,4979
3,423,268,133,824,4979
4,407,295,148,850,4979
5,421,329,175,925,4979
6,400,351,212,963,4979
7,400,360,223,983,4979
8,400,357,250,1007,4979
9,412,369,258,1039,4979
10,391,383,279,1053,4979
11,379,405,290,1074,4979
1,500,200,50,750,4980
2,479,222,102,803,4980
3,446,242,128,816,4980
4,433,280,155,868,4980
5,426,289,179,894,4980
6,427,333,188,948,4980
7,415,356,208,979,4980
8,408,373,223,1004,4980
9,402,390,236,1028,4980
10,380,394,274,1048,4980
11,386,402,288,1076,4980
1,500,200,50,750,4981
2,449,236,93,778,4981
3,441,270,130,841,4981
4,418,292,150,860,4981
5,407,310,180,897,4981
6,401,337,221,959,4981
7,399,360,229,988,4981
8,395,357,251,1003,4981
9,398,386,249,1033,4981
10,400,404,255,1059,4981
11,400,398,282,1080,4981
1,500,200,50,750,4982
2,471,228,98,797,4982
3,423,261,126,810,4982
4,402,299,150,851,4982
5,392,321,190,903,4982
6,397,343,213,953,4982
7,378,362,229,969,4982
8,366,362,256,984,4982
9,421,370,248,1039,4982
10,408,390,260,1058,4982
11,411,363,290,1064,4982
1,500,200,50,750,4983
2,467,235,94,796,4983
3,455,264,115,834,4983
4,417,299,143,859,4983
5,422,297,183,902,4983
6,442,346,195,983,4983
7,424,335,223,982,4983
8,422,349,232,1003,4983
9,418,371,243,1032,4983
10,409,398,257,1064,4983
11,406,424,267,1097,4983
1,500,200,50,750,4984
2,456,232,95,783,4984
3,440,233,135,808,4984
4,439,274,161,874,4984
5,439,277,187,903,4984
6,428,334,197,959,4984
7,388,353,230,971,4984
8,413,356,244,1013,4984
9,411,367,244,1022,4984
10,432,372,259,1063,4984
11,425,401,259,1085,4984
1,500,200,50,750,4985
2,470,232,86,788,4985
3,434,251,141,826,4985
4,412,304,151,867,4985
5,398,331,173,902,4985
6,415,336,197,948,4985
7,400,365,217,982,4985
8,407,365,238,1010,4985
9,386,401,248,1035,4985
10,388,383,279,1050,4985
11,376,381,299,1056,4985
1,500,200,50,750,4986
2,458,226,100,784,4986
3,429,259,137,825,4986
4,436,274,161,871,4986
5,422,279,210,911,4986
6,426,319,225,970,4986
7,407,344,228,979,4986
8,392,362,242,996,4986
9,394,393,245,1032,4986
10,401,412,245,1058,4986
11,396,425,261,1082,4986
1,500,200,50,750,4987
2,462,213,111,786,4987
3,431,232,162,825,4987
4,431,265,188,884,4987
5,399,307,204,910,4987
6,417,320,227,964,4987
7,384,356,225,965,4987
8,397,380,236,1013,4987
9,388,387,251,1026,4987
10,401,408,250,1059,4987
11,386,410,281,1077,4987
1,500,200,50,750,4988
2,459,222,91,772,4988
3,444,270,118,832,4988
4,411,306,145,862,4988
5,416,321,178,915,4988
6,404,341,220,965,4988
7,385,357,238,980,4988
8,389,362,253,1004,4988
9,387,390,246,1023,4988
10,407,389,265,1061,4988
11,403,406,282,1091,4988
1,500,200,50,750,4989
2,457,236,103,796,4989
3,428,259,129,816,4989
4,432,293,161,886,4989
5,428,324,176,928,4989
6,406,347,198,951,4989
7,402,390,201,993,4989
8,382,407,228,1017,4989
9,389,414,231,1034,4989
10,403,426,238,1067,4989
11,410,426,247,1083,4989
1,500,200,50,750,4990
2,456,248,91,795,4990
3,423,250,145,818,4990
4,415,289,168,872,4990
5,412,308,189,909,4990
6,425,330,205,960,4990
7,403,355,211,969,4990
8,404,376,230,1010,4990
9,395,386,254,1035,4990
10,371,410,264,1045,4990
11,384,420,290,1094,4990
1,500,200,50,750,4991
2,453,241,93,787,4991
3,414,257,153,824,4991
4,389,280,183,852,4991
5,399,332,194,925,4991
6,395,345,220,960,4991
7,405,342,229,976,4991
8,403,364,242,1009,4991
9,412,371,266,1049,4991
10,383,387,280,1050,4991
11,390,415,274,1079,4991
1,500,200,50,750,4992
2,436,246,94,776,4992
3,429,279,123,831,4992
4,402,294,163,859,4992
5,404,306,204,914,4992
6,403,344,214,961,4992
7,383,364,224,971,4992
8,386,367,252,1005,4992
9,400,364,266,1030,4992
10,402,391,270,1063,4992
11,401,419,275,1095,4992
1,500,200,50,750,4993
2,440,240,102,782,4993
3,411,291,135,837,4993
4,398,309,169,876,4993
5,396,326,192,914,4993
6,409,336,218,963,4993
7,399,363,217,979,4993
8,397,392,232,1021,4993
9,398,385,234,1017,4993
10,397,414,252,1063,4993
11,386,425,293,1104,4993
1,500,200,50,750,4994
2,453,245,88,786,4994
3,413,260,144,817,4994
4,412,305,154,871,4994
5,398,316,185,899,4994
6,412,350,212,974,4994
7,384,384,218,986,4994
8,377,383,245,1005,4994
9,386,378,263,1027,4994
10,413,410,262,1085,4994
11,399,393,285,1077,4994
1,500,200,50,750,4995
2,441,246,107,794,4995
3,433,263,138,834,4995
4,414,293,176,883,4995
5,376,333,182,891,4995
6,445,335,211,991,4995
7,413,335,237,985,4995
8,397,361,245,1003,4995
9,370,385,268,1023,4995
10,410,372,274,1056,4995
11,421,390,266,1077,4995
1,500,200,50,750,4996
2,450,235,95,780,4996
3,432,267,134,833,4996
4,406,318,151,875,4996
5,368,317,200,885,4996
6,406,354,214,974,4996
7,377,373,229,979,4996
8,385,370,255,1010,4996
9,378,384,269,1031,4996
10,392,391,264,1047,4996
11,414,419,268,1101,4996
1,500,200,50,750,4997
2,438,251,104,793,4997
3,424,269,135,828,4997
4,425,298,168,891,4997
5,409,309,201,919,4997
6,407,343,209,959,4997
7,392,353,223,968,4997
8,400,365,230,995,4997
9,409,370,248,1027,4997
10,404,393,252,1049,4997
11,397,415,257,1069,4997
1,500,200,50,750,4998
2,468,225,94,787,4998
3,437,255,137,829,4998
4,410,288,159,857,4998
5,406,329,181,916,4998
6,391,345,213,949,4998
7,396,359,228,983,4998
8,375,360,266,1001,4998
9,397,353,279,1029,4998
10,411,374,286,1071,4998
11,403,385,298,1086,4998
1,500,200,50,750,4999
2,448,218,105,771,4999
3,428,239,143,810,4999
4,429,275,164,868,4999
5,412,305,191,908,4999
6,429,314,212,955,4999
7,423,356,207,986,4999
8,415,380,221,1016,4999
9,435,377,223,1035,4999
10,406,396,245,1047,4999
11,415,394,268,1077,4999
1,500,200,50,750,5000
2,455,243,94,792,5000
3,438,255,141,834,5000
4,411,282,173,866,5000
5,398,329,180,907,5000
6,392,364,208,964,5000
7,363,381,239,983,5000
8,372,392,252,1016,5000
9,366,370,297,1033,5000
10,357,395,295,1047,5000
11,391,418,289,1098,5000
